chr1	11873	14409	DDX11L1	2536	0.575710
chr1	14361	19759	WASH7P	5398	0.595961
chr1	14406	29370	WASH7P	14964	0.541500
chr1	34610	36081	FAM138F	1471	0.508498
chr1	69090	70008	OR4F5	918	0.428105
chr1	134772	140566	LOC729737	5794	0.611840
chr1	321083	321115	DQ597235	32	0.468750
chr1	321145	321207	DQ599768	62	0.564516
chr1	322036	326938	LOC100133331	4902	0.544268
chr1	327545	328439	LOC388312	894	0.634228
chr1	367658	368597	OR4F29	939	0.460064
chr1	420205	421839	BC036251	1634	0.431457
chr1	566092	566115	JA429830	23	0.434783
chr1	566134	566155	JA429831	21	0.523810
chr1	566239	566263	JB137814	24	0.416667
chr1	568843	568913	M37726	70	0.328571
chr1	621095	622034	OR4F29	939	0.460064
chr1	661138	670994	LOC100133331	9856	0.520901
chr1	668417	668479	DQ575786	62	0.564516
chr1	668509	668541	DQ599872	32	0.468750
chr1	671823	671885	DQ575786	62	0.564516
chr1	671915	671947	DQ599872	32	0.468750
chr1	674239	679736	AK310751	5497	0.451701
chr1	700244	714068	LOC100288069	13824	0.468533
chr1	761585	762902	LINC00115	1317	0.526955
chr1	762970	794826	LOC643837	31856	0.463712
chr1	803450	812182	FAM41C	8732	0.480417
chr1	846814	850328	AK056486	3514	0.585373
chr1	852952	854817	LOC100130417	1865	0.618231
chr1	861120	879961	SAMD11	18841	0.655379
chr1	879582	894679	NOC2L	15097	0.595284
chr1	895966	901099	KLHL17	5133	0.678551
chr1	901876	910484	PLEKHN1	8608	0.629414
chr1	910578	917473	C1orf170	6895	0.677157
chr1	934341	935552	HES4	1211	0.743187
chr1	948846	949919	ISG15	1073	0.643057
chr1	955502	991499	AGRN	35997	0.657083
chr1	995116	1001833	BC033949	6717	0.627661
chr1	1007125	1009687	RNF223	2562	0.678376
chr1	1017197	1051736	C1orf159	34539	0.546484
chr1	1072396	1079434	LOC254099	7038	0.650185
chr1	1102483	1102578	MIR200B	95	0.600000
chr1	1103242	1103332	MIR200A	90	0.555556
chr1	1103295	1103317	JA715134	22	0.409091
chr1	1104384	1104467	MIR429	83	0.578313
chr1	1104434	1104456	JA715143	22	0.363636
chr1	1108435	1114935	AK128833	6500	0.610308
chr1	1109285	1133313	TTLL10	24028	0.547486
chr1	1138887	1142089	TNFRSF18	3202	0.674266
chr1	1146705	1149548	TNFRSF4	2843	0.702779
chr1	1152287	1167447	SDF4	15160	0.613852
chr1	1167628	1170420	B3GALT6	2792	0.642192
chr1	1177825	1182102	FAM132A	4277	0.693477
chr1	1189291	1209234	UBE2J2	19943	0.563205
chr1	1215815	1227409	SCNN1D	11594	0.659307
chr1	1227763	1243269	ACAP3	15506	0.665420
chr1	1243993	1247057	PUSL1	3064	0.666123
chr1	1246964	1260067	CPSF3L	13103	0.604442
chr1	1260142	1264276	GLTPD1	4134	0.651911
chr1	1266725	1269844	TAS1R3	3119	0.673613
chr1	1270657	1284492	DVL1	13835	0.658619
chr1	1288070	1293915	MXRA8	5845	0.671856
chr1	1309109	1310562	AURKAIP1	1453	0.666208
chr1	1321090	1334718	CCNL2	13628	0.513795
chr1	1334909	1337426	LOC148413	2517	0.593166
chr1	1337275	1342693	MRPL20	5418	0.530269
chr1	1353799	1356824	ANKRD65	3025	0.668099
chr1	1361507	1363167	TMEM88B	1660	0.706024
chr1	1370902	1378262	VWA1	7360	0.665897
chr1	1385068	1405538	ATAD3C	20470	0.569761
chr1	1407163	1431582	ATAD3B	24419	0.588804
chr1	1447522	1470067	ATAD3A	22545	0.598714
chr1	1470157	1475740	TMEM240	5583	0.660398
chr1	1477052	1510262	SSU72	33210	0.538814
chr1	1510354	1510644	HP08716	290	0.634483
chr1	1533387	1535476	C1orf233	2089	0.702729
chr1	1535818	1543166	AK094692	7348	0.618672
chr1	1550794	1565990	MIB2	15196	0.664056
chr1	1567559	1570030	MMP23B	2471	0.717928
chr1	1571099	1655775	CDK11B	84676	0.538925
chr1	1586822	1590469	CDC2L1	3647	0.465314
chr1	1592938	1624243	SLC35E2B	31305	0.537007
chr1	1631377	1633247	MMP23A	1870	0.718182
chr1	1656053	1663343	AK097814	7290	0.511523
chr1	1658823	1677438	SLC35E2	18615	0.521730
chr1	1682670	1711508	NADK	28838	0.537069
chr1	1716724	1822526	GNB1	105802	0.466948
chr1	1846265	1848733	CALML6	2468	0.630875
chr1	1849028	1850740	TMEM52	1712	0.675818
chr1	1853395	1858842	C1orf222	5447	0.653020
chr1	1884751	1935276	KIAA1751	50525	0.555032
chr1	1944651	1946969	AK054708	2318	0.516825
chr1	1950767	1962192	GABRD	11425	0.625120
chr1	1981908	2116834	PRKCZ	134926	0.564398
chr1	2112574	2114663	AX747530	2089	0.596936
chr1	2115898	2126214	C1orf86	10316	0.598779
chr1	2121236	2123179	BC018779	1943	0.642306
chr1	2160133	2241652	SKI	81519	0.574676
chr1	2252695	2322993	MORN1	70298	0.572648
chr1	2281852	2284100	LOC100129534	2248	0.576957
chr1	2309493	2322993	MORN1	13500	0.577926
chr1	2323213	2336885	RER1	13672	0.539424
chr1	2336240	2344010	PEX10	7770	0.606692
chr1	2407753	2436964	PLCH2	29211	0.645510
chr1	2439974	2458035	PANK4	18061	0.606943
chr1	2460183	2461684	HES5	1501	0.682878
chr1	2481358	2484284	LOC115110	2926	0.591934
chr1	2486162	2488450	LOC100133445	2288	0.652972
chr1	2487804	2495188	TNFRSF14	7384	0.645314
chr1	2487804	2495267	TNFRSF14	7463	0.642637
chr1	2518188	2522908	FAM213B	4720	0.640678
chr1	2522080	2564481	MMEL1	42401	0.549492
chr1	2572806	2706230	TTC34	133424	0.373861
chr1	2938045	2939467	ACTRT2	1422	0.614627
chr1	2976180	2980350	FLJ42875	4170	0.604077
chr1	2980635	2984289	FLJ42875	3654	0.608648
chr1	2985741	3355185	PRDM16	369444	0.575787
chr1	3044538	3044599	MIR4251	61	0.508197
chr1	3371146	3397677	ARHGEF16	26531	0.629905
chr1	3404505	3528059	MEGF6	123554	0.624245
chr1	3477259	3477354	MIR551A	95	0.621053
chr1	3541555	3546694	TPRG1L	5139	0.523059
chr1	3547330	3566671	WRAP73	19341	0.537459
chr1	3569128	3652765	TP73	83637	0.595084
chr1	3652547	3663937	TP73-AS1	11390	0.544513
chr1	3668964	3688209	CCDC27	19245	0.539049
chr1	3689351	3692546	SMIM1	3195	0.649139
chr1	3696783	3713068	LRRC47	16285	0.544612
chr1	3728644	3773797	CEP104	45153	0.479304
chr1	3773844	3801993	DFFB	28149	0.516573
chr1	3805696	3816857	C1orf174	11161	0.493504
chr1	3816967	3832011	LOC100133612	15044	0.569264
chr1	4000671	4012643	LOC728716	11972	0.512195
chr1	4472110	4484744	LOC284661	12634	0.435412
chr1	4715104	4843851	AJAP1	128747	0.526871
chr1	4847557	4852183	BC037321	4626	0.449416
chr1	5621768	5728315	AK125078	106547	0.468676
chr1	5624130	5624203	MIR4417	73	0.630137
chr1	5922731	5922801	MIR4689	70	0.628571
chr1	5922869	6052533	NPHP4	129664	0.499352
chr1	6105980	6161253	KCNAB2	55273	0.561124
chr1	6161846	6240194	CHD5	78348	0.567034
chr1	6245079	6259679	RPL22	14600	0.470685
chr1	6266188	6281359	RNF207	15171	0.569574
chr1	6281252	6296044	ICMT	14792	0.496079
chr1	6297870	6299502	C1orf211	1632	0.554534
chr1	6304251	6305638	HES3	1387	0.659697
chr1	6307405	6321035	GPR153	13630	0.603081
chr1	6324331	6453826	ACOT7	129495	0.539712
chr1	6475293	6479979	HES2	4686	0.592403
chr1	6484847	6521004	ESPN	36157	0.601847
chr1	6489893	6489956	MIR4252	63	0.650794
chr1	6521213	6526255	TNFRSF25	5042	0.597382
chr1	6526151	6545529	PLEKHG5	19378	0.589638
chr1	6581406	6614658	NOL9	33252	0.478317
chr1	6615337	6639817	TAS1R1	24480	0.524673
chr1	6640062	6649340	ZBTB48	9278	0.577819
chr1	6650783	6662929	KLHL21	12146	0.571464
chr1	6673755	6684093	PHF13	10338	0.549719
chr1	6685209	6693642	THAP3	8433	0.565279
chr1	6694227	6761966	DNAJC11	67739	0.465921
chr1	6845383	7829766	CAMTA1	984383	0.480010
chr1	7831328	7841492	VAMP3	10164	0.427686
chr1	7844713	7905237	PER3	60524	0.403311
chr1	7907671	7913565	UTS2	5894	0.418222
chr1	7975930	8003225	TNFRSF9	27295	0.439238
chr1	8021713	8045342	PARK7	23629	0.453891
chr1	8071778	8086393	ERRFI1	14615	0.410811
chr1	8384389	8404227	SLC45A1	19838	0.524801
chr1	8412463	8877699	RERE	465236	0.419017
chr1	8440651	8441235	BC113958	584	0.527397
chr1	8921058	8939151	ENO1	18093	0.500083
chr1	8938893	8939943	ENO1-AS1	1050	0.596190
chr1	9005892	9034503	CA6	28611	0.481843
chr1	9063358	9086404	SLC2A7	23046	0.524386
chr1	9097004	9129887	SLC2A5	32883	0.478849
chr1	9164475	9189229	GPR157	24754	0.501212
chr1	9186983	9189250	GPR157	2267	0.601676
chr1	9208345	9242451	mir-34	34106	0.507799
chr1	9294862	9331394	H6PD	36532	0.522829
chr1	9352940	9429590	SPSB1	76650	0.542857
chr1	9599527	9642831	SLC25A33	43304	0.455986
chr1	9648931	9674935	TMEM201	26004	0.593678
chr1	9711789	9789172	PIK3CD	77383	0.513304
chr1	9712667	9714644	C1orf200	1977	0.552858
chr1	9740902	9747627	BC038541	6725	0.499182
chr1	9789078	9884550	CLSTN1	95472	0.473615
chr1	9908333	9970316	CTNNBIP1	61983	0.513496
chr1	9989775	10002840	LZIC	13065	0.434367
chr1	10003485	10045556	NMNAT1	42071	0.461315
chr1	10057254	10076078	RBP7	18824	0.483213
chr1	10093040	10241296	UBE4B	148256	0.440893
chr1	10270763	10441661	KIF1B	170898	0.420075
chr1	10459084	10480201	PGD	21117	0.472558
chr1	10490158	10512060	APITD1-CORT	21902	0.480184
chr1	10520602	10532613	DFFA	12011	0.496711
chr1	10535002	10690815	PEX14	155813	0.449860
chr1	10696665	10856733	CASZ1	160068	0.567328
chr1	11006529	11042094	C1orf127	35565	0.521524
chr1	11072678	11085549	TARDBP	12871	0.439671
chr1	11086579	11107296	MASP2	20717	0.502148
chr1	11114648	11120091	SRM	5443	0.600037
chr1	11126675	11159938	EXOSC10	33263	0.463819
chr1	11166587	11322608	MTOR	156021	0.445446
chr1	11203954	11209595	MTOR-AS1	5641	0.453998
chr1	11249345	11256038	ANGPTL7	6693	0.464067
chr1	11333254	11348491	UBIAD1	15237	0.476800
chr1	11539294	11597640	PTCHD2	58346	0.528262
chr1	11708417	11714888	FBXO2	6471	0.604389
chr1	11714913	11723384	FBXO44	8471	0.538425
chr1	11724149	11734409	FBXO6	10260	0.553411
chr1	11734536	11751678	MAD2L2	17142	0.538619
chr1	11751780	11780336	DRAXIN	28556	0.539887
chr1	11782186	11785914	AK125437	3728	0.496513
chr1	11796141	11810828	AGTRAP	14687	0.544087
chr1	11824461	11826573	C1orf167	2112	0.597064
chr1	11832138	11849642	C1orf167	17504	0.552617
chr1	11845786	11866160	MTHFR	20374	0.544027
chr1	11866152	11903201	CLCN6	37049	0.477908
chr1	11905766	11907840	NPPA	2074	0.529894
chr1	11917520	11918992	NPPB	1472	0.545516
chr1	11979644	11986485	KIAA2013	6841	0.557959
chr1	11994723	12035599	PLOD1	40876	0.534641
chr1	12040237	12073572	MFN2	33335	0.511144
chr1	12079298	12092106	MIIP	12808	0.557464
chr1	12123433	12204264	TNFRSF8	80831	0.505474
chr1	12227059	12269277	TNFRSF1B	42218	0.553934
chr1	12251761	12251839	MIR4632	78	0.692308
chr1	12290112	12572098	VPS13D	281986	0.423344
chr1	12567299	12567451	SNORA59B	152	0.539474
chr1	12627938	12677820	DHRS3	49882	0.512951
chr1	12704565	12727097	AADACL4	22532	0.472306
chr1	12776117	12788726	AADACL3	12609	0.461020
chr1	12806162	12821102	C1orf158	14940	0.427309
chr1	12834983	12838048	PRAMEF12	3065	0.532137
chr1	12851545	12856777	PRAMEF1	5232	0.465023
chr1	12884467	12891264	PRAMEF11	6797	0.479918
chr1	12907235	12908237	LOC649330	1002	0.478044
chr1	12916940	12921764	PRAMEF2	4824	0.471393
chr1	12939032	12946025	PRAMEF4	6993	0.481624
chr1	12952726	12958094	PRAMEF10	5368	0.478577
chr1	12976449	12980568	PRAMEF8	4119	0.498665
chr1	12998301	13007406	PRAMEF6	9105	0.476112
chr1	13035542	13038381	PRAMEF22	2839	0.514618
chr1	13182959	13184326	LOC440563	1367	0.460863
chr1	13328195	13331692	PRAMEF3	3497	0.492708
chr1	13359818	13369057	PRAMEF5	9239	0.474402
chr1	13386646	13390765	PRAMEF8	4119	0.499636
chr1	13421175	13428191	PRAMEF9	7016	0.481613
chr1	13447413	13452656	PRAMEF13	5243	0.465382
chr1	13474052	13477569	PRAMEF19	3517	0.492465
chr1	13495253	13498259	PRAMEF16	3006	0.500998
chr1	13516065	13526943	PRAMEF20	10878	0.474352
chr1	13607430	13611550	PRAMEF8	4120	0.499272
chr1	13629937	13635299	PRAMEF10	5362	0.480045
chr1	13641972	13648988	PRAMEF9	7016	0.481328
chr1	13694888	13698405	PRAMEF19	3517	0.492181
chr1	13716087	13719064	PRAMEF17	2977	0.500840
chr1	13736906	13747803	PRAMEF20	10897	0.475085
chr1	13801444	13840242	LRRC38	38798	0.500258
chr1	13910251	13944452	PDPN	34201	0.453671
chr1	14031349	14151574	PRDM2	120225	0.434860
chr1	14925212	15444544	KAZN	519332	0.490095
chr1	15438310	15478960	TMEM51-AS1	40650	0.490603
chr1	15480228	15546974	TMEM51	66746	0.480823
chr1	15573767	15724622	FHAD1	150855	0.474469
chr1	15653175	15670372	AK055853	17197	0.480200
chr1	15736390	15756839	EFHD2	20449	0.567705
chr1	15764937	15773153	CTRC	8216	0.516310
chr1	15783222	15798586	CELA2A	15364	0.482817
chr1	15802595	15817895	CELA2B	15300	0.483987
chr1	15817895	15850940	CASP9	33045	0.483280
chr1	15853351	15898228	DNAJC16	44877	0.427480
chr1	15898193	15911605	AGMAT	13412	0.493812
chr1	15943952	15987552	DDI2	43600	0.427982
chr1	15986363	15988217	RSC1A1	1854	0.428263
chr1	15992765	15995537	DQ573015	2772	0.404401
chr1	16010826	16061264	PLEKHM2	50438	0.519985
chr1	16062808	16067884	SLC25A34	5076	0.589835
chr1	16068986	16074292	TMEM82	5306	0.588014
chr1	16085254	16113084	FBLIM1	27830	0.528997
chr1	16133656	16134194	UQCRHL	538	0.447955
chr1	16160709	16174642	FLJ37453	13933	0.502476
chr1	16174358	16266950	SPEN	92592	0.429864
chr1	16268363	16302627	ZBTB17	34264	0.512170
chr1	16317618	16317647	DQ576383	29	0.586207
chr1	16330730	16333184	C1orf64	2454	0.538305
chr1	16340522	16345285	HSPB7	4763	0.614319
chr1	16348485	16360545	CLCNKA	12060	0.602819
chr1	16384263	16400127	FAM131C	15864	0.579488
chr1	16450831	16482582	EPHA2	31751	0.573273
chr1	16524598	16539104	ARHGEF19	14506	0.574934
chr1	16558181	16563659	RSG1	5478	0.540526
chr1	16576558	16678948	FBXO42	102390	0.438744
chr1	16693524	16724643	SZRD1	31119	0.485941
chr1	16725137	16763919	SPATA21	38782	0.504306
chr1	16767166	16786584	NECAP2	19418	0.493923
chr1	16793930	16819196	CROCCP3	25266	0.507322
chr1	16860349	16862144	BC036435	1795	0.586072
chr1	16862254	16864669	AX747988	2415	0.514700
chr1	16875408	16875482	MIR3675	74	0.418919
chr1	16888921	16940100	NBPF1	51179	0.440298
chr1	16944756	16959841	CROCCP2	15085	0.565661
chr1	16972068	16976915	MST1P2	4847	0.602022
chr1	17007749	17007823	MIR3675	74	0.418919
chr1	17017712	17046652	ESPNP	28940	0.605460
chr1	17248444	17299474	CROCC	51030	0.558103
chr1	17081128	17090975	MST1L	9847	0.515385
chr1	17185443	17185516	MIR3675	73	0.410959
chr1	17197439	17200574	AK125737	3135	0.591707
chr1	17215040	17216161	BC070363	1121	0.569135
chr1	17222645	17222720	DL489931	75	0.386667
chr1	17300998	17307173	MFAP2	6175	0.623158
chr1	17312452	17338423	ATP13A2	25971	0.572331
chr1	17345224	17380665	SDHB	35441	0.435202
chr1	17393255	17445948	PADI2	52693	0.517526
chr1	17531620	17572501	PADI1	40881	0.533059
chr1	17566189	17572501	PADI1	6312	0.539766
chr1	17575592	17610727	PADI3	35135	0.514814
chr1	17634689	17690495	PADI4	55806	0.490574
chr1	17698740	17728195	PADI6	29455	0.520421
chr1	17733250	17765059	RCC2	31809	0.514980
chr1	17866329	18024370	ARHGEF10L	158041	0.543555
chr1	18081807	18153558	ACTL8	71751	0.481526
chr1	18434239	18704977	IGSF21	270738	0.499117
chr1	18701063	18702174	AX747631	1111	0.512151
chr1	18807423	18812480	KLHDC7A	5057	0.581570
chr1	18957499	19062632	PAX7	105133	0.526552
chr1	19166092	19186155	TAS1R2	20063	0.496636
chr1	19197923	19229293	ALDH4A1	31370	0.550271
chr1	19209695	19209769	MIR4695	74	0.702703
chr1	19230773	19282826	IFFO2	52053	0.541679
chr1	19400999	19536746	UBR4	135747	0.437372
chr1	19542157	19578053	EMC1	35896	0.466403
chr1	19578074	19586622	MRTO4	8548	0.533458
chr1	19592475	19600568	AKR7L	8093	0.519091
chr1	19609056	19615280	AKR7A3	6224	0.543541
chr1	19619740	19622230	LOC100506730	2490	0.433735
chr1	19629201	19638640	AKR7A2	9439	0.523043
chr1	19638739	19655794	PQLC2	17055	0.550630
chr1	19665266	19812066	CAPZB	146800	0.492166
chr1	19673334	19675427	AX748283	2093	0.508361
chr1	19969722	19984949	NBL1	15227	0.581467
chr1	19923470	19956315	MINOS1	32845	0.429563
chr1	19934300	19935138	RPS14P3	838	0.460621
chr1	19991779	20006055	HTR6	14276	0.529350
chr1	20008705	20126410	TMCO4	117705	0.489104
chr1	20140521	20141771	RNF186	1250	0.580800
chr1	20208887	20239437	OTUD3	30550	0.413879
chr1	20246799	20250110	PLA2G2E	3311	0.599517
chr1	20301923	20306932	PLA2G2A	5009	0.521262
chr1	20396700	20418394	PLA2G5	21694	0.487923
chr1	20439142	20446059	PLA2G2D	6917	0.507012
chr1	20465822	20476879	PLA2G2F	11057	0.560098
chr1	20490483	20501687	PLA2G2C	11204	0.529365
chr1	20512577	20519942	UBXN10	7365	0.482824
chr1	20617411	20681387	VWA5B1	63976	0.503642
chr1	20686293	20755287	LOC339505	68994	0.482361
chr1	20808883	20812728	CAMK2N1	3845	0.577113
chr1	20825940	20834674	MUL1	8734	0.475842
chr1	20878931	20881513	FAM43B	2582	0.678544
chr1	20915443	20945400	CDA	29957	0.485362
chr1	20959947	20978004	PINK1	18057	0.507836
chr1	20978259	20988037	DDOST	9778	0.506136
chr1	20990506	21044317	KIF17	53811	0.524298
chr1	21046224	21059133	SH2D5	12909	0.613680
chr1	21069170	21113181	HP1BP3	44011	0.406648
chr1	21132784	21503381	EIF4G3	370597	0.393638
chr1	21543739	21616766	ECE1	73027	0.516672
chr1	21602542	21604868	AX747766	2326	0.506449
chr1	21619782	21626362	LOC100506801	6580	0.513222
chr1	21749600	21754300	AK098438	4700	0.436808
chr1	21761832	21762609	BC127868	777	0.606178
chr1	21766582	21811393	NBPF3	44811	0.431033
chr1	21835857	21904905	ALPL	69048	0.516365
chr1	21922707	21978348	RAP1GAP	55641	0.567693
chr1	22004791	22109688	USP48	104897	0.417753
chr1	22138757	22151714	LDLRAD2	12957	0.542950
chr1	22148736	22263750	HSPG2	115014	0.560793
chr1	22303417	22315847	CELA3B	12430	0.509976
chr1	22351706	22357715	LINC00339	6009	0.469462
chr1	22379119	22419436	CDC42	40317	0.418161
chr1	22443797	22469519	WNT4	25722	0.569746
chr1	22778343	22857650	ZBTB40	79307	0.426986
chr1	22890003	22930087	EPHA8	40084	0.568257
chr1	22963117	22966175	C1QA	3058	0.565729
chr1	22970117	22974603	C1QC	4486	0.546812
chr1	22979681	22988029	C1QB	8348	0.508265
chr1	23037330	23241823	EPHB2	204493	0.518649
chr1	23046009	23046091	MIR4684	82	0.524390
chr1	23189651	23189719	MIR4253	68	0.647059
chr1	23243782	23247347	AK025975	3565	0.526227
chr1	23337326	23342343	LOC729059	5017	0.458840
chr1	23345940	23410184	KDM1A	64244	0.391663
chr1	23370797	23370865	MIR3115	68	0.411765
chr1	23410515	23495517	LUZP1	85002	0.429449
chr1	23490445	23490546	U6	101	0.425743
chr1	23518387	23521222	HTR1D	2835	0.487478
chr1	23636275	23670853	HNRNPR	34578	0.400602
chr1	23685940	23694879	ZNF436	8939	0.439423
chr1	23695463	23698330	C1orf213	2867	0.517614
chr1	23707554	23751261	TCEA3	43707	0.485757
chr1	23755055	23810750	ASAP3	55695	0.495287
chr1	23801092	23803135	BC038455	2043	0.489476
chr1	23832919	23857712	E2F2	24793	0.516597
chr1	23853364	23855542	AX748204	2178	0.543159
chr1	23884420	23886285	ID3	1865	0.574799
chr1	23907984	23967056	MDS2	59072	0.495666
chr1	24018268	24022915	RPL11	4647	0.461803
chr1	24069855	24088549	TCEB3	18694	0.453568
chr1	24086871	24104787	LOC100506963	17916	0.456854
chr1	24104875	24114722	PITHD1	9847	0.446126
chr1	24117645	24122029	LYPLA2	4384	0.622719
chr1	24122088	24126060	GALE	3972	0.578298
chr1	24128366	24151949	HMGCL	23583	0.486834
chr1	24171571	24194859	FUCA1	23288	0.457918
chr1	24200459	24239817	CNR2	39358	0.479293
chr1	24255559	24255637	MIR378F	78	0.525641
chr1	24286300	24289949	PNRC2	3649	0.394355
chr1	24295572	24306953	SRSF10	11381	0.405940
chr1	24320925	24320957	DQ588542	32	0.718750
chr1	24382530	24438665	MYOM3	56135	0.526356
chr1	24446260	24469775	IL22RA1	23515	0.485307
chr1	24480646	24513765	IFNLR1	33119	0.470364
chr1	24526729	24538180	LOC284632	11451	0.504497
chr1	24578722	24578758	DQ597487	36	0.388889
chr1	24579767	24579803	DQ601330	36	0.527778
chr1	24645811	24690970	GRHL3	45159	0.510064
chr1	24683488	24740262	STPG1	56774	0.436379
chr1	24742244	24799473	NIPAL3	57229	0.449964
chr1	24822822	24828850	RCAN3AS	6028	0.460020
chr1	24829386	24863510	RCAN3	34124	0.422928
chr1	24882566	24935818	NCMAP	53252	0.479325
chr1	24969593	24999772	SRRM1	30179	0.398158
chr1	25071759	25170815	CLIC4	99056	0.416976
chr1	25226001	25256770	RUNX3	30769	0.557314
chr1	25548766	25559013	SYF2	10247	0.430370
chr1	25568739	25573985	C1orf63	5246	0.431376
chr1	25598980	25656936	RHD	57956	0.466440
chr1	25629228	25631643	AX747205	2415	0.477847
chr1	25664788	25688852	TMEM50A	24064	0.417345
chr1	25688739	25747363	RHCE	58624	0.467965
chr1	25757387	25826698	TMEM57	69311	0.406674
chr1	25870075	25895377	LDLRAP1	25302	0.546162
chr1	25943958	26111258	MAN1C1	167300	0.484937
chr1	26126666	26144713	SEPN1	18047	0.567684
chr1	26146396	26159433	MTFR1L	13037	0.488149
chr1	26146444	26150097	LOC646471	3653	0.562551
chr1	26160496	26185848	AUNIP	25352	0.421939
chr1	26187974	26197744	PAQR7	9770	0.513613
chr1	26210676	26232993	STMN1	22317	0.477573
chr1	26286257	26324648	PAFAH2	38391	0.456748
chr1	26348270	26362954	EXTL1	14684	0.554685
chr1	26364513	26372604	SLC30A2	8091	0.557162
chr1	26377795	26394125	TRIM63	16330	0.497428
chr1	26438267	26452039	PDIK1L	13772	0.415844
chr1	26485510	26489119	FAM110D	3609	0.597395
chr1	26496387	26497364	ZNF593	977	0.624360
chr1	26503980	26516375	CNKSR1	12395	0.551432
chr1	26517118	26529033	CATSPER4	11915	0.504490
chr1	26551810	26556331	BC030768	4521	0.491484
chr1	26560692	26605299	CEP85	44607	0.446836
chr1	26606212	26608013	SH3BGRL3	1801	0.636868
chr1	26608772	26633195	UBXN11	24423	0.554354
chr1	26644410	26647014	CD52	2604	0.544547
chr1	26648349	26680621	AIM1L	32272	0.521598
chr1	26688124	26699266	ZNF683	11142	0.525399
chr1	26737268	26756219	LIN28A	18951	0.465780
chr1	26758772	26797795	DHDDS	39023	0.454629
chr1	26789254	26794028	AL050085	4774	0.464181
chr1	26798901	26803133	HMGN2	4232	0.473771
chr1	26872342	26901520	RPS6KA1	29178	0.523922
chr1	26881032	26881084	MIR1976	52	0.615385
chr1	27022521	27108601	ARID1A	86080	0.459305
chr1	27114453	27124894	PIGV	10441	0.475338
chr1	27145536	27392034	BC016143	246498	0.504032
chr1	27153200	27182211	ZDHHC18	29011	0.511427
chr1	27189632	27190947	SFN	1315	0.627376
chr1	27189786	27190449	SFN	663	0.628959
chr1	27205872	27216869	GPN2	10997	0.495772
chr1	27216978	27226962	GPATCH3	9984	0.501202
chr1	27237974	27240567	NR0B2	2593	0.532588
chr1	27248212	27273362	NUDC	25150	0.485169
chr1	27276046	27286901	C1orf172	10855	0.512667
chr1	27320194	27327377	TRNP1	7183	0.557845
chr1	27331510	27339333	FAM46B	7823	0.555158
chr1	27425299	27481621	SLC9A1	56322	0.526775
chr1	27533765	27533868	DL490887	103	0.485437
chr1	27561006	27635124	WDTC1	74118	0.465110
chr1	27648635	27662891	TMEM222	14256	0.518729
chr1	27650364	27653016	LOC644961	2652	0.471342
chr1	27668482	27680423	SYTL1	11941	0.582782
chr1	27681669	27693337	MAP3K6	11668	0.607816
chr1	27695600	27701315	FCN3	5715	0.544357
chr1	27705595	27709805	CD164L2	4210	0.600238
chr1	27719147	27722317	GPR3	3170	0.580126
chr1	27730733	27816678	WASF2	85945	0.440084
chr1	27860755	27930143	AHDC1	69388	0.562287
chr1	27938800	27961727	FGR	22927	0.529201
chr1	27992571	27998724	IFI6	6153	0.500569
chr1	28052489	28089423	FAM76A	36934	0.434369
chr1	28099693	28150963	STX12	51270	0.414082
chr1	28157251	28178183	PPP1R8	20932	0.444678
chr1	28160911	28161077	SCARNA1	166	0.403614
chr1	28199054	28213193	THEMIS2	14139	0.540420
chr1	28218048	28241236	RPA2	23188	0.441521
chr1	28261503	28285663	SMPDL3B	24160	0.498634
chr1	28286503	28294604	XKR8	8101	0.549685
chr1	28296854	28415148	EYA3	118294	0.395143
chr1	28473676	28503455	PTAFR	29779	0.487928
chr1	28526789	28559542	DNAJC8	32753	0.430342
chr1	28562601	28564616	ATPIF1	2015	0.508189
chr1	28567542	28567564	JA611241	22	0.500000
chr1	28585962	28609002	SESN2	23040	0.501346
chr1	28655512	28662478	MED18	6966	0.460523
chr1	28764660	28826881	PHACTR4	62221	0.432748
chr1	28844744	28865708	RCC1	20964	0.515550
chr1	28832454	28837404	SNHG3	4950	0.464646
chr1	28879528	28905057	TRNAU1AP	25529	0.476909
chr1	28905049	28908383	SNHG12	3334	0.496701
chr1	28905254	28905334	SNORD99	80	0.487500
chr1	28919006	28921088	RAB42	2082	0.598463
chr1	28929608	28969604	TAF12	39996	0.454370
chr1	28975111	28975246	RNU11	135	0.511111
chr1	28995239	29042115	GMEB1	46876	0.461046
chr1	29016176	29016306	SCARNA24	130	0.346154
chr1	29063132	29096287	YTHDF2	33155	0.435741
chr1	29138653	29190208	OPRD1	51555	0.499156
chr1	29213602	29446558	EPB41	232956	0.418676
chr1	29445936	29450421	TMEM200B	4485	0.644816
chr1	29474249	29508637	SRSF4	34388	0.431255
chr1	29519384	29557454	MECR	38070	0.482138
chr1	29563027	29653325	PTPRU	90298	0.515825
chr1	30486798	30510456	BC042538	23658	0.427128
chr1	31184123	31196432	MATN1	12309	0.563653
chr1	31191618	31199593	MATN1-AS1	7975	0.561128
chr1	31205314	31230683	LAPTM5	25369	0.526272
chr1	31212002	31212079	MIR4420	77	0.493506
chr1	31342312	31381480	SDC3	39168	0.556245
chr1	31404352	31538564	PUM1	134212	0.409896
chr1	31408535	31408623	SNORD103A	88	0.443182
chr1	31421964	31422052	SNORD103A	88	0.443182
chr1	31441009	31441084	SNORD85	75	0.466667
chr1	31652591	31712734	NKAIN1	60143	0.506360
chr1	31732414	31742513	SNRNP40	10099	0.417764
chr1	31732414	31769644	SNRNP40	37230	0.420279
chr1	31769841	31837780	ZCCHC17	67939	0.418640
chr1	31838099	31845923	FABP3	7824	0.491564
chr1	31886659	31907527	SERINC2	20868	0.521468
chr1	31971838	31974167	LOC149086	2329	0.537999
chr1	31984035	31989846	LOC284551	5811	0.460850
chr1	32042085	32053287	TINAGL1	11202	0.554812
chr1	32083300	32092919	HCRTR1	9619	0.560869
chr1	32095462	32110838	PEF1	15376	0.485952
chr1	32117847	32169768	COL16A1	51921	0.559504
chr1	32192717	32229648	BAI2	36931	0.584225
chr1	32224260	32224336	MIR4254	76	0.657895
chr1	32256024	32281580	SPOCD1	25556	0.492644
chr1	32372021	32403988	PTP4A2	31967	0.400851
chr1	32479294	32509482	KHDRBS1	30188	0.436332
chr1	32538502	32568467	TMEM39B	29965	0.487903
chr1	32573643	32642168	KPNA6	68525	0.442087
chr1	32645344	32663886	TXLNA	18542	0.502265
chr1	32666201	32670991	CCDC28B	4790	0.548434
chr1	32671235	32674288	IQCC	3053	0.554864
chr1	32674694	32681797	DCDC2B	7103	0.531325
chr1	32681797	32687926	TMEM234	6129	0.503182
chr1	32687958	32697205	EIF3I	9247	0.497675
chr1	32697260	32707311	MTMR9LP	10051	0.526614
chr1	32712817	32714461	FAM167B	1644	0.600973
chr1	32739711	32751766	LCK	12055	0.513065
chr1	32757707	32799224	HDAC1	41517	0.467760
chr1	32799429	32801840	MARCKSL1	2411	0.637495
chr1	32826870	32827844	FAM229A	974	0.718686
chr1	32827861	32829924	TSSK3	2063	0.558410
chr1	32830704	32860062	BSDC1	29358	0.478541
chr1	32930657	32953459	ZBTB8B	22802	0.465880
chr1	33004771	33071542	ZBTB8A	66771	0.434964
chr1	33087306	33116185	ZBTB8OS	28879	0.440147
chr1	33116748	33151812	RBBP4	35064	0.429358
chr1	33145506	33168361	SYNC	22855	0.471363
chr1	33207511	33240571	KIAA1522	33060	0.543557
chr1	33240839	33283633	YARS	42794	0.462915
chr1	33283118	33324480	S100PBP	41362	0.410884
chr1	33327868	33338082	FNDC5	10214	0.540043
chr1	33352097	33360247	HPCA	8150	0.560000
chr1	33360195	33366953	TMEM54	6758	0.569547
chr1	33402049	33430286	RNF19B	28237	0.443390
chr1	33452675	33498070	BC036308	45395	0.461835
chr1	33476825	33502512	AK2	25687	0.445245
chr1	33546713	33585995	ADC	39282	0.459116
chr1	33607471	33608831	AX747064	1360	0.491176
chr1	33611002	33647671	TRIM62	36669	0.518558
chr1	33722173	33766320	ZNF362	44147	0.505425
chr1	33772366	33786699	A3GALT2	14333	0.541896
chr1	33789223	33841194	PHC2	51971	0.490716
chr1	33797993	33798093	MIR3605	100	0.550000
chr1	33802166	33802465	7SK	299	0.541806
chr1	33938231	33961995	ZSCAN20	23764	0.433555
chr1	33979608	34631443	CSMD2	651835	0.452090
chr1	34326075	34330392	HMGB4	4317	0.454251
chr1	34334556	34351059	LOC402779	16503	0.445071
chr1	34642552	34684731	C1orf94	42179	0.479599
chr1	35220647	35224113	GJB5	3466	0.541546
chr1	35225341	35229325	GJB4	3984	0.561245
chr1	35247910	35251967	GJB3	4057	0.536357
chr1	35258598	35261348	GJA4	2750	0.593455
chr1	35315962	35325417	SMIM12	9455	0.474987
chr1	35331036	35370984	DLGAP3	39948	0.479649
chr1	35441299	35444307	LOC653160	3008	0.555851
chr1	35447126	35450948	ZMYM6NB	3822	0.516745
chr1	35451766	35497569	ZMYM6	45803	0.388031
chr1	35544971	35581455	ZMYM1	36484	0.413935
chr1	35641980	35646083	AL831889	4103	0.401901
chr1	35649200	35658743	SFPQ	9543	0.436236
chr1	35734567	35887545	ZMYM4	152978	0.386454
chr1	35833677	35835012	AF119915	1335	0.306367
chr1	35899090	36023037	KIAA0319L	123947	0.417808
chr1	36023392	36032380	NCDN	8988	0.577993
chr1	36065142	36107445	PSMB2	42303	0.410987
chr1	36038970	36060927	TFAP2E	21957	0.525391
chr1	36179476	36184790	C1orf216	5314	0.539330
chr1	36197712	36235551	CLSPN	37839	0.414097
chr1	36273827	36323490	AGO4	49663	0.414997
chr1	36348809	36389899	AGO1	41090	0.453444
chr1	36391432	36395210	AK025726	3778	0.426681
chr1	36396682	36522063	AGO3	125381	0.388217
chr1	36549675	36553876	TEKT2	4201	0.583194
chr1	36554452	36559533	ADPRHL2	5081	0.551663
chr1	36560843	36565850	COL8A2	5007	0.605552
chr1	36602169	36615115	TRAPPC3	12946	0.472424
chr1	36621802	36646441	MAP7D1	24639	0.542230
chr1	36690016	36770957	THRAP3	80941	0.437183
chr1	36771993	36787379	SH3D21	15386	0.515469
chr1	36787631	36789755	EVA1B	2124	0.701977
chr1	36805224	36851485	STK40	46261	0.522773
chr1	36859030	36863493	LSM10	4463	0.509075
chr1	36883506	36916086	OSCP1	32580	0.451688
chr1	36921361	36930040	MRPS15	8679	0.493029
chr1	36931643	36948915	CSF3R	17272	0.531612
chr1	37261127	37499844	GRIK3	238717	0.495897
chr1	37627163	37627235	MIR4255	72	0.472222
chr1	37920479	37940044	LOC728431	19565	0.468081
chr1	37940118	37949978	ZC3H12A	9860	0.593915
chr1	37955560	37980420	MEAF6	24860	0.429485
chr1	37966535	37966595	MIR5581	60	0.483333
chr1	38000049	38019945	SNIP1	19896	0.432298
chr1	38022519	38032458	DNALI1	9939	0.492504
chr1	38032412	38061586	GNL2	29174	0.428121
chr1	38076950	38100595	RSPO1	23645	0.525650
chr1	38147241	38156192	C1orf109	8951	0.461848
chr1	38147242	38149864	AX747480	2622	0.408085
chr1	38158072	38175391	CDCA8	17319	0.458283
chr1	38181645	38230824	EPHA10	49179	0.503284
chr1	38259773	38267278	MANEAL	7505	0.537508
chr1	38268613	38273865	YRDC	5252	0.495240
chr1	38273472	38275126	C1orf122	1654	0.677146
chr1	38275238	38325292	MTF1	50054	0.436069
chr1	38326368	38412729	INPP5B	86361	0.466414
chr1	38349908	38349989	SNORA63	81	0.370370
chr1	38422651	38455761	SF3A3	33110	0.443854
chr1	38462441	38471187	FHL3	8746	0.565173
chr1	38478383	38490497	UTP11L	12114	0.436024
chr1	38509522	38512450	POU3F1	2928	0.632514
chr1	38554902	38555001	MIR3659	99	0.474747
chr1	38674705	38680439	LOC339442	5734	0.512208
chr1	39303868	39325495	RRAGC	21627	0.414528
chr1	39328161	39339050	MYCBP	10889	0.433740
chr1	39340222	39341770	GJA9	1548	0.424419
chr1	39351478	39407456	RHBDL2	55978	0.446014
chr1	39456915	39471737	AKIRIN1	14822	0.438605
chr1	39491966	39500308	NDUFS5	8342	0.465836
chr1	39549838	39952810	MACF1	402972	0.424561
chr1	39875175	39882154	KIAA0754	6979	0.485886
chr1	39957317	39995541	BMP8A	38224	0.547509
chr1	39987951	40025370	PPIEL	37419	0.476950
chr1	40026484	40042521	PABPC4	16037	0.473655
chr1	40033045	40033182	SNORA55	137	0.518248
chr1	40089102	40105348	HEYL	16246	0.516189
chr1	40124792	40137710	NT5C1A	12918	0.521830
chr1	40144644	40157089	HPCAL4	12445	0.523986
chr1	40204516	40229586	PPIE	25070	0.477982
chr1	40223902	40254533	BMP8B	30631	0.560641
chr1	40235196	40237020	OXCT2	1824	0.633772
chr1	40306705	40349177	TRIT1	42472	0.424609
chr1	40361095	40367687	MYCL1	6592	0.531098
chr1	40420783	40435628	MFSD2A	14845	0.536948
chr1	40506254	40538321	CAP1	32067	0.430411
chr1	40538381	40563142	PPT1	24761	0.440612
chr1	40627040	40706593	RLF	79553	0.396918
chr1	40713572	40717365	TMCO2	3793	0.409175
chr1	40723721	40759856	ZMPSTE24	36135	0.407998
chr1	40766162	40782981	COL9A2	16819	0.572269
chr1	40839377	40888998	SMAP2	49621	0.416638
chr1	40916336	40929390	ZFP69B	13054	0.410449
chr1	40943301	40962015	ZFP69	18714	0.403922
chr1	40974432	40982214	EXO5	7782	0.436520
chr1	40997232	41013841	ZNF684	16609	0.403095
chr1	41086351	41131324	RIMS3	44973	0.513908
chr1	41154751	41157933	LOC100130557	3182	0.474859
chr1	41157241	41237275	NFYC	80034	0.426631
chr1	41220026	41220118	MIR30E	92	0.510870
chr1	41222955	41223044	MIR30C1	89	0.505618
chr1	41249683	41306124	KCNQ4	56441	0.554242
chr1	41326727	41328018	CITED4	1291	0.736638
chr1	41445006	41478235	CTPS1	33229	0.452707
chr1	41480261	41509562	SLFNL1-AS1	29301	0.499744
chr1	41481268	41487427	SLFNL1	6159	0.584835
chr1	41492870	41707815	SCMH1	214945	0.394999
chr1	41944445	41949874	EDN2	5429	0.563087
chr1	41944445	41950344	EDN2	5899	0.569758
chr1	41972035	42384496	HIVEP3	412461	0.480387
chr1	42619091	42621495	GUCA2B	2404	0.599418
chr1	42628361	42630395	GUCA2A	2034	0.575713
chr1	42642209	42800903	FOXJ3	158694	0.384596
chr1	42846467	42889900	RIMKLA	43433	0.436488
chr1	42896000	42921938	ZMYND12	25938	0.428291
chr1	42922172	42926086	PPCS	3914	0.459377
chr1	43000559	43120335	CCDC30	119776	0.396866
chr1	43124047	43142429	PPIH	18382	0.438581
chr1	43144356	43147330	AF086102	2974	0.440820
chr1	43148065	43168020	YBX1	19955	0.404510
chr1	43198763	43205925	CLDN19	7162	0.595644
chr1	43212005	43232755	LEPRE1	20750	0.500337
chr1	43232915	43241413	C1orf50	8498	0.431043
chr1	43253660	43263901	LOC100129924	10241	0.463138
chr1	43272722	43283059	CCDC23	10337	0.418980
chr1	43291248	43310660	ERMAP	19412	0.440140
chr1	43312243	43318146	ZNF691	5903	0.472641
chr1	43323292	43354460	BC043541	31168	0.426688
chr1	43391045	43424847	SLC2A1	33802	0.528933
chr1	43424719	43449029	SLC2A1-AS1	24310	0.485479
chr1	43489219	43489308	U6	89	0.370787
chr1	43585818	43611958	AK309744	26140	0.404858
chr1	43613593	43622067	FAM183A	8474	0.441586
chr1	43629844	43638241	EBNA1BP2	8397	0.450399
chr1	43638000	43720029	WDR65	82029	0.439942
chr1	43735664	43739673	TMEM125	4009	0.583188
chr1	43747556	43751250	C1orf210	3694	0.538170
chr1	43766565	43788781	TIE1	22216	0.546183
chr1	43803474	43820135	MPL	16661	0.481724
chr1	43824625	43828873	CDC20	4248	0.522128
chr1	43829067	43833409	ELOVL1	4342	0.574620
chr1	43849578	43855483	MED8	5905	0.467739
chr1	43855555	43919918	SZT2	64363	0.502338
chr1	43916673	43919660	HYI	2987	0.593572
chr1	43996546	44089343	PTPRF	92797	0.559792
chr1	44115796	44171189	KDM4A	55393	0.467640
chr1	44165355	44173012	KDM4A-AS1	7657	0.486091
chr1	44173203	44396837	ST3GAL3	223634	0.442424
chr1	44182137	44182227	U6	90	0.355556
chr1	44398991	44402912	ARTN	3921	0.637592
chr1	44412477	44433694	IPO13	21217	0.518028
chr1	44435652	44439043	DPH2	3391	0.560897
chr1	44440601	44443972	ATP6V0B	3371	0.556511
chr1	44445607	44456843	B4GALT2	11236	0.550107
chr1	44462154	44483012	SLC6A9	20858	0.566881
chr1	44457279	44462198	CCDC24	4919	0.575727
chr1	44584521	44600809	KLF17	16288	0.453647
chr1	44679124	44686351	DMAP1	7227	0.523454
chr1	44686741	44820939	ERI3	134198	0.477272
chr1	44870959	45117396	RNF220	246437	0.471999
chr1	45011164	45011224	MIR5584	60	0.416667
chr1	45119500	45140099	TMEM53	20599	0.492888
chr1	45140393	45191263	C1orf228	50870	0.475329
chr1	45205489	45233438	KIF2C	27949	0.490787
chr1	45241245	45244412	RPS8	3167	0.549100
chr1	45241536	45241610	SNORD55	74	0.567568
chr1	45242163	45242261	SNORD46	98	0.489796
chr1	45243513	45243584	SNORD38A	71	0.464789
chr1	45244061	45244130	SNORD38B	69	0.405797
chr1	45249256	45253426	BEST4	4170	0.591367
chr1	45266035	45271667	PLK3	5632	0.595526
chr1	45271585	45272957	TCTEX1D4	1372	0.637755
chr1	45274153	45279801	BTBD19	5648	0.581091
chr1	45287937	45308616	PTCH2	20679	0.531360
chr1	45316193	45452394	EIF2B3	136201	0.425481
chr1	45468219	45477027	HECTD3	8808	0.566985
chr1	45477804	45481341	UROD	3537	0.520780
chr1	45482075	45672250	ZSWIM5	190175	0.404328
chr1	45769581	45771291	LOC400752	1710	0.569006
chr1	45792544	45794346	HPDL	1802	0.610988
chr1	45794913	45806142	MUTYH	11229	0.510909
chr1	45805341	45809650	TOE1	4309	0.535159
chr1	45809554	45956840	TESK2	147286	0.422274
chr1	45959597	45965751	CCDC163P	6154	0.511050
chr1	45965855	45976739	MMACHC	10884	0.486494
chr1	45976706	45988562	PRDX1	11856	0.473516
chr1	46016454	46035723	AKR1A1	19269	0.489854
chr1	46049659	46084578	NASP	34919	0.428134
chr1	46085715	46089731	CCDC17	4016	0.581175
chr1	46092975	46152302	GPBP1L1	59327	0.408465
chr1	46111451	46112357	RPS15AP10	906	0.405077
chr1	46153846	46160108	TMEM69	6262	0.437560
chr1	46164406	46216485	IPP	52079	0.425507
chr1	46269284	46501796	MAST2	232512	0.411437
chr1	46505811	46598380	PIK3R3	92569	0.401798
chr1	46640748	46651634	TSPAN1	10886	0.507073
chr1	46654352	46685977	POMGNT1	31625	0.493850
chr1	46669005	46686928	LURAP1	17923	0.467946
chr1	46713366	46744145	RAD54L	30779	0.464992
chr1	46744071	46769038	LRRC41	24967	0.481436
chr1	46769379	46782447	UQCRH	13068	0.462427
chr1	46805848	46830824	NSUN4	24976	0.473455
chr1	46859938	46879520	FAAH	19582	0.553774
chr1	46899498	46911374	LOC729041	11876	0.508505
chr1	46972667	46979886	DMBX1	7219	0.559496
chr1	47004367	47035927	MKNK1-AS1	31560	0.524556
chr1	47011315	47015678	KNCN	4363	0.553747
chr1	47011315	47016887	KNCN	5572	0.566942
chr1	47023078	47069966	MKNK1	46888	0.469203
chr1	47073386	47080805	MOB3C	7419	0.532147
chr1	47100710	47134099	ATPAF1	33389	0.406331
chr1	47140830	47184736	EFCAB14	43906	0.401676
chr1	47137496	47139256	TEX38	1760	0.517614
chr1	47139707	47157769	EFCAB14-AS1	18062	0.397686
chr1	47264669	47285021	CYP4B1	20352	0.496561
chr1	47308766	47366147	CYP4Z2P	57381	0.400969
chr1	47394845	47407156	CYP4A11	12311	0.484526
chr1	47489239	47516423	CYP4X1	27184	0.392142
chr1	47533159	47583992	CYP4Z1	50833	0.397734
chr1	47603106	47614526	CYP4A22	11420	0.484501
chr1	47644921	47646011	LINC00853	1090	0.560550
chr1	47649260	47655771	PDZK1IP1	6511	0.575795
chr1	47681962	47689770	TAL1	7808	0.502561
chr1	47681962	47695443	TAL1	13481	0.529115
chr1	47691628	47691655	JA375062	27	0.592593
chr1	47715810	47779819	STIL	64009	0.400178
chr1	47799468	47844511	CMPK1	45043	0.421952
chr1	47859449	47861215	AX748181	1766	0.411665
chr1	47881743	47883724	FOXE3	1981	0.682484
chr1	47897806	47900313	FOXD2-AS1	2507	0.587156
chr1	47901688	47906363	FOXD2	4675	0.649198
chr1	48226199	48462562	TRABD2B	236363	0.487479
chr1	48567386	48648100	SKINTL	80714	0.390899
chr1	48688356	48714316	SLC5A9	25960	0.489946
chr1	48761043	48937876	SPATA6	176833	0.370389
chr1	48998526	50489626	AGBL4	1491100	0.390490
chr1	49193539	49242547	BEND5	49008	0.439724
chr1	50574593	50667540	ELAVL4	92947	0.405930
chr1	50883222	50889119	DMRTA2	5897	0.601831
chr1	50906934	51425936	FAF1	519002	0.382392
chr1	51048075	51048183	U6	108	0.379630
chr1	51435641	51440309	CDKN2C	4668	0.354113
chr1	51567905	51613754	C1orf185	45849	0.378896
chr1	51701944	51739119	RNF11	37175	0.412428
chr1	51752929	51810785	TTC39A	57856	0.514000
chr1	51819934	51984995	EPS15	165061	0.380526
chr1	52004296	52004401	U6	105	0.371429
chr1	52082545	52254891	OSBPL9	172346	0.389849
chr1	52254865	52344609	NRD1	89744	0.393475
chr1	52373627	52456436	RAB3B	82809	0.443744
chr1	52485803	52521843	TXNDC12	36040	0.430300
chr1	52497776	52499472	KTI12	1696	0.553656
chr1	52521856	52556388	BTF3L4	34532	0.411415
chr1	52607765	52812358	ZFYVE9	204593	0.408391
chr1	52816264	52831877	CC2D1B	15613	0.537501
chr1	52838500	52870143	ORC1	31643	0.447714
chr1	52870218	52883992	PRPF38A	13774	0.421156
chr1	52870218	52883992	PRPF38A	13774	0.421156
chr1	52888947	53018762	ZCCHC11	129815	0.383330
chr1	53068042	53074723	GPX7	6681	0.496782
chr1	53099065	53122737	FAM159A	23672	0.444111
chr1	53152013	53164038	SELRC1	12025	0.466112
chr1	53192130	53293013	ZYG11B	100883	0.412894
chr1	53308182	53360247	ZYG11A	52065	0.436090
chr1	53361581	53387591	ECHDC2	26010	0.476471
chr1	53392900	53517289	SCP2	124389	0.400172
chr1	53527723	53551174	PODN	23451	0.560232
chr1	53552854	53608289	SLC1A7	55435	0.531866
chr1	53580247	53584281	AX748428	4034	0.567427
chr1	53662100	53679869	CPT2	17769	0.446789
chr1	53679771	53686289	C1orf123	6518	0.469316
chr1	53692563	53704282	MAGOH	11719	0.416332
chr1	53704281	53708455	LOC100507564	4174	0.448970
chr1	53708040	53793821	LRP8	85781	0.518075
chr1	53793904	53802889	AK097571	8985	0.482582
chr1	53904042	53905693	SLC25A3P1	1651	0.652938
chr1	53925071	53933158	DMRTB1	8087	0.549400
chr1	53971905	54199877	GLIS1	227972	0.507562
chr1	54231133	54304225	NDC1	73092	0.402315
chr1	54317391	54355487	YIPF1	38096	0.434481
chr1	54359860	54376759	DIO1	16899	0.481330
chr1	54387233	54411288	HSPB11	24055	0.393806
chr1	54411998	54433841	LRRC42	21843	0.427093
chr1	54472970	54483859	LDLRAD1	10889	0.537148
chr1	54497348	54519111	TMEM59	21763	0.386252
chr1	54519273	54565416	TCEANC2	46143	0.413280
chr1	54519751	54519827	MIR4781	76	0.539474
chr1	54604667	54618679	CDCP2	14012	0.480445
chr1	54638026	54665746	CYB5RL	27720	0.489755
chr1	54665839	54684056	MRPL37	18217	0.481583
chr1	54691103	54872068	SSBP3	180965	0.508745
chr1	55013806	55076005	ACOT11	62199	0.519076
chr1	55074849	55089200	FAM151A	14351	0.518013
chr1	55107426	55175939	MROH7	68513	0.485470
chr1	55181494	55208328	TTC4	26834	0.420660
chr1	55222570	55230226	PARS2	7656	0.498694
chr1	55246751	55266941	TTC22	20190	0.523774
chr1	55271735	55307937	C1orf177	36202	0.470803
chr1	55315299	55352921	DHCR24	37622	0.477088
chr1	55352654	55353883	HP08874	1229	0.624898
chr1	55446464	55457966	TMEM61	11502	0.529212
chr1	55464616	55474465	BSND	9849	0.517616
chr1	55505148	55530526	PCSK9	25378	0.555481
chr1	55532031	55681039	USP24	149008	0.378503
chr1	55681080	55683128	LOC100507634	2048	0.476074
chr1	55691313	55691396	MIR4422	83	0.506024
chr1	55842198	55842525	7SK	327	0.516820
chr1	56046709	56200675	AK127270	153966	0.402621
chr1	56960418	57045257	PPAP2B	84839	0.430156
chr1	57110989	57181008	PRKAA2	70019	0.365972
chr1	57184476	57285369	C1orf168	100893	0.384843
chr1	57289353	57292593	BC048114	3240	0.463580
chr1	57320442	57383894	C8A	63452	0.405598
chr1	57394882	57431688	C8B	36806	0.428164
chr1	57463578	58716211	DAB1	1252633	0.408208
chr1	58326214	58328786	BC047487	2572	0.380638
chr1	58933598	58934677	AX746780	1079	0.456905
chr1	58946390	59012446	OMA1	66056	0.363888
chr1	59041094	59043166	TACSTD2	2072	0.593147
chr1	59120410	59165747	MYSM1	45337	0.363125
chr1	59246462	59249785	JUN	3323	0.559735
chr1	59250822	59365384	LOC100131060	114562	0.431068
chr1	59597607	59612479	HSD52	14872	0.435315
chr1	59762624	60228402	FGGY	465778	0.405610
chr1	60198898	60198968	MIR4711	70	0.471429
chr1	60238466	60254501	BC042048	16035	0.388712
chr1	60280532	60342050	HOOK1	61518	0.343200
chr1	60358979	60392423	CYP2J2	33444	0.397590
chr1	60454823	60539442	C1orf87	84619	0.382845
chr1	61125302	61291256	AK097193	165954	0.397773
chr1	61405915	61436448	BC030753	30533	0.424754
chr1	61547533	61928460	NFIA	380927	0.387980
chr1	62119913	62121800	MGC34796	1887	0.502385
chr1	62146718	62191095	TM2D1	44377	0.396354
chr1	62208148	62629591	INADL	421443	0.404301
chr1	62318170	62318274	U6	104	0.403846
chr1	62660473	62678001	L1TD1	17528	0.433136
chr1	62701836	62785083	KANK4	83247	0.469494
chr1	62901974	62917475	USP1	15501	0.394620
chr1	62920396	63154039	DOCK7	233643	0.360738
chr1	63063157	63071976	ANGPTL3	8819	0.294931
chr1	63249776	63330941	ATG4C	81165	0.354586
chr1	63624753	63782901	LINC00466	158148	0.393252
chr1	63704613	63704845	7SK	232	0.452586
chr1	63788729	63790797	FOXD3	2068	0.639749
chr1	63799429	63799491	U7	62	0.387097
chr1	63833260	63904233	ALG6	70973	0.379327
chr1	63906440	63988944	ITGB3BP	82504	0.369909
chr1	63989012	64038364	EFCAB7	49352	0.351556
chr1	64014650	64016307	DLEU2L	1657	0.316234
chr1	64088886	64125916	PGM1	37030	0.414421
chr1	64239689	64647179	ROR1	407490	0.409706
chr1	64571005	64636980	AK096291	65975	0.410201
chr1	64669489	64710027	UBE2U	40538	0.368395
chr1	64936475	65158741	CACHD1	222266	0.399224
chr1	65045529	65045604	MIR4794	75	0.400000
chr1	65210777	65298914	RAVER2	88137	0.372046
chr1	65298905	65432187	JAK1	133282	0.426907
chr1	65445259	65468159	BC035370	22900	0.422314
chr1	65488650	65488757	U6	107	0.280374
chr1	65523437	65523525	MIR3671	88	0.272727
chr1	65524116	65524191	MIR101-1	75	0.453333
chr1	65613231	65697828	AK4	84597	0.426162
chr1	65775217	65881552	DNAJC6	106335	0.395119
chr1	65886130	66103176	LEPR	217046	0.378689
chr1	65886130	65901690	LEPROT	15560	0.410540
chr1	66258855	66840262	PDE4B	581407	0.374120
chr1	66560143	66560229	U4	86	0.372093
chr1	66999824	67210768	SGIP1	210944	0.378759
chr1	67094122	67094200	MIR3117	78	0.461538
chr1	67132271	67142710	AK298300	10439	0.382699
chr1	67218139	67244730	TCTEX1D1	26591	0.372607
chr1	67263423	67266942	INSL5	3519	0.373117
chr1	67278571	67390570	WDR78	111999	0.364396
chr1	67390577	67454302	MIER1	63725	0.361491
chr1	67465014	67520080	SLC35D1	55066	0.380017
chr1	67557858	67600654	C1orf141	42796	0.378447
chr1	67632168	67725650	IL23R	93482	0.398858
chr1	67661822	67661926	U6	104	0.423077
chr1	67773046	67862583	IL12RB2	89537	0.416543
chr1	67873492	67896123	SERBP1	22631	0.389024
chr1	68150859	68154021	GADD45A	3162	0.527514
chr1	68167148	68299155	GNG12	132007	0.415463
chr1	68238275	68238336	U7	61	0.409836
chr1	68297970	68668670	GNG12-AS1	370700	0.402797
chr1	68511644	68516481	DIRAS3	4837	0.445111
chr1	68564141	68698284	WLS	134143	0.415229
chr1	68649200	68649293	MIR1262	93	0.354839
chr1	68649301	68649321	JB175146	20	0.400000
chr1	68894506	68915642	RPE65	21136	0.388200
chr1	68939834	68962799	DEPDC1	22965	0.347616
chr1	68962358	69004310	BC020917	41952	0.363892
chr1	70225857	70589171	LRRC7	363314	0.355045
chr1	70385004	70386000	PIN1P1	996	0.609438
chr1	70610484	70671361	LRRC40	60877	0.351791
chr1	70671364	70717701	SRSF11	46337	0.371604
chr1	70724684	70820417	ANKRD13C	95733	0.375127
chr1	70820492	70833705	HHLA3	13213	0.426777
chr1	70876900	70905534	CTH	28634	0.395055
chr1	71172135	71252151	BC041441	80016	0.380236
chr1	71418114	71513491	PTGER3	95377	0.380658
chr1	71512188	71532865	ZRANB2-AS1	20677	0.394206
chr1	71528973	71546972	ZRANB2	17999	0.341908
chr1	71533313	71533399	MIR186	86	0.360465
chr1	71547006	71703406	ZRANB2-AS2	156400	0.377270
chr1	71868624	72748405	NEGR1	879781	0.349195
chr1	72259914	72302695	NEGR1-IT1	42781	0.362638
chr1	73771852	73804560	BC041341	32708	0.338327
chr1	74491701	74663871	LRRIQ3	172170	0.340019
chr1	74663895	75010116	FPGT-TNNI3K	346221	0.365186
chr1	75033794	75139422	C1orf173	105628	0.364572
chr1	75043113	75091782	CR627203	48669	0.358175
chr1	75171171	75199092	CRYZ	27921	0.396118
chr1	75198835	75232360	TYW3	33525	0.402655
chr1	75600566	75627218	LHX8	26652	0.377608
chr1	75595658	75598261	AK055631	2603	0.528237
chr1	75672074	76076799	SLC44A5	404725	0.370276
chr1	76103850	76188721	CR936677	84871	0.386434
chr1	76190042	76229355	ACADM	39313	0.397019
chr1	76251878	76260775	RABGGTB	8897	0.378555
chr1	76252756	76252834	SNORD45C	78	0.346154
chr1	76253573	76253657	SNORD45A	84	0.357143
chr1	76255161	76255232	SNORD45B	71	0.352113
chr1	76262555	76378923	MSH4	116368	0.370102
chr1	76384557	76398116	ASB17	13559	0.351648
chr1	76540388	77096669	ST6GALNAC3	556281	0.388063
chr1	77333185	77529737	ST6GALNAC5	196552	0.399660
chr1	77554666	77685132	PIGK	130466	0.358392
chr1	77747661	78025654	AK5	277993	0.396165
chr1	78030189	78148343	ZZZ3	118154	0.370626
chr1	78161673	78225564	USP33	63891	0.383700
chr1	78245308	78345225	FAM73A	99917	0.395308
chr1	78354199	78409578	NEXN	55379	0.390635
chr1	78413590	78444777	FUBP1	31187	0.370058
chr1	78470635	78482995	DNAJB4	12360	0.349676
chr1	78511588	78603112	GIPC2	91524	0.398529
chr1	78695282	78759574	MGC27382	64292	0.392086
chr1	78956727	79006386	PTGFR	49659	0.369701
chr1	79086087	79111830	IFI44L	25743	0.344365
chr1	79115476	79129763	IFI44	14287	0.353118
chr1	79355448	79472495	ELTD1	117047	0.339718
chr1	82266081	82458107	LPHN2	192026	0.343740
chr1	83439565	83451891	U80773	12326	0.372546
chr1	83911736	83920454	BC043544	8718	0.381395
chr1	84041470	84326679	BC036594	285209	0.390752
chr1	84259583	84259634	HH834010	51	0.333333
chr1	84259597	84379059	MIR548AP	119462	0.370871
chr1	84267442	84326229	AK097722	58787	0.388742
chr1	84335056	84464833	TTLL7	129777	0.356589
chr1	84379036	84379062	HH834010	26	0.346154
chr1	84609951	84704181	PRKACB	94230	0.340295
chr1	84743003	84743140	SNORA2	137	0.372263
chr1	84764048	84816481	SAMD13	52433	0.386741
chr1	84810360	84816481	SAMD13	6121	0.403039
chr1	84830640	84863576	UOX	32936	0.400140
chr1	84864214	84880691	DNASE2B	16477	0.393458
chr1	84944919	84964033	RPF1	19114	0.372188
chr1	84964005	84972262	GNG5	8257	0.406806
chr1	84972012	85014647	SPATA1	42635	0.365005
chr1	85018803	85040163	CTBS	21360	0.376170
chr1	85093912	85097429	C1orf180	3517	0.413421
chr1	85109389	85156240	SSX2IP	46851	0.370728
chr1	85279085	85358896	LPAR3	79811	0.416772
chr1	85391265	85462796	MCOLN2	71531	0.403769
chr1	85483764	85514223	MCOLN3	30459	0.408188
chr1	85527992	85598821	WDR63	70829	0.389798
chr1	85599476	85599556	MIR4423	80	0.412500
chr1	85623355	85666728	SYDE2	43373	0.365135
chr1	85715636	85725355	C1orf52	9719	0.396646
chr1	85731459	85742587	BCL10	11128	0.400072
chr1	85742040	85865646	LOC646626	123606	0.406259
chr1	85784167	85930889	DDAH1	146722	0.387638
chr1	86046443	86049648	CYR61	3205	0.502340
chr1	86115105	86174116	ZNHIT6	59011	0.364644
chr1	86194915	86622154	COL24A1	427239	0.363794
chr1	86815776	86862025	ODF2L	46249	0.350494
chr1	86889768	86922240	CLCA2	32472	0.379773
chr1	86934394	86965974	CLCA1	31580	0.400253
chr1	87012758	87046432	CLCA4	33674	0.379907
chr1	87099958	87121059	CLCA3P	21101	0.342780
chr1	87170252	87213867	SH3GLB1	43615	0.361137
chr1	87328127	87380107	SEP15	51980	0.378665
chr1	87380334	87575681	HS2ST1	195347	0.368176
chr1	87597679	87598718	LOC339524	1039	0.619827
chr1	87794150	87814607	LMO4	20457	0.425527
chr1	87819209	87837338	LOC100505768	18129	0.406531
chr1	89004735	89150887	AK123834	146152	0.385195
chr1	89149921	89301938	PKN2	152017	0.362459
chr1	89318320	89357301	GTF2B	38981	0.396963
chr1	89401455	89458643	CCBL2	57188	0.385973
chr1	89445138	89458643	RBMXL1	13505	0.411847
chr1	89472359	89488549	GBP3	16190	0.401112
chr1	89517986	89531043	GBP1	13057	0.381098
chr1	89573309	89591799	GBP2	18490	0.372580
chr1	89597433	89641723	GBP7	44290	0.378844
chr1	89646830	89664633	GBP4	17803	0.388530
chr1	89724633	89738544	GBP5	13911	0.383222
chr1	89754940	89756045	LOC729930	1105	0.375566
chr1	89829435	89853719	GBP6	24284	0.388610
chr1	89873237	89890493	GBP1P1	17256	0.389488
chr1	89990396	90063420	LRRC8B	73024	0.386284
chr1	90090407	90098453	FLJ27354	8046	0.411757
chr1	90098643	90185094	LRRC8C	86451	0.384206
chr1	90287479	90401989	LRRC8D	114510	0.400524
chr1	90453271	90453503	7SK	232	0.469828
chr1	90458823	90460525	GEMIN8P4	1702	0.494125
chr1	90460677	90494094	ZNF326	33417	0.357333
chr1	91177578	91182794	BARHL2	5216	0.514954
chr1	91295103	91317175	AK022898	22072	0.436028
chr1	91380856	91487812	ZNF644	106956	0.363832
chr1	91726322	91870426	HFM1	144104	0.371586
chr1	91966403	91991321	CDC7	24918	0.366562
chr1	92145899	92351836	TGFBR3	205937	0.422547
chr1	92414927	92479985	BRDT	65058	0.394325
chr1	92495532	92529093	EPHX4	33561	0.383570
chr1	92545861	92613401	BTBD8	67540	0.392316
chr1	92632608	92650280	KIAA1107	17672	0.345349
chr1	92683572	92711367	C1orf146	27795	0.391257
chr1	92711954	92764566	GLMN	52612	0.380217
chr1	92764521	92853732	RPAP2	89211	0.380099
chr1	92940317	92951628	GFI1	11311	0.547166
chr1	92974252	93257961	EVI5	283709	0.381856
chr1	93297593	93307481	RPL5	9888	0.403115
chr1	93307716	93427079	FAM69A	119363	0.394997
chr1	93302845	93302940	SNORD21	95	0.452632
chr1	93303574	93303627	SNORA66	53	0.452830
chr1	93544791	93604638	MTF2	59847	0.373686
chr1	93615298	93646246	TMED5	30948	0.381931
chr1	93646280	93744287	CCDC18	98007	0.367402
chr1	93775665	93811368	LOC100131564	35703	0.389603
chr1	93811477	93828148	DR1	16671	0.362786
chr1	93913687	94020218	FNBP1L	106531	0.373431
chr1	94027342	94146926	BCAR3	119584	0.453740
chr1	94057524	94065587	LOC100129046	8063	0.475257
chr1	94219111	94240930	MIG7	21819	0.460241
chr1	94312387	94312467	MIR760	80	0.637500
chr1	94317792	94319887	AX746627	2095	0.342721
chr1	94335013	94344762	DNTTIP2	9749	0.385681
chr1	94352589	94375012	GCLM	22423	0.370245
chr1	94458393	94586705	ABCA4	128312	0.464430
chr1	94634462	94703307	ARHGAP29	68845	0.359808
chr1	94883932	94984219	ABCD3	100287	0.370706
chr1	94994731	95007413	F3	12682	0.436682
chr1	95123088	95285834	BC030750	162746	0.417774
chr1	95285897	95360803	SLC44A3	74906	0.439244
chr1	95362506	95392735	CNN3	30229	0.429058
chr1	95393583	95428826	LOC729970	35243	0.418665
chr1	95448278	95538507	ALG14	90229	0.403717
chr1	95582893	95663161	TMEM56	80268	0.390018
chr1	95628774	95699538	AK090700	70764	0.391753
chr1	95699710	95712781	RWDD3	13071	0.407696
chr1	95940292	95944912	FLJ31662	4620	0.433766
chr1	95975895	95981020	BC067883	5125	0.376390
chr1	97161411	97161723	7SK	312	0.471154
chr1	97187174	97280605	PTBP2	93431	0.358660
chr1	97543299	98386615	DPYD	843316	0.350937
chr1	97561478	97788511	DPYD-AS1	227033	0.360172
chr1	98453555	98515249	MIR137HG	61694	0.342934
chr1	98510798	98510907	MIR2682	109	0.550459
chr1	98676266	98738214	LOC729987	61948	0.352909
chr1	99127235	99226056	SNX7	98821	0.360591
chr1	99207463	99207540	7SK	77	0.402597
chr1	99355800	99470449	LPPR5	114649	0.371560
chr1	99469831	99614408	LOC100129620	144577	0.376934
chr1	99729847	99775138	LPPR4	45291	0.361330
chr1	100111430	100160097	PALMD	48667	0.375491
chr1	100174258	100231349	FRRS1	57091	0.380025
chr1	100178485	100178513	MIR548D1	28	0.357143
chr1	100178485	100178513	MIR548AA1	28	0.357143
chr1	100315639	100389579	AGL	73940	0.364674
chr1	100434000	100435404	BC112312	1404	0.426638
chr1	100435991	100492534	SLC35A3	56543	0.370373
chr1	100503788	100548929	HIAT1	45141	0.394054
chr1	100549101	100598511	SASS6	49410	0.364744
chr1	100598705	100616054	TRMT13	17349	0.358003
chr1	100614003	100643829	LRRC39	29826	0.362469
chr1	100652477	100715409	DBT	62932	0.391534
chr1	100731713	100758325	RTCA	26612	0.391214
chr1	100746796	100746864	MIR553	68	0.323529
chr1	100818022	100965021	CDC14A	146999	0.383526
chr1	101003727	101007583	GPR88	3856	0.523859
chr1	101092605	101112560	LOC100128787	19955	0.400802
chr1	101185195	101204601	VCAM1	19406	0.369886
chr1	101337927	101360735	EXTL2	22808	0.381445
chr1	101361631	101447311	SLC30A7	85680	0.358462
chr1	101455179	101491362	DPH5	36183	0.375204
chr1	101491408	101552819	BX538249	61411	0.371334
chr1	101702304	101707076	S1PR1	4772	0.481978
chr1	101806424	101806451	RNU6-31P	27	0.407407
chr1	102268126	102462790	OLFM3	194664	0.351467
chr1	102337566	102360299	DNAJA1P5	22733	0.333832
chr1	103342022	103574052	COL11A1	232030	0.331276
chr1	104068577	104097859	RNPC3	29282	0.348883
chr1	104095895	104122149	AMY2B	26254	0.348404
chr1	104159998	104168400	AMY2A	8402	0.335634
chr1	104198301	104207173	AMY1A	8872	0.342876
chr1	104230039	104238912	AMY1A	8873	0.343063
chr1	104257374	104262492	AMY2A	5118	0.337632
chr1	104292439	104301311	AMY1A	8872	0.343102
chr1	104615644	104619693	LOC100129138	4049	0.423561
chr1	106144773	106161557	BC043293	16784	0.310296
chr1	107599266	107601916	PRMT6	2650	0.506038
chr1	107682628	108024475	NTNG1	341847	0.373497
chr1	107937775	108024475	NTNG1	86700	0.378639
chr1	107937775	108024475	NTNG1	86700	0.378639
chr1	108113781	108507545	VAV3	393764	0.375138
chr1	108507064	108537229	VAV3-AS1	30165	0.413294
chr1	108677343	108742980	SLC25A24	65637	0.392797
chr1	108765962	108786703	NBPF4	20741	0.453064
chr1	108803819	108816311	BC051808	12492	0.397454
chr1	108918459	108953434	NBPF4	34975	0.401144
chr1	108963310	108975804	BC051808	12494	0.397711
chr1	108992903	109013260	NBPF6	20357	0.453112
chr1	109102970	109181949	FAM102B	78979	0.390711
chr1	109190909	109203744	HENMT1	12835	0.403506
chr1	109234931	109244422	PRPF38B	9491	0.379517
chr1	109255555	109285367	FNDC7	29812	0.426607
chr1	109289284	109352148	STXBP3	62864	0.360397
chr1	109358519	109399726	AKNAD1	41207	0.434999
chr1	109399838	109401146	SPATA42	1308	0.402905
chr1	109419602	109473044	GPSM2	53442	0.383257
chr1	109472129	109506121	CLCC1	33992	0.416922
chr1	109512837	109584850	WDR47	72013	0.412301
chr1	109606997	109618624	TAF13	11627	0.438032
chr1	109633402	109639554	TMEM167B	6152	0.419213
chr1	109642814	109643234	SCARNA2	420	0.654762
chr1	109648572	109656479	C1orf194	7907	0.473757
chr1	109656584	109749403	KIAA1324	92819	0.458236
chr1	109756514	109780804	SARS	24290	0.431618
chr1	109792640	109818378	CELSR2	25738	0.597482
chr1	109822175	109825790	PSRC1	3615	0.536376
chr1	109834986	109849663	MYBPHL	14677	0.498467
chr1	109852187	109940563	SORT1	88376	0.422671
chr1	109941652	109969070	PSMA5	27418	0.407506
chr1	109965120	109966952	FW340027	1832	0.421397
chr1	110009099	110024764	SYPL2	15665	0.493776
chr1	110026560	110035420	ATXN7L2	8860	0.564898
chr1	110036700	110043063	CYB561D1	6363	0.534811
chr1	110049445	110052336	AMIGO1	2891	0.580076
chr1	110082493	110088455	GPR61	5962	0.523482
chr1	110091185	110138454	GNAI3	47269	0.387040
chr1	110141514	110141589	MIR197	75	0.626667
chr1	110145888	110155705	GNAT2	9817	0.444331
chr1	110162434	110174677	AMPD2	12243	0.605816
chr1	110198697	110204331	GSTM4	5634	0.539936
chr1	110230417	110236367	GSTM1	5950	0.526387
chr1	110254863	110260890	GSTM5	6027	0.526630
chr1	110276553	110283660	GSTM3	7107	0.471648
chr1	110292701	110306644	EPS8L3	13943	0.538478
chr1	110453232	110473616	CSF1	20384	0.546900
chr1	110527386	110566364	AHCYL1	38978	0.409205
chr1	110577222	110597424	STRIP1	20202	0.495545
chr1	110602996	110613322	ALX3	10326	0.591226
chr1	110603303	110603368	DQ574855	65	0.538462
chr1	110655061	110656569	UBL4B	1508	0.570292
chr1	110693131	110744823	SLC6A17	51692	0.505862
chr1	110753335	110776674	KCNC4	23339	0.557307
chr1	110815105	110815229	SNORA25	124	0.379032
chr1	110828998	110881793	LOC440600	52795	0.444947
chr1	110881944	110889303	RBM15	7359	0.426417
chr1	110887099	110888734	BC069739	1635	0.322324
chr1	110905472	110933704	SLC16A4	28232	0.404010
chr1	110943876	110950546	LAMTOR5	6670	0.425187
chr1	110950430	110958896	LAMTOR5-AS1	8466	0.447319
chr1	110993787	110999976	PROK1	6189	0.507513
chr1	111023387	111033891	CYMP	10504	0.535415
chr1	111059838	111061797	KCNA10	1959	0.503318
chr1	111145775	111148975	KCNA2	3200	0.522812
chr1	111214309	111217655	KCNA3	3346	0.533473
chr1	111413820	111442558	CD53	28738	0.395191
chr1	111489811	111506566	LRIF1	16755	0.363593
chr1	111659953	111682838	DRAM2	22885	0.379375
chr1	111682248	111727724	CEPT1	45476	0.365424
chr1	111728590	111747160	DENND2D	18570	0.495261
chr1	111770280	111786062	CHI3L2	15782	0.439995
chr1	111823145	111828730	CHIAP2	5585	0.425425
chr1	111833473	111863188	CHIA	29715	0.382534
chr1	111889194	111895639	PIFO	6445	0.413654
chr1	111927140	111932473	PGCP1	5333	0.455278
chr1	111956936	111970399	OVGP1	13463	0.456956
chr1	111982511	111991830	WDR77	9319	0.442537
chr1	111991742	112004525	ATP5F1	12783	0.392944
chr1	112016603	112021134	C1orf162	4531	0.418009
chr1	112025969	112046743	ADORA3	20774	0.429046
chr1	112032938	112033045	U6	107	0.383178
chr1	112162404	112256101	RAP1A	93697	0.377910
chr1	112141628	112150940	LOC100129269	9312	0.466602
chr1	112256829	112259310	AK023457	2481	0.391374
chr1	112264685	112282046	FAM212B	17361	0.521802
chr1	112282462	112290420	LOC100506343	7958	0.494722
chr1	112287934	112298131	BC041890	10197	0.466019
chr1	112298189	112310199	DDX20	12010	0.399251
chr1	112318453	112531777	KCND3	213324	0.473974
chr1	112533189	112541463	LOC643355	8274	0.475828
chr1	112913625	112913729	SnoU13	104	0.413462
chr1	112938799	113003786	CTTNBP2NL	64987	0.394171
chr1	112938880	112941439	AX747733	2559	0.443142
chr1	113004391	113004455	MIR4256	64	0.421875
chr1	113051369	113063910	WNT2B	12541	0.494697
chr1	113066140	113162040	ST7L	95900	0.388832
chr1	113162074	113214241	CAPZA1	52167	0.402400
chr1	113217047	113243368	MOV10	26321	0.488811
chr1	113243748	113249678	RHOC	5930	0.558179
chr1	113252615	113257950	PPM1J	5335	0.577132
chr1	113263188	113269856	FAM19A3	6668	0.502549
chr1	113362795	113393265	AX748125	30470	0.461339
chr1	113392521	113420491	HP08777	27970	0.460815
chr1	113454469	113498975	SLC16A1	44506	0.403968
chr1	113465971	113467295	AKR7A2P1	1324	0.532477
chr1	113499070	113511603	BX648855	12533	0.435570
chr1	113554308	113615724	BC037540	61416	0.451348
chr1	113615830	113667342	LRIG2	51512	0.412603
chr1	113739403	113748875	LOC643441	9472	0.416596
chr1	113933474	114228545	MAGI3	295071	0.370975
chr1	114239823	114301777	PHTF1	61954	0.389773
chr1	114304453	114355070	RSBN1	50617	0.372167
chr1	114356432	114414375	PTPN22	57943	0.388537
chr1	114399256	114443859	AP4B1-AS1	44603	0.405018
chr1	114419435	114430169	BCL2L15	10734	0.415129
chr1	114437370	114447525	AP4B1	10155	0.425899
chr1	114447914	114456708	DCLRE1B	8794	0.453036
chr1	114466622	114471880	BC036361	5258	0.429251
chr1	114471995	114520491	HIPK1	48496	0.397703
chr1	114522029	114524875	OLFML3	2846	0.522136
chr1	114631913	114695062	SYT6	63149	0.480625
chr1	114935398	115053781	TRIM33	118383	0.382006
chr1	115110180	115124265	BCAS2	14085	0.403266
chr1	115125468	115126223	DKFZp686N1631	755	0.402649
chr1	115127195	115212732	DENND2C	85537	0.392801
chr1	115215719	115238239	AMPD1	22520	0.407416
chr1	115247084	115259515	NRAS	12431	0.389912
chr1	115259533	115300671	CSDE1	41138	0.382274
chr1	115312104	115323308	SIKE1	11204	0.369154
chr1	115397454	115537990	SYCP1	140536	0.353091
chr1	115572444	115576930	TSHB	4486	0.339055
chr1	115590632	115632121	TSPAN2	41489	0.434453
chr1	115828536	115880857	NGF	52321	0.438008
chr1	116184573	116240845	VANGL1	56272	0.453192
chr1	116242625	116311426	CASQ2	68801	0.432290
chr1	116378998	116383747	NHLH2	4749	0.504317
chr1	116461996	116468529	BC043254	6533	0.384203
chr1	116519118	116612675	SLC22A15	93557	0.394978
chr1	116654375	116677861	MAB21L3	23486	0.434940
chr1	116821227	116821443	U3	216	0.481481
chr1	116915794	116947396	ATP1A1	31602	0.433549
chr1	116947335	116961244	ATP1A1OS	13909	0.464088
chr1	116956387	116956491	U6	104	0.442308
chr1	117057155	117113715	CD58	56560	0.416549
chr1	117117019	117209578	IGSF3	92559	0.459512
chr1	117214370	117214449	MIR320B1	79	0.354430
chr1	117297085	117311851	CD2	14766	0.471218
chr1	117452688	117532972	PTGFRN	80284	0.441969
chr1	117544371	117579173	CD101	34802	0.426470
chr1	117602948	117645491	TTF2	42543	0.409750
chr1	117637264	117637350	MIR942	86	0.441860
chr1	117653676	117664411	TRIM45	10735	0.456358
chr1	117686208	117753582	VTCN1	67374	0.424066
chr1	117910084	118068320	MAN1A2	158236	0.353826
chr1	118148603	118171011	FAM46C	22408	0.440646
chr1	118406106	118472302	GDAP2	66196	0.365641
chr1	118472371	118503049	WDR3	30678	0.367201
chr1	118496287	118727848	SPAG17	231561	0.375262
chr1	119425665	119532179	TBX15	106514	0.411204
chr1	119573838	119683295	WARS2	109457	0.381063
chr1	119683047	119726446	BC043601	43399	0.436623
chr1	119911401	119936751	HAO2	25350	0.415108
chr1	119957742	119965662	HSD3B2	7920	0.438005
chr1	120049825	120057681	HSD3B1	7856	0.445137
chr1	120106502	120115199	HSD3BP4	8697	0.451650
chr1	120140324	120141914	LINC00622	1590	0.376730
chr1	120161999	120190390	ZNF697	28391	0.443204
chr1	120254418	120286849	PHGDH	32431	0.493694
chr1	120290618	120311555	HMGCS2	20937	0.418876
chr1	120336640	120354203	REG4	17563	0.436486
chr1	120377387	120387503	NBPF7	10116	0.454725
chr1	120436155	120439147	ADAM30	2992	0.440508
chr1	120454175	120612317	NOTCH2	158142	0.397478
chr1	120839004	120855681	FAM72B	16677	0.400192
chr1	120906033	120914842	HIST2H2BA	8809	0.412533
chr1	120906460	120906507	Histone3	47	0.446809
chr1	120926127	120935944	FCGR1B	9817	0.419273
chr1	121107151	121129827	SRGAP2D	22676	0.443685
chr1	121306423	121313686	EMBP1	7263	0.344486
chr1	142618798	143257763	CR936796	638965	0.276101
chr1	142660105	142660135	DQ579288	30	0.433333
chr1	142672190	142672219	DQ586768	29	0.482759
chr1	142688238	142688268	DQ579288	30	0.433333
chr1	142689205	142689235	DQ583161	30	0.466667
chr1	142689523	142689553	DQ590589	30	0.566667
chr1	142697420	142713605	ANKRD20A12P	16185	0.353661
chr1	142803223	142888797	BC053679	85574	0.393192
chr1	142803530	142826645	BC071797	23115	0.356176
chr1	142851394	142851424	DQ590126	30	0.433333
chr1	142853227	142855999	DQ592442	2772	0.497114
chr1	143168647	143168675	DQ586768	28	0.500000
chr1	143184707	143184737	DQ579288	30	0.433333
chr1	143185980	143186010	DQ590589	30	0.566667
chr1	143286955	143286985	DQ587539	30	0.566667
chr1	143289062	143289092	DQ590126	30	0.433333
chr1	143402283	143402313	DQ587539	30	0.566667
chr1	143403553	143403583	DQ590126	30	0.433333
chr1	143419286	143419314	DQ596206	28	0.500000
chr1	143424332	143467651	BC070106	43319	0.433713
chr1	143431367	143431397	DQ590126	30	0.433333
chr1	143647638	143744587	LINC00875	96949	0.425667
chr1	143687129	143714180	LOC100130000	27051	0.424421
chr1	143702303	143702331	DQ571491	28	0.392857
chr1	143767143	143767881	PPIAL4G	738	0.462060
chr1	143896451	143913143	FAM72D	16692	0.401929
chr1	143915747	144094477	SRGAP2B	178730	0.416254
chr1	144146810	146467744	LOC100288142	2320934	0.349280
chr1	144171303	144172451	AF420437	1148	0.429442
chr1	144209457	144212180	AL050141	2723	0.442527
chr1	144275887	144290006	AX746564	14119	0.422551
chr1	144300511	144340773	LINC00623	40262	0.414262
chr1	144340773	144341077	BC047032	304	0.687500
chr1	144363461	144364246	PPIAL4B	785	0.452229
chr1	144456162	144470244	AX746564	14082	0.423022
chr1	144480744	144521009	LOC728875	40265	0.414032
chr1	144514872	144519720	AK094156	4848	0.363449
chr1	144610814	144612727	PFN1P2	1913	0.422373
chr1	144851423	144995033	PDE4DIP	143610	0.408843
chr1	144832199	144833038	AX747132	839	0.411204
chr1	144833046	144833912	AX747132	866	0.319861
chr1	144833912	144834808	AX747132	896	0.406250
chr1	144944671	144944750	U2	79	0.367089
chr1	145004780	145005287	BC065231	507	0.487179
chr1	145013718	145018395	BX647792	4677	0.403464
chr1	145096406	145116997	SEC22B	20591	0.364285
chr1	145209110	145285912	NOTCH2NL	76802	0.391552
chr1	145372087	145373798	AX747132	1711	0.362361
chr1	145373798	145374694	AX747132	896	0.406250
chr1	145413190	145417545	HFE2	4355	0.491160
chr1	145438461	145442628	TXNIP	4167	0.425246
chr1	145456235	145470387	POLR3GL	14152	0.448982
chr1	145470507	145475647	ANKRD34A	5140	0.559144
chr1	145477084	145499091	LIX1L	22007	0.436225
chr1	145500506	145501669	AK123675	1163	0.418745
chr1	145507556	145513535	RBM8A	5979	0.438033
chr1	145509751	145515899	GNRHR2	6148	0.441607
chr1	145514173	145515899	GNRHR2	1726	0.495365
chr1	145516164	145523732	PEX11B	7568	0.455735
chr1	145524989	145543868	ITGA10	18879	0.483765
chr1	145549208	145568526	ANKRD35	19318	0.481830
chr1	145575987	145586546	PIAS3	10559	0.515011
chr1	145586492	145589435	NUDT17	2943	0.550459
chr1	145592604	145610884	POLR3C	18280	0.429705
chr1	145611035	145688776	RNF115	77741	0.418904
chr1	145695797	145715565	CD160	19768	0.420174
chr1	145727665	145764206	PDZK1	36541	0.443693
chr1	145764594	145827103	GPR89A	62509	0.389064
chr1	145883867	145924049	GPR89C	40182	0.390946
chr1	145924387	145934507	PDZK1P1	10120	0.403360
chr1	146032541	146057734	NBPF24	25193	0.442028
chr1	146215990	146217136	AF420437	1146	0.427574
chr1	146490894	146514599	LOC728989	23705	0.405231
chr1	146571065	146585928	NBPF13P	14863	0.450447
chr1	146626684	146644129	PRKAB2	17445	0.398338
chr1	146649429	146651528	PDIA3P	2099	0.449738
chr1	146657837	146697230	FMO5	39393	0.393090
chr1	146714290	146767447	CHD1L	53157	0.402637
chr1	146853913	146989699	LINC00624	135786	0.394805
chr1	147013181	147098015	BCL9	84834	0.420857
chr1	147119167	147142634	ACP6	23467	0.441002
chr1	147228331	147232714	GJA5	4383	0.492813
chr1	147374945	147381395	GJA8	6450	0.451938
chr1	147400505	147465755	GPR89B	65250	0.399234
chr1	147466093	147484331	PDZK1P1	18238	0.425101
chr1	147574322	147599571	NBPF24	25249	0.442117
chr1	148250248	148346791	NBPF14	96543	0.442404
chr1	147680370	147691166	AK091688	10796	0.395517
chr1	147751385	147763966	AK023809	12581	0.446467
chr1	147801123	147816764	BC041003	15641	0.420114
chr1	147806602	147806678	MIR5087	76	0.421053
chr1	147835126	147931980	FLJ39739	96854	0.425269
chr1	147874654	147893482	AK311108	18828	0.425112
chr1	147925822	147930669	AK094156	4847	0.364349
chr1	147954634	147955419	PPIAL4B	785	0.450955
chr1	148201751	148202536	PPIAL4D	785	0.457325
chr1	148556107	148556133	DQ577785	26	0.538462
chr1	148560846	148596267	NBPF15	35421	0.424833
chr1	148644010	148644795	PPIAL4E	785	0.457325
chr1	148739441	148758311	NBPF16	18870	0.433227
chr1	148806014	148806799	PPIAL4F	785	0.457325
chr1	148876039	148902123	AK310441	26084	0.383453
chr1	148930404	148953054	LOC645166	22650	0.452097
chr1	149230715	149232553	BC062745	1838	0.453754
chr1	149279475	149291742	LOC388692	12267	0.503383
chr1	149369293	149378297	FCGR1C	9004	0.418925
chr1	149398714	149398761	Histone3	47	0.468085
chr1	149400063	149400109	Histone3	46	0.478261
chr1	149553002	149553787	PPIAL4B	785	0.453503
chr1	149576261	149616786	LINC00623	40525	0.415077
chr1	149577754	149582605	AB074166	4851	0.361781
chr1	149627308	149651107	AB007962	23799	0.413211
chr1	149754244	149783928	HIST2H2BF	29684	0.419014
chr1	149754249	149764074	FCGR1A	9825	0.418830
chr1	149763335	149765367	AX747534	2032	0.565453
chr1	149784779	149785236	HIST2H3D	457	0.647702
chr1	149804220	149804616	HIST2H4A	396	0.608586
chr1	149812258	149812765	HIST2H3C	507	0.656805
chr1	149813784	149814318	HIST2H2AA4	534	0.634831
chr1	149821758	149822340	HIST2H2BC	582	0.597938
chr1	149822627	149823161	HIST2H2AA4	534	0.634831
chr1	149824180	149824687	HIST2H3C	507	0.656805
chr1	149832329	149832725	HIST2H4A	396	0.608586
chr1	149856009	149858232	HIST2H2BE	2223	0.479532
chr1	149858524	149858961	HIST2H2AC	437	0.608696
chr1	149859018	149859466	HIST2H2AB	448	0.607143
chr1	149871154	149872348	BOLA1	1194	0.599665
chr1	149874871	149889434	SV2A	14563	0.522145
chr1	149895208	149900144	SF3B4	4936	0.483185
chr1	149900542	149908791	MTMR11	8249	0.500182
chr1	149912231	149982686	OTUD7B	70455	0.422482
chr1	150039341	150117505	VPS45	78164	0.391293
chr1	150122169	150131825	PLEKHO1	9656	0.516674
chr1	150190716	150208504	ANP32E	17788	0.425736
chr1	150230217	150237480	CA14	7263	0.503236
chr1	150237798	150241609	APH1A	3811	0.546838
chr1	150245182	150253335	C1orf54	8153	0.439593
chr1	150255228	150259501	C1orf51	4273	0.467821
chr1	150266268	150280819	MRPS21	14551	0.464161
chr1	150293927	150325704	PRPF3	31777	0.441766
chr1	150336989	150449041	RPRD2	112052	0.416789
chr1	150459839	150480085	TARS2	20246	0.485232
chr1	150480486	150486265	ECM1	5779	0.552691
chr1	150488232	150490508	LINC00568	2276	0.503954
chr1	150521897	150533412	ADAMTSL4	11515	0.600521
chr1	150524404	150524490	MIR4257	86	0.569767
chr1	150547026	150552214	MCL1	5188	0.447379
chr1	150594598	150602098	ENSA	7500	0.452667
chr1	150618700	150669672	GOLPH3L	50972	0.400965
chr1	150670534	150693364	HORMAD1	22830	0.367148
chr1	150702671	150738433	CTSS	35762	0.393882
chr1	150768683	150780917	CTSK	12234	0.430848
chr1	150782180	150849244	ARNT	67064	0.412129
chr1	150785066	150785174	U6	108	0.379630
chr1	150898814	150937220	SETDB1	38406	0.441155
chr1	150937648	150947479	CERS2	9831	0.546231
chr1	150954498	150968114	ANXA9	13616	0.499045
chr1	150969300	150980854	FAM63A	11554	0.491691
chr1	150980972	151008189	PRUNE	27217	0.465224
chr1	150995221	150995328	U6	107	0.439252
chr1	151009028	151020076	BNIPL	11048	0.469678
chr1	151020258	151023871	C1orf56	3613	0.487407
chr1	151023446	151032125	CDC42SE1	8679	0.496601
chr1	151032150	151040973	MLLT11	8823	0.438400
chr1	151043079	151091007	GABPB2	47928	0.449257
chr1	151104162	151119140	SEMA6C	14978	0.574910
chr1	151138497	151142773	SCNM1	4276	0.491113
chr1	151129104	151132225	TNFAIP8L2	3121	0.516181
chr1	151132223	151138370	LYSMD1	6147	0.459736
chr1	151142462	151148547	TMOD4	6085	0.504355
chr1	151148775	151162689	VPS72	13914	0.466796
chr1	151171020	151222007	PIP5K1A	50987	0.451527
chr1	151227196	151239954	PSMD4	12758	0.476407
chr1	151252499	151254405	BC021024	1906	0.549318
chr1	151254790	151264381	ZNF687	9591	0.581900
chr1	151264272	151300191	PI4KB	35919	0.484535
chr1	151265261	151265284	HV592965	23	0.608696
chr1	151265461	151265487	HV592900	26	0.538462
chr1	151266582	151266606	HV592953	24	0.583333
chr1	151271387	151271414	HV592909	27	0.481481
chr1	151271499	151271523	HV592934	24	0.416667
chr1	151274383	151274409	HV592964	26	0.576923
chr1	151278732	151278766	HV592982	34	0.558824
chr1	151313115	151319769	RFX5	6654	0.496844
chr1	151336777	151345210	SELENBP1	8433	0.549508
chr1	151372040	151374412	PSMB4	2372	0.491568
chr1	151375199	151431941	POGZ	56742	0.417856
chr1	151483861	151511167	CGN	27306	0.492346
chr1	151512780	151556059	TUFT1	43279	0.459253
chr1	151518271	151518367	MIR554	96	0.489583
chr1	151584661	151671559	SNX27	86898	0.403577
chr1	151670318	151670850	BC127854	532	0.498120
chr1	151672533	151689290	CELF3	16757	0.558990
chr1	151694012	151702082	RIIAD1	8070	0.471747
chr1	151732122	151736040	MRPL9	3918	0.484431
chr1	151739130	151743806	OAZ3	4676	0.498289
chr1	151745954	151763010	TDRKH	17056	0.428061
chr1	151763317	151766878	BC038201	3561	0.427970
chr1	151772764	151777882	LINGO4	5118	0.561938
chr1	151778546	151804348	RORC	25802	0.530773
chr1	151810338	151813033	C2CD4D	2695	0.667904
chr1	151810944	151816641	LOC100132111	5697	0.509566
chr1	151819576	151826173	THEM5	6597	0.523723
chr1	151843342	151882361	THEM4	39019	0.424024
chr1	151955385	151966714	S100A10	11329	0.456528
chr1	151967006	152015250	AC2	48244	0.440262
chr1	152004981	152009511	S100A11	4530	0.463576
chr1	152056619	152061540	TCHHL1	4921	0.425726
chr1	152078792	152087930	TCHH	9138	0.514555
chr1	152126070	152131704	RPTN	5634	0.447462
chr1	152184551	152196672	HRNR	12121	0.508951
chr1	152274650	152297679	FLG	23029	0.439967
chr1	152285934	152339168	AK056431	53234	0.373295
chr1	152321212	152332482	FLG2	11270	0.458208
chr1	152381718	152386750	CRNN	5032	0.491057
chr1	152483319	152484653	LCE5A	1334	0.502998
chr1	152486977	152488481	CRCT1	1504	0.554521
chr1	152538174	152539229	LCE3E	1055	0.547867
chr1	152551859	152552980	LCE3D	1121	0.545941
chr1	152573137	152573562	LCE3C	425	0.574118
chr1	152586286	152586574	LCE3B	288	0.645833
chr1	152595309	152595579	LCE3A	270	0.648148
chr1	152635886	152637135	LCE2D	1249	0.492394
chr1	152647790	152649049	LCE2C	1259	0.490866
chr1	152658598	152659876	LCE2B	1278	0.492958
chr1	152670839	152671918	LCE2A	1079	0.478221
chr1	152681522	152681910	LCE4A	388	0.582474
chr1	152691997	152692905	C1orf68	908	0.555066
chr1	152730505	152734529	KPRP	4024	0.525099
chr1	152748847	152749445	LCE1F	598	0.593646
chr1	152758752	152760901	LCE1E	2149	0.487669
chr1	152769226	152770657	LCE1D	1431	0.519916
chr1	152777310	152779107	LCE1C	1797	0.487479
chr1	152784446	152785585	LCE1B	1139	0.486392
chr1	152799948	152800573	LCE1A	625	0.603200
chr1	152815329	152816459	LCE6A	1130	0.485841
chr1	152850797	152857523	SMCP	6726	0.489295
chr1	152881038	152884362	IVL	3324	0.558664
chr1	152943127	152945069	SPRR4	1942	0.491246
chr1	152956563	152958290	SPRR1A	1727	0.451071
chr1	152974222	152976332	SPRR3	2110	0.439810
chr1	153003678	153005376	SPRR1B	1698	0.426384
chr1	153012200	153013594	SPRR2D	1394	0.442611
chr1	153028595	153029988	SPRR2A	1393	0.440057
chr1	153042717	153044084	SPRR2B	1367	0.446964
chr1	153065610	153067001	SPRR2E	1391	0.445004
chr1	153084612	153085989	SPRR2F	1377	0.449528
chr1	153112593	153113969	SPRR2C	1376	0.446221
chr1	153122057	153123427	SPRR2G	1370	0.447445
chr1	153175905	153177601	LELP1	1696	0.458726
chr1	153190059	153191793	PRR9	1734	0.464245
chr1	153232178	153234600	LOR	2422	0.602395
chr1	153270337	153283194	PGLYRP3	12857	0.469394
chr1	153302596	153321022	PGLYRP4	18426	0.442093
chr1	153330329	153333503	S100A9	3174	0.525520
chr1	153346183	153348075	S100A12	1892	0.494715
chr1	153362507	153363664	S100A8	1157	0.541054
chr1	153388999	153395701	S100A7A	6702	0.480752
chr1	153409470	153412503	S100A7L2	3033	0.509726
chr1	153430219	153433137	S100A7	2918	0.511652
chr1	153507075	153508717	S100A6	1642	0.585262
chr1	153509622	153514241	S100A5	4619	0.525222
chr1	153516094	153518282	S100A4	2188	0.536106
chr1	153518229	153524245	AK307246	6016	0.562001
chr1	153519808	153521734	S100A3	1926	0.579439
chr1	153533584	153538306	S100A2	4722	0.531978
chr1	153579366	153585514	S100A16	6148	0.571080
chr1	153586731	153588808	S100A14	2077	0.564275
chr1	153591275	153600117	S100A13	8842	0.482922
chr1	153600872	153604513	S100A1	3641	0.548476
chr1	153606457	153618782	CHTOP	12325	0.443813
chr1	153631129	153634328	SNAPIN	3199	0.511410
chr1	153634263	153643504	ILF2	9241	0.443242
chr1	153651163	153666468	NPR1	15305	0.553871
chr1	153700566	153746555	INTS3	45989	0.482528
chr1	153747767	153752633	SLC27A3	4866	0.599260
chr1	153777202	153895451	GATAD2B	118249	0.436181
chr1	153901976	153919154	DENND4B	17178	0.564559
chr1	153920147	153931132	CRTC2	10985	0.532908
chr1	153931574	153940660	SLC39A1	9086	0.523002
chr1	153940674	153946840	CREB3L4	6166	0.517353
chr1	153946744	153950451	JTB	3707	0.514162
chr1	153954092	153958853	RAB13	4761	0.487923
chr1	153963238	153964631	RPS27	1393	0.458722
chr1	153965167	154127592	NUP210L	162425	0.428930
chr1	154134288	154164611	TPM3	30323	0.455397
chr1	154166140	154166219	MIR190B	79	0.341772
chr1	154171561	154178841	C1orf189	7280	0.464835
chr1	154179182	154193273	C1orf43	14091	0.461500
chr1	154193324	154243329	UBAP2L	50005	0.432957
chr1	154232202	154232338	SNORA58	136	0.485294
chr1	154245038	154248355	HAX1	3317	0.498040
chr1	154293591	154297801	AQP10	4210	0.526128
chr1	154300275	154323780	ATP8B2	23505	0.515465
chr1	154377668	154441926	IL6R	64258	0.491161
chr1	154451953	154474526	SHE	22573	0.439197
chr1	154474694	154520623	TDRD10	45929	0.475321
chr1	154521050	154531120	UBE2Q1	10070	0.501589
chr1	154540256	154552353	CHRNB2	12097	0.547574
chr1	154554533	154580724	ADAR	26191	0.467603
chr1	154669941	154842754	KCNN3	172813	0.488615
chr1	154897207	154909484	PMVK	12277	0.499715
chr1	154916558	154928567	PBXIP1	12009	0.542760
chr1	154929501	154934258	PYGO2	4757	0.538365
chr1	154934773	154943223	SHC1	8450	0.541420
chr1	154947117	154951725	CKS1B	4608	0.444661
chr1	154948168	154948259	MIR4258	91	0.681319
chr1	154955769	154965587	FLAD1	9818	0.512426
chr1	154966061	154966791	LENEP	730	0.546575
chr1	154975105	154991001	ZBTB7B	15896	0.604051
chr1	154991002	155006257	DCST2	15255	0.536545
chr1	155006281	155023406	DCST1	17125	0.533956
chr1	155017667	155036467	LOC100505666	18800	0.570426
chr1	155023747	155035252	ADAM15	11505	0.573924
chr1	155051347	155060014	EFNA3	8667	0.632283
chr1	155100348	155107386	EFNA1	7038	0.537795
chr1	155108287	155111334	SLC50A1	3047	0.550049
chr1	155112366	155112883	DPM3	517	0.605416
chr1	155141883	155145804	KRTCAP2	3921	0.501913
chr1	155146262	155157447	TRIM46	11185	0.578006
chr1	155155666	155157427	AX746485	1761	0.580352
chr1	155158299	155162706	MUC1	4407	0.610166
chr1	155161986	155162007	DM075093	21	0.523810
chr1	155164967	155165063	MIR92B	96	0.750000
chr1	155165378	155177772	THBS3	12394	0.546716
chr1	155178489	155183624	MTX1	5135	0.558715
chr1	155183615	155188809	GBAP1	5194	0.538891
chr1	155203712	155204236	DQ786325	524	0.606870
chr1	155204238	155214653	GBA	10415	0.516371
chr1	155216995	155225274	FAM189B	8279	0.573982
chr1	155225769	155232176	SCAMP3	6407	0.519120
chr1	155232658	155243281	CLK2	10623	0.492328
chr1	155247217	155259639	HCN3	12422	0.540090
chr1	155259083	155271225	PKLR	12142	0.523637
chr1	155278538	155290457	FDPS	11919	0.504824
chr1	155290250	155293938	RUSC1-AS1	3688	0.634761
chr1	155290639	155300909	RUSC1	10270	0.580721
chr1	155305051	155532324	ASH1L	227273	0.413393
chr1	155402970	155404053	POU5F1P4	1083	0.588181
chr1	155403092	155403473	POU5F1P4	381	0.611549
chr1	155531771	155533735	ASH1L-AS1	1964	0.621690
chr1	155531863	155533735	BC017347	1872	0.621261
chr1	155579960	155584758	MSTO1	4798	0.526053
chr1	155596545	155618335	BC041646	21790	0.438733
chr1	155719509	155826972	GON4L	107463	0.440235
chr1	155658881	155708800	DAP3	49919	0.443739
chr1	155715558	155718322	MSTO2P	2764	0.545948
chr1	155716586	155720673	MSTO2P	4087	0.512601
chr1	155829259	155854990	SYT11	25731	0.465120
chr1	155867598	155880706	RIT1	13108	0.432255
chr1	155882835	155904188	KIAA0907	21353	0.425608
chr1	155889699	155889833	SNORA42	134	0.544776
chr1	155895748	155895877	SCARNA4	129	0.465116
chr1	155911479	155912625	RXFP4	1146	0.621291
chr1	155916629	155948336	ARHGEF2	31707	0.520800
chr1	155978838	155990758	SSR2	11920	0.469883
chr1	156005091	156023516	UBQLN4	18425	0.505943
chr1	156024516	156028605	LAMTOR2	4089	0.510394
chr1	156030965	156040295	RAB25	9330	0.512219
chr1	156041803	156051789	MEX3A	9986	0.534448
chr1	156084460	156109880	LMNA	25420	0.543627
chr1	156104903	156107058	LMNA	2155	0.589327
chr1	156123321	156147542	SEMA4A	24221	0.509806
chr1	156163729	156182587	SLC25A44	18858	0.482766
chr1	156182778	156213123	PMF1-BGLAP	30345	0.501664
chr1	156211950	156213123	BGLAP	1173	0.632566
chr1	156213111	156217908	PAQR6	4797	0.609548
chr1	156219014	156252620	SMG5	33606	0.498185
chr1	156254069	156262234	TMEM79	8165	0.512309
chr1	156262477	156265480	C1orf85	3003	0.568432
chr1	156268414	156269428	VHLL	1014	0.523669
chr1	156278751	156308206	CCT3	29455	0.452046
chr1	156307104	156316785	TSACC	9681	0.464415
chr1	156338979	156355013	RHBG	16034	0.518586
chr1	156374048	156377645	BC016978	3597	0.525160
chr1	156374054	156399340	C1orf61	25286	0.513881
chr1	156390132	156390221	MIR9-1	89	0.404494
chr1	156433512	156460391	MEF2D	26879	0.536032
chr1	156495196	156542396	IQGAP3	47200	0.508623
chr1	156549518	156556562	TTC24	7044	0.551533
chr1	156561557	156564091	APOA1BP	2534	0.563141
chr1	156564099	156571279	GPATCH4	7180	0.485097
chr1	156589085	156595517	HAPLN2	6432	0.542133
chr1	156589085	156594259	HAPLN2	5174	0.503286
chr1	156611456	156613427	BC005081	1971	0.574835
chr1	156611739	156629324	BCAN	17585	0.558885
chr1	156638555	156647189	NES	8634	0.590109
chr1	156669399	156675459	CRABP2	6060	0.551650
chr1	156692412	156697705	ISG20L2	5293	0.493104
chr1	156698262	156706752	RRNAD1	8490	0.509541
chr1	156707093	156710923	MRPL24	3830	0.483551
chr1	156711898	156721543	HDGF	9645	0.565474
chr1	156737273	156770609	PRCC	33336	0.451194
chr1	156776034	156786640	SH2D2A	10606	0.555346
chr1	156830670	156851642	NTRK1	20972	0.551402
chr1	156810664	156828712	INSRR	18048	0.551751
chr1	156863522	156886226	PEAR1	22704	0.570032
chr1	156890423	156902880	LRRC71	12457	0.546199
chr1	156904631	157015162	ARHGEF11	110531	0.445070
chr1	156905922	156906036	MIR765	114	0.491228
chr1	157061834	157069600	ETV3L	7766	0.531033
chr1	157094458	157108383	ETV3	13925	0.440646
chr1	157098153	157098463	CYCSP52	310	0.448387
chr1	157483166	157522310	FCRL5	39144	0.429721
chr1	157543538	157567870	FCRL4	24332	0.420804
chr1	157647977	157670647	FCRL3	22670	0.405382
chr1	157715522	157746922	FCRL2	31400	0.408854
chr1	157764193	157789940	FCRL1	25747	0.410339
chr1	157800703	157811634	CD5L	10931	0.432897
chr1	157895763	157918861	AK057438	23098	0.419993
chr1	157963062	158065844	KIRREL	102782	0.492294
chr1	158101833	158110430	LOC646268	8597	0.426893
chr1	158149736	158156216	CD1D	6480	0.485339
chr1	158169170	158173667	AK097921	4497	0.300645
chr1	158223926	158228058	CD1A	4132	0.451113
chr1	158259562	158264564	CD1C	5002	0.416034
chr1	158297739	158301321	CD1B	3582	0.427973
chr1	158323485	158327343	CD1E	3858	0.445568
chr1	158368311	158369256	OR10T2	945	0.476190
chr1	158389717	158390656	OR10K2	939	0.463259
chr1	158435351	158436293	OR10K1	942	0.480892
chr1	158444244	158464676	AK057554	20432	0.345341
chr1	158449667	158450675	OR10R2	1008	0.435516
chr1	158516917	158517895	OR6Y1	978	0.472393
chr1	158532440	158533394	OR6P1	954	0.493711
chr1	158548708	158549689	OR10X1	981	0.443425
chr1	158576228	158577170	OR10Z1	942	0.507431
chr1	158580495	158656506	SPTA1	76011	0.375511
chr1	158669467	158670442	OR6K2	975	0.452308
chr1	158686957	158687905	OR6K3	948	0.444093
chr1	158724605	158725637	OR6K6	1032	0.466085
chr1	158735533	158736472	OR6N1	939	0.504792
chr1	158746471	158747425	OR6N2	954	0.448637
chr1	158801167	158819270	MNDA	18103	0.346738
chr1	158901336	158946849	PYHIN1	45513	0.389383
chr1	158979681	159024945	IFI16	45264	0.383086
chr1	159032274	159046647	AIM2	14373	0.387741
chr1	159111400	159111474	TRNA	74	0.608108
chr1	159141376	159172932	CADM3	31556	0.461782
chr1	159165774	159172212	LOC100131825	6438	0.506834
chr1	159175048	159176290	DARC	1242	0.577295
chr1	159259505	159278014	FCER1A	18509	0.380301
chr1	159283459	159284449	OR10J3	990	0.486869
chr1	159315958	159438858	BC038194	122900	0.369748
chr1	159409511	159410600	OR10J1	1089	0.465565
chr1	159504867	159505797	OR10J5	930	0.438710
chr1	159557615	159558661	APCS	1046	0.451243
chr1	159682078	159684379	CRP	2301	0.485876
chr1	159750758	159752333	DUSP23	1575	0.589206
chr1	159772172	159786047	FCRL6	13875	0.481297
chr1	159796478	159807282	SLAMF8	10804	0.495372
chr1	159824105	159832447	VSIG8	8342	0.563054
chr1	159842153	159869906	CCDC19	27753	0.461932
chr1	159887896	159894341	TAGLN2	6445	0.547556
chr1	159896828	159915386	IGSF9	18558	0.557980
chr1	159921281	159924044	SLAMF9	2763	0.513934
chr1	159931013	159948876	LOC100505633	17863	0.452388
chr1	159997461	160001783	PIGM	4322	0.413003
chr1	160007256	160040051	KCNJ10	32795	0.483366
chr1	160051359	160059212	KCNJ9	7853	0.547689
chr1	160061128	160068618	IGSF8	7490	0.586248
chr1	160085519	160113374	ATP1A2	27855	0.503752
chr1	160121351	160156767	ATP1A4	35416	0.457703
chr1	160160284	160171676	CASQ1	11392	0.506057
chr1	160171988	160178659	AK093299	6671	0.513566
chr1	160175124	160185162	PEA15	10038	0.518629
chr1	160185504	160232350	DCAF8	46846	0.422555
chr1	160258376	160313354	COPA	54978	0.406908
chr1	160287054	160288260	SUMO1P3	1206	0.386401
chr1	160313062	160328742	NCSTN	15680	0.468431
chr1	160336860	160342638	NHLH1	5778	0.501211
chr1	160370363	160398468	VANGL2	28105	0.516563
chr1	160454819	160493052	SLAMF6	38233	0.396673
chr1	160510883	160549306	CD84	38423	0.415975
chr1	160579890	160617081	SLAMF1	37191	0.422091
chr1	160650211	160681641	CD48	31430	0.421222
chr1	160709076	160724601	SLAMF7	15525	0.440515
chr1	160765863	160798045	LY9	32182	0.439966
chr1	160799949	160832692	CD244	32743	0.438170
chr1	160846329	160854960	ITLN1	8631	0.474800
chr1	160914815	160924589	ITLN2	9774	0.482300
chr1	160965000	160991133	F11R	26133	0.472276
chr1	161009040	161014727	USF1	5687	0.492878
chr1	161016731	161039760	ARHGAP30	23029	0.495115
chr1	161040780	161059385	PVRL4	18605	0.525235
chr1	161068180	161070138	KLHDC9	1958	0.561287
chr1	161070345	161087866	PFDN2	17521	0.440957
chr1	161087861	161090984	NIT1	3123	0.509446
chr1	161090768	161102256	DEDD	11488	0.457173
chr1	161123533	161128646	UFC1	5113	0.461177
chr1	161129253	161135516	USP21	6263	0.534089
chr1	161136180	161141010	PPOX	4830	0.543478
chr1	161141099	161147758	B4GALT3	6659	0.522751
chr1	161159537	161168845	ADAMTS4	9308	0.546304
chr1	161171936	161184184	NDUFS2	12248	0.466444
chr1	161185086	161189038	FCER1G	3952	0.503036
chr1	161192082	161193418	APOA2	1336	0.534431
chr1	161195832	161200407	TOMM40L	4575	0.529399
chr1	161196975	161197051	MIR5187	76	0.513158
chr1	161199455	161208000	NR1I3	8545	0.487068
chr1	161228516	161255240	PCP4L1	26724	0.458240
chr1	161274524	161279762	MPZ	5238	0.505155
chr1	161284165	161334535	SDHC	50370	0.422633
chr1	161334520	161337673	C1orf192	3153	0.422772
chr1	161475204	161489360	FCGR2A	14156	0.435858
chr1	161494035	161496687	HSPA6	2652	0.596908
chr1	161511550	161519818	FCGR3A	8268	0.441098
chr1	161551128	161571010	FCGR2C	19882	0.446685
chr1	161575848	161578341	HSPA7	2493	0.590052
chr1	161592987	161601252	FCGR3B	8265	0.441984
chr1	161632904	161648444	FCGR2B	15540	0.472201
chr1	161653494	161655042	RPL31P11	1548	0.383075
chr1	161676761	161684142	FCRLA	7381	0.460507
chr1	161692442	161697933	FCRLB	5491	0.544710
chr1	161719580	161726952	DUSP12	7372	0.399213
chr1	161736033	161933860	ATF6	197827	0.372138
chr1	161952981	161993644	OLFML2B	40663	0.482183
chr1	162039580	162339813	NOS1AP	300233	0.424284
chr1	162126896	162126972	MIR4654	76	0.565789
chr1	162312335	162312430	MIR556	95	0.273684
chr1	162343514	162346644	C1orf111	3130	0.520767
chr1	162348695	162356608	C1orf226	7913	0.513459
chr1	162365055	162381928	SH2D1B	16873	0.414034
chr1	162467594	162499419	UHMK1	31825	0.381398
chr1	162531295	162569633	UAP1	38338	0.396786
chr1	162602227	162750247	DDR2	148020	0.405391
chr1	162751900	162756362	AF268386	4462	0.369341
chr1	162760495	162782608	HSD17B7	22113	0.393343
chr1	162824086	162838605	C1orf110	14519	0.385702
chr1	163038395	163046592	RGS4	8197	0.395389
chr1	163112088	163172963	RGS5	60875	0.383179
chr1	163291722	163325553	NUF2	33831	0.345452
chr1	164528596	164821060	PBX1	292464	0.415631
chr1	164595272	164651720	AX748175	56448	0.424957
chr1	164738352	164743878	LOC100505795	5526	0.432501
chr1	165171103	165325478	LMX1A	154375	0.431676
chr1	165370158	165414592	RXRG	44434	0.440811
chr1	165446078	165551341	LOC400794	105263	0.418827
chr1	165513477	165533185	LRRC52	19708	0.439213
chr1	165600109	165625372	MGST3	25263	0.433519
chr1	165631448	165667900	ALDH9A1	36452	0.402502
chr1	165667986	165679199	LOC440700	11213	0.429680
chr1	165693527	165738159	TMCO1	44632	0.391244
chr1	165738165	165744685	BC071770	6520	0.418252
chr1	165796731	165880855	UCK2	84124	0.442395
chr1	166026689	166135958	FAM78B	109269	0.450091
chr1	166039068	166135958	FAM78B	96890	0.451687
chr1	166123979	166124035	MIR921	56	0.553571
chr1	166573152	166594473	FMO9P	21321	0.367853
chr1	166808723	166823709	POGK	14986	0.476712
chr1	166825748	166845654	TADA1	19906	0.410529
chr1	166882440	166944561	ILDR2	62121	0.427601
chr1	166958518	166991447	MAEL	32929	0.367852
chr1	167022081	167059868	GPA33	37787	0.475481
chr1	167064070	167098402	DUSP27	34332	0.446144
chr1	167144598	167165042	RBSG4	20444	0.437635
chr1	167190065	167396582	POU2F1	206517	0.379649
chr1	167399876	167487847	CD247	87971	0.472417
chr1	167510250	167523056	CREG1	12806	0.447837
chr1	167599473	167675486	RCSD1	76013	0.467473
chr1	167691186	167761156	MPZL1	69970	0.411033
chr1	167778624	167883453	ADCY10	104829	0.417585
chr1	167885912	167906307	MPC2	20395	0.379358
chr1	167905796	168045083	DCAF6	139287	0.357636
chr1	168048779	168106811	GPR161	58032	0.468190
chr1	168148170	168171351	TIPRL	23181	0.385963
chr1	168250277	168283664	TBX19	33387	0.428280
chr1	168195254	168212088	SFT2D2	16834	0.445289
chr1	168214818	168216668	ANKRD36BP1	1850	0.369189
chr1	168218461	168220378	DQ576756	1917	0.480438
chr1	168344761	168344859	MIR557	98	0.540816
chr1	168369426	168391894	LOC100505918	22468	0.405733
chr1	168510002	168513235	XCL2	3233	0.421590
chr1	168545710	168551315	XCL1	5605	0.399822
chr1	168664694	168698442	DPT	33748	0.421921
chr1	168756178	168762126	LINC00626	5948	0.384499
chr1	169075946	169101960	ATP1B1	26014	0.422157
chr1	169101768	169337186	NME7	235418	0.366136
chr1	169337193	169365780	BLZF1	28587	0.357785
chr1	169364113	169396670	CCDC181	32557	0.372669
chr1	169433148	169455208	SLC19A2	22060	0.386854
chr1	169481191	169555769	F5	74578	0.380367
chr1	169558087	169599377	SELP	41290	0.404844
chr1	169659805	169680843	SELL	21038	0.388487
chr1	169691780	169703220	SELE	11440	0.390122
chr1	169761669	169764061	METTL18	2392	0.403428
chr1	169764549	169822229	C1orf112	57680	0.369695
chr1	169822214	169863100	SCYL3	40886	0.402534
chr1	169890469	170043879	KIFAP3	153410	0.342605
chr1	170115187	170136923	METTL11B	21736	0.380475
chr1	170120518	170120603	MIR3119-1	85	0.341176
chr1	170120518	170120603	MIR3119-2	85	0.341176
chr1	170240545	170253349	LOC284688	12804	0.380428
chr1	170429593	170489887	AK096329	60294	0.368063
chr1	170501262	170522974	GORAB	21712	0.363163
chr1	170633312	170708541	PRRX1	75229	0.390288
chr1	170904611	171033906	MROH9	129295	0.375861
chr1	171060017	171086959	FMO3	26942	0.365006
chr1	171070868	171070947	MIR1295A	79	0.518987
chr1	171070879	171070939	MIR1295B	60	0.550000
chr1	171106878	171130702	FMO6P	23824	0.389397
chr1	171154387	171181822	FMO2	27435	0.388555
chr1	171217662	171255113	FMO1	37451	0.409095
chr1	171283485	171311223	FMO4	27738	0.401867
chr1	171308034	171310463	TOP1P1	2429	0.365583
chr1	171454665	171562650	PRRC2C	107985	0.383007
chr1	171604556	171621773	MYOC	17217	0.456700
chr1	171669295	171711379	VAMP4	42084	0.366743
chr1	171750760	171766856	METTL13	16096	0.450360
chr1	171810617	172381857	DNM3	571240	0.372612
chr1	171964791	171964994	7SK	203	0.403941
chr1	172106018	172113975	DNM3OS	7957	0.334925
chr1	172107947	172108028	MIR3120	81	0.543210
chr1	172389827	172437969	C1orf105	48142	0.416331
chr1	172410596	172413230	PIGC	2634	0.454442
chr1	172502259	172580973	SUCO	78714	0.362159
chr1	172628184	172636012	FASLG	7828	0.417348
chr1	173010359	173020103	TNFSF18	9744	0.367919
chr1	173152869	173176471	TNFSF4	23602	0.398907
chr1	173204198	173446294	LOC100506023	242096	0.399321
chr1	173387087	173430501	BC136808	43414	0.403510
chr1	173446485	173457946	PRDX6	11461	0.404851
chr1	173469603	173572233	SLC9C2	102630	0.385940
chr1	173577474	173639001	ANKRD45	61527	0.396135
chr1	173604660	173606272	LOC730159	1612	0.339950
chr1	173684079	173755840	KLHL20	71761	0.383244
chr1	173768687	173793270	CENPL	24583	0.402595
chr1	173793796	173827682	DARS2	33886	0.405035
chr1	173832385	173833079	GAS5-AS1	694	0.360231
chr1	173833038	173837125	GAS5	4087	0.415953
chr1	173833312	173833355	SNORD81	43	0.372093
chr1	173834487	173834568	SNORD79	81	0.308642
chr1	173834770	173834824	SNORD78	54	0.370370
chr1	173835105	173835166	SNORD44	61	0.393443
chr1	173835448	173835509	SNORD77	61	0.360656
chr1	173836016	173836076	SNORD75	60	0.416667
chr1	173836811	173836883	SNORD74	72	0.513889
chr1	173837492	173855774	ZBTB37	18282	0.422711
chr1	173867684	173867712	DQ593451	28	0.500000
chr1	173872941	173886516	SERPINC1	13575	0.463131
chr1	173900351	173962210	RC3H1	61859	0.381723
chr1	174128551	174927327	RABGAP1L	798776	0.378984
chr1	174417211	174418683	GPR52	1472	0.420516
chr1	174417553	174418334	GPR52	781	0.439181
chr1	174968891	174981163	CACYBP	12272	0.396757
chr1	174982093	174992591	MRPS14	10498	0.404649
chr1	175036993	175117202	TNN	80209	0.456944
chr1	175126122	175161949	KIAA0040	35827	0.447428
chr1	175291934	175712752	TNR	420818	0.438672
chr1	175526123	175533005	AK093214	6882	0.391311
chr1	175913966	176176370	RFWD2	262404	0.362891
chr1	175937532	175937676	SCARNA3	144	0.472222
chr1	176432306	176811970	PAPPA2	379664	0.393403
chr1	176830202	177134024	ASTN1	303822	0.416240
chr1	176998498	176998581	MIR488	83	0.397590
chr1	177140632	177251558	FAM5B	110926	0.417630
chr1	177897488	177939050	SEC16B	41562	0.448222
chr1	178060642	178062735	RASAL2-AS1	2093	0.409460
chr1	178062863	178448648	RASAL2	385785	0.369880
chr1	178482211	178491789	TEX35	9578	0.452182
chr1	178511930	178518024	C1orf220	6094	0.490318
chr1	178646883	178646969	MIR4424	86	0.348837
chr1	178694299	178889237	RALGPS2	194938	0.368409
chr1	178818669	178840215	ANGPTL1	21546	0.337650
chr1	178995073	179045702	FAM20B	50629	0.430880
chr1	179051111	179065129	TOR3A	14018	0.536310
chr1	179068461	179112224	ABL2	43763	0.435185
chr1	179170962	179170982	DD413682	20	0.400000
chr1	179262848	179327814	SOAT1	64966	0.396330
chr1	179334854	179523870	AXDND1	189016	0.393718
chr1	179519673	179545084	NPHS2	25411	0.416316
chr1	179556206	179556240	DQ592690	34	0.441176
chr1	179556492	179556554	DQ571986	62	0.516129
chr1	179556689	179556738	DQ600552	49	0.510204
chr1	179556805	179556836	DQ595741	31	0.451613
chr1	179556860	179556891	DQ601755	31	0.548387
chr1	179557007	179557111	DQ592269	104	0.471154
chr1	179557405	179557438	DQ577099	33	0.575758
chr1	179557454	179557483	DQ587855	29	0.620690
chr1	179557496	179557540	DQ578106	44	0.590909
chr1	179557562	179557602	DQ576856	40	0.550000
chr1	179557656	179557734	DQ590691	78	0.525641
chr1	179557814	179557850	DQ576653	36	0.527778
chr1	179558162	179558192	DQ599950	30	0.633333
chr1	179558664	179558701	DQ594459	37	0.459459
chr1	179558711	179558760	DQ591798	49	0.469388
chr1	179558972	179559006	DQ578586	34	0.382353
chr1	179560756	179660407	TDRD5	99651	0.367693
chr1	179712297	179785333	FAM163A	73036	0.473232
chr1	179809101	179846941	TOR1AIP2	37840	0.388531
chr1	179828164	179846941	TOR1AIP2	18777	0.393300
chr1	179851176	179889212	TOR1AIP1	38036	0.388264
chr1	179923907	180084015	CEP350	160108	0.364591
chr1	180123967	180167169	QSOX1	43202	0.519143
chr1	180167143	180169859	FLJ23867	2716	0.557806
chr1	180199432	180244188	LHX4	44756	0.519819
chr1	180238797	180243816	LOC100527964	5019	0.516039
chr1	180257351	180472022	ACBD6	214671	0.371378
chr1	180318292	180318386	U6	94	0.308511
chr1	180407448	180407525	MIR3121	77	0.350649
chr1	180528109	180535654	BC036830	7545	0.441750
chr1	180601145	180859415	XPR1	258270	0.369470
chr1	180882312	180915239	KIAA1614	32927	0.541319
chr1	180942175	180992046	STX6	49871	0.405907
chr1	181002560	181031074	MR1	28514	0.460721
chr1	181057637	181059979	IER5	2342	0.620837
chr1	181143619	181151342	BC039493	7723	0.494108
chr1	181205523	181207740	GM140	2217	0.502932
chr1	181382578	181382716	AF387615	138	0.688406
chr1	181452685	181775921	CACNA1E	323236	0.435700
chr1	182023704	182030847	ZNF648	7143	0.515470
chr1	182350838	182360539	GLUL	9701	0.457788
chr1	182367251	182369751	TEDDM1	2500	0.454800
chr1	182376755	182383948	LINC00272	7193	0.418462
chr1	182419255	182529732	RGSL1	110477	0.402618
chr1	182542768	182558394	RNASEL	15626	0.415205
chr1	182567757	182573548	RGS16	5791	0.508720
chr1	182584274	182585764	LOC284648	1490	0.533557
chr1	182615791	182642067	RGS8	26276	0.440782
chr1	182758583	182799519	NPL	40936	0.418800
chr1	182808438	182857117	DHX9	48679	0.382567
chr1	182868999	182922553	SHCBP1L	53554	0.384117
chr1	182992594	183114727	LAMC1	122133	0.400768
chr1	183155173	183214262	LAMC2	59089	0.433211
chr1	183217371	183387634	NMNAT2	170263	0.444025
chr1	183430010	183441117	SMG7-AS1	11107	0.410642
chr1	183441505	183523328	SMG7	81823	0.373196
chr1	183524696	183560056	NCF2	35360	0.465922
chr1	183595327	183605076	ARPC5	9749	0.385168
chr1	183605207	183897666	RGL1	292459	0.399796
chr1	183615410	183622448	APOBEC4	7038	0.385195
chr1	183904965	184006863	COLGALT2	101898	0.400656
chr1	184020810	184043344	TSEN15	22534	0.350404
chr1	184356149	184598155	C1orf21	242006	0.402676
chr1	184659624	184724041	EDEM3	64417	0.343962
chr1	184727265	184730133	AX747662	2868	0.383194
chr1	184760158	184943718	FAM129A	183560	0.401329
chr1	185014550	185071740	RNF2	57190	0.393443
chr1	185087217	185126116	TRMT1L	38899	0.354945
chr1	185126191	185260913	SWT1	134722	0.376397
chr1	185220508	185220534	JA611272	26	0.538462
chr1	185265521	185286461	IVNS1ABP	20940	0.373543
chr1	185292978	185304171	LOC100288079	11193	0.390780
chr1	185405427	185405453	JA611272	26	0.346154
chr1	185527511	185597620	AF508906	70109	0.380122
chr1	185576315	185591914	AF508907	15599	0.342394
chr1	185703682	186160085	HMCN1	456403	0.359713
chr1	186029866	186446655	MIR548F1	416789	0.365156
chr1	186265404	186283688	PRG4	18284	0.380606
chr1	186280785	186344457	TPR	63672	0.340024
chr1	186348898	186390503	C1orf27	41605	0.348756
chr1	186369703	186370587	OCLM	884	0.355204
chr1	186412697	186430240	PDC	17543	0.352904
chr1	186640943	186649559	PTGS2	8616	0.349118
chr1	186798031	186958113	PLA2G4A	160082	0.361015
chr1	187610357	187612988	C1orf99	2631	0.385025
chr1	190066796	190446759	FAM5C	379963	0.332227
chr1	190447389	190450524	CR936711	3135	0.376715
chr1	190594019	190770788	LOC440704	176769	0.333407
chr1	192127591	192154945	RGS18	27354	0.339548
chr1	192286121	192336414	RGS21	50293	0.327839
chr1	192544856	192549159	RGS1	4303	0.339066
chr1	192605267	192629440	RGS13	24173	0.357217
chr1	192778168	192781407	RGS2	3239	0.408151
chr1	192844815	192845115	7SK	300	0.483333
chr1	192981495	193028523	UCHL5	47028	0.345603
chr1	193026410	193026545	SnoU109	135	0.400000
chr1	193027466	193029189	UCHL5	1723	0.594312
chr1	193028551	193055115	TROVE2	26564	0.368506
chr1	193065594	193074608	GLRX2	9014	0.415354
chr1	193091087	193223942	CDC73	132855	0.356577
chr1	193105632	193105713	MIR1278	81	0.370370
chr1	193147859	193155743	B3GALT2	7884	0.323186
chr1	196194912	196577499	KCNT2	382587	0.337994
chr1	196551542	196551611	MIR4735	69	0.376812
chr1	196621007	196716634	CFH	95627	0.352003
chr1	196743929	196763203	CFHR3	19274	0.356024
chr1	196912933	196928356	CFHR2	15423	0.357518
chr1	196946666	196978803	CFHR5	32137	0.348819
chr1	197008320	197036397	F13B	28077	0.340742
chr1	197053256	197115824	ASPM	62568	0.346599
chr1	197122813	197169672	ZBTB41	46859	0.333981
chr1	197237333	197447585	CRB1	210252	0.365252
chr1	197473878	197744623	DENND1B	270745	0.342902
chr1	197871681	197876497	C1orf53	4816	0.411545
chr1	197886516	197899273	LHX9	12757	0.440229
chr1	198126107	198291548	NEK7	165441	0.358400
chr1	198492351	198510075	ATP6V1G3	17724	0.352855
chr1	198608097	198726605	PTPRC	118508	0.342517
chr1	198777131	198906558	MIR181A1HG	129427	0.350259
chr1	198828001	198828111	MIR181B1	110	0.445455
chr1	198828172	198828282	MIR181A1	110	0.418182
chr1	198975168	198990166	BC040869	14998	0.339312
chr1	199996729	200146550	NR5A2	149821	0.406992
chr1	200023188	200023293	U6	105	0.390476
chr1	200311671	200342920	LINC00862	31249	0.429038
chr1	200375419	200379166	ZNF281	3747	0.460368
chr1	200380927	200444641	EU250746	63714	0.397636
chr1	200520624	200589862	KIF14	69238	0.378333
chr1	200613164	200639126	DDX59	25962	0.422155
chr1	200708685	200829831	CAMSAP2	121146	0.376925
chr1	200842082	200843306	GPR25	1224	0.727124
chr1	200860626	200884864	C1orf106	24238	0.529087
chr1	200898071	200935796	C1orf81	37725	0.452909
chr1	200938513	200992828	KIF21B	54315	0.550014
chr1	200993076	200997920	BC016656	4844	0.502271
chr1	201008639	201081694	CACNA1S	73055	0.516022
chr1	201083080	201084500	ASCL5	1420	0.671127
chr1	201103899	201123632	TMEM9	19733	0.518826
chr1	201159952	201198080	IGFN1	38128	0.524680
chr1	201252579	201302121	PKP1	49542	0.522446
chr1	201328135	201346828	TNNT2	18693	0.545712
chr1	201349965	201368669	LAD1	18704	0.545498
chr1	201372894	201390874	TNNI1	17980	0.523749
chr1	201434606	201438299	PHLDA3	3693	0.599513
chr1	201434606	201438299	PHLDA3	3693	0.599513
chr1	201452657	201475967	CSRP1	23310	0.502488
chr1	201489031	201489720	RPS10P7	689	0.492017
chr1	201604354	201606516	AX747377	2162	0.484736
chr1	201617449	201796102	NAV1	178653	0.471669
chr1	201688635	201688755	MIR5191	120	0.566667
chr1	201777738	201777830	MIR1231	92	0.586957
chr1	201798287	201853422	IPO9	55135	0.418881
chr1	201857804	201861715	SHISA4	3911	0.580414
chr1	201865583	201915716	LMOD1	50133	0.485169
chr1	201924618	201939789	TIMM17A	15171	0.423176
chr1	201951765	201975275	RNPEP	23510	0.485113
chr1	201979689	201986315	ELF3	6626	0.550860
chr1	202092028	202098634	GPR37L1	6606	0.545867
chr1	202102531	202113871	ARL8A	11340	0.533333
chr1	202116140	202130716	PTPN7	14576	0.529158
chr1	202152694	202156267	PTPRVP	3573	0.580744
chr1	202156130	202158577	PTPRVP	2447	0.614630
chr1	202163117	202288889	LGR6	125772	0.495881
chr1	202300784	202311094	UBE2T	10310	0.406693
chr1	202317829	202557697	PPP1R12B	239868	0.393963
chr1	202379235	202379335	U6	100	0.350000
chr1	202559724	202679551	SYT2	119827	0.501531
chr1	202696531	202777549	KDM5B	81018	0.410625
chr1	202780073	202781041	KDM5B-AS1	968	0.637397
chr1	202794328	202795421	LOC641515	1093	0.520586
chr1	202827080	202830736	BC049825	3656	0.548414
chr1	202830881	202844369	LOC148709	13488	0.463597
chr1	202847409	202858385	RABIF	10976	0.457270
chr1	202860229	202896371	KLHL12	36142	0.414670
chr1	202909959	202927524	ADIPOR1	17565	0.439966
chr1	202931000	202936404	CYB5R1	5404	0.502776
chr1	202955579	202976393	LOC401980	20814	0.421495
chr1	202976533	202993197	TMEM183A	16664	0.414186
chr1	203003611	203047864	PPFIA4	44253	0.529184
chr1	203052256	203055166	MYOG	2910	0.580069
chr1	203096835	203136533	ADORA1	39698	0.511008
chr1	203097405	203136533	ADORA1	39128	0.509073
chr1	203136938	203144942	MYBPH	8004	0.576212
chr1	203148058	203155922	CHI3L1	7864	0.547940
chr1	203185206	203198860	CHIT1	13654	0.513549
chr1	203267885	203274453	LOC730227	6568	0.473508
chr1	203274663	203278729	BTG2	4066	0.531727
chr1	203309751	203320289	FMOD	10538	0.501708
chr1	203444882	203460479	PRELP	15597	0.500224
chr1	203463270	203478077	OPTC	14807	0.511650
chr1	203595914	203713209	ATP2B4	117295	0.464802
chr1	203696748	203696784	U42379	36	0.555556
chr1	203698708	203698833	SNORA77	125	0.568000
chr1	203699704	203700979	LINC00260	1275	0.484706
chr1	203734283	203745480	LAX1	11197	0.462803
chr1	203764750	203823256	ZC3H11A	58506	0.408608
chr1	203766650	203769590	ZBED6	2940	0.421088
chr1	203830739	203840280	SNRPE	9541	0.424065
chr1	204001574	204010392	LINC00303	8818	0.480154
chr1	204042245	204096871	SOX13	54626	0.517574
chr1	204100189	204121307	ETNK2	21118	0.527559
chr1	204110535	204112137	BC038769	1602	0.518727
chr1	204123943	204135465	REN	11522	0.518747
chr1	204159468	204165619	KISS1	6151	0.516827
chr1	204167287	204183220	GOLT1A	15933	0.475240
chr1	204187978	204329057	PLEKHA6	141079	0.487755
chr1	204337557	204338847	LINC00628	1290	0.521705
chr1	204372491	204380944	PPP1R15B	8453	0.404472
chr1	204379010	204380945	AK316092	1935	0.545736
chr1	204391757	204459474	PIK3C2B	67717	0.491885
chr1	204485506	204527248	MDM4	41742	0.425183
chr1	204586302	204654597	LRRN2	68295	0.500256
chr1	204595902	204598840	AK097184	2938	0.525868
chr1	204797781	204991950	NFASC	194169	0.479237
chr1	204981852	204991950	NFASC	10098	0.539711
chr1	204989426	204991950	AX746920	2524	0.501585
chr1	205012339	205047171	CNTN2	34832	0.541686
chr1	205052256	205053588	TMEM81	1332	0.475225
chr1	205055269	205091150	RBBP5	35881	0.407765
chr1	205111630	205180727	DSTYK	69097	0.435677
chr1	205197037	205242471	TMCC2	45434	0.514042
chr1	205271190	205290883	NUAK2	19693	0.512822
chr1	205305192	205326218	KLHDC8A	21026	0.508799
chr1	205342379	205356568	LEMD1-AS1	14189	0.446050
chr1	205350505	205391214	LEMD1	40709	0.428431
chr1	205417429	205417526	MIR135B	97	0.525773
chr1	205425185	205438152	AK095633	12967	0.496722
chr1	205473683	205495965	CDK18	22282	0.548694
chr1	205473683	205501921	CDK18	28238	0.557015
chr1	205523400	205525763	LOC284578	2363	0.398646
chr1	205538111	205572046	MFSD4	33935	0.508678
chr1	205564168	205564275	U6	107	0.457944
chr1	205626980	205649630	SLC45A3	22650	0.544371
chr1	205681946	205719372	NUCKS1	37426	0.395554
chr1	205737113	205744610	RAB7L1	7497	0.460051
chr1	205758220	205782161	SLC41A1	23941	0.502736
chr1	205765004	205765744	AX748016	740	0.486486
chr1	205797149	205819276	PM20D1	22127	0.466444
chr1	205831206	205865215	LOC284581	34009	0.412567
chr1	205882176	205912588	SLC26A9	30412	0.520255
chr1	206138910	206155074	FAM72A	16164	0.396065
chr1	206224282	206231482	AVPR1B	7200	0.513056
chr1	206238881	206288236	C1orf186	49355	0.442225
chr1	206317458	206332104	CTSE	14646	0.437457
chr1	206516199	206637783	SRGAP2	121584	0.432771
chr1	206643585	206670223	IKBKE	26638	0.533711
chr1	206680878	206762616	RASSF5	81738	0.482003
chr1	206764973	206785904	EIF2D	20931	0.444221
chr1	206808880	206822542	DYRK3	13662	0.418460
chr1	206858364	206907630	MAPKAPK2	49266	0.486421
chr1	206940947	206945839	IL10	4892	0.477719
chr1	206972214	207016326	IL19	44112	0.438633
chr1	207039153	207042568	IL20	3415	0.423719
chr1	207070787	207077484	IL24	6697	0.484695
chr1	207076630	207095378	FAIM3	18748	0.480265
chr1	207101866	207119811	PIGR	17945	0.492784
chr1	207131311	207143970	FCAMR	12659	0.489849
chr1	207191865	207206101	C1orf116	14236	0.474571
chr1	207226619	207251162	PFKFB2	24543	0.446604
chr1	207217193	207224422	YOD1	7229	0.376401
chr1	207262211	207273337	C4BPB	11126	0.399964
chr1	207277510	207277617	AX229788	107	0.457944
chr1	207277606	207318317	C4BPA	40711	0.392130
chr1	207494816	207534311	CD55	39495	0.363590
chr1	207627644	207663240	CR2	35596	0.391083
chr1	207669472	207815110	CR1	145638	0.391629
chr1	207818457	207897036	CR1L	78579	0.404154
chr1	207925382	207968861	CD46	43479	0.382345
chr1	207975196	207975868	MIR29C	672	0.491071
chr1	207991723	207995941	LOC148696	4218	0.523234
chr1	208039465	208042417	AK123177	2952	0.576897
chr1	208059882	208084683	CD34	24801	0.457723
chr1	208195587	208417665	PLXNA2	222078	0.479809
chr1	209602167	209605892	MIR205HG	3725	0.483490
chr1	209757044	209787284	CAMK1G	30240	0.470073
chr1	209788217	209825820	LAMB3	37603	0.499508
chr1	209796788	209796855	MIR4260	67	0.582090
chr1	209848669	209849735	G0S2	1066	0.582552
chr1	209878135	209908295	HSD11B1	30160	0.402553
chr1	209929393	209955668	TRAF3IP3	26275	0.455985
chr1	209955661	209957890	C1orf74	2229	0.484971
chr1	209958967	209979520	IRF6	20553	0.449569
chr1	210001311	210030910	DIEXF	29599	0.414575
chr1	210111518	210337633	SYT14	226115	0.365694
chr1	210404803	210407466	SERTAD4-AS1	2663	0.579797
chr1	210406194	210416440	SERTAD4	10246	0.455495
chr1	210501595	210849638	HHAT	348043	0.422586
chr1	210851656	211307457	KCNH1	455801	0.410681
chr1	211432707	211489725	RCOR3	57018	0.368971
chr1	211500147	211548286	TRAF5	48139	0.445626
chr1	211556096	211605877	LINC00467	49781	0.389245
chr1	211649863	211666259	RD3	16396	0.512015
chr1	211748380	211752099	SLC30A1	3719	0.454154
chr1	211836113	211848972	NEK2	12859	0.386889
chr1	211916798	212004114	LPGAT1	87316	0.383000
chr1	212113740	212209002	INTS7	95262	0.381558
chr1	212208918	212278187	DTL	69269	0.384082
chr1	212250954	212251027	MIR3122	73	0.506849
chr1	212317864	212318301	BC010168	437	0.455378
chr1	212458878	212535205	PPP2R5A	76327	0.392757
chr1	212526159	212526292	SNORA16B	133	0.421053
chr1	212537815	212588267	TMEM206	50452	0.446405
chr1	212606228	212619721	NENF	13493	0.477210
chr1	212781969	212794119	ATF3	12150	0.488971
chr1	212797625	212800113	FAM71A	2488	0.551045
chr1	212797788	212800120	FAM71A	2332	0.554031
chr1	212859758	212873327	BATF3	13569	0.491267
chr1	212899494	212965139	NSL1	65645	0.397608
chr1	212965169	212990167	TATDN3	24998	0.405592
chr1	213003484	213020991	C1orf227	17507	0.439538
chr1	213029945	213031480	FLVCR1-AS1	1535	0.512052
chr1	213031596	213072705	FLVCR1	41109	0.402661
chr1	213123886	213164927	VASH2	41041	0.482542
chr1	213165523	213189168	ANGEL2	23645	0.386805
chr1	213224587	213446808	RPS6KC1	222221	0.375100
chr1	213992977	214139607	AK092251	146630	0.407181
chr1	214098091	214099996	LINC00538	1905	0.425722
chr1	214161277	214214847	PROX1	53570	0.403192
chr1	214454564	214510477	SMYD2	55913	0.435033
chr1	214522038	214725024	PTPN14	202986	0.412122
chr1	214655881	214656819	BC171896	938	0.407249
chr1	214776531	214837914	CENPF	61383	0.409218
chr1	215256559	215410436	KCNK2	153877	0.360990
chr1	215740734	215795149	KCTD3	54415	0.360415
chr1	215796235	216596738	USH2A	800503	0.363600
chr1	216676587	216896814	ESRRG	220227	0.366208
chr1	217603833	217804409	GPATCH2	200576	0.363947
chr1	217804694	218040484	SPATA17	235790	0.356690
chr1	218066241	218094146	LINC00210	27905	0.418527
chr1	218458628	218511325	RRP15	52697	0.376359
chr1	218517537	218519020	LOC728463	1483	0.437626
chr1	218518675	218617961	TGFB2	99286	0.420311
chr1	219254316	219347130	LOC643723	92814	0.360700
chr1	219347191	219386207	LYPLAL1	39016	0.339502
chr1	220046618	220292777	RNU5F-1	246159	0.396589
chr1	220087605	220101993	SLC30A10	14388	0.424937
chr1	220141941	220220000	EPRS	78059	0.381468
chr1	220230823	220263191	BPNT1	32368	0.403269
chr1	220267454	220321383	IARS2	53929	0.391997
chr1	220291194	220291304	MIR215	110	0.345455
chr1	220291498	220291583	MIR194-1	85	0.411765
chr1	220291547	220291569	DM119532	22	0.454545
chr1	220321609	220445843	RAB3GAP2	124234	0.378045
chr1	220373883	220374018	SNORA36B	135	0.355556
chr1	220439520	220441057	AURKAPS1	1537	0.437215
chr1	220701567	220837799	MARK1	136232	0.370853
chr1	220863627	220872499	C1orf115	8872	0.481064
chr1	220921675	220957596	MARC2	35921	0.440912
chr1	220960038	220987741	MARC1	27703	0.452009
chr1	220999117	220999235	U6atac	118	0.423729
chr1	221002596	221005770	BC045735	3174	0.436673
chr1	221052742	221058400	HLX	5658	0.544185
chr1	221503269	221509638	C1orf140	6369	0.405244
chr1	221874763	221915516	DUSP10	40753	0.413442
chr1	222646009	222646043	DQ587965	34	0.558824
chr1	222646722	222646767	DQ573170	45	0.644444
chr1	222646839	222646870	DQ576410	31	0.516129
chr1	222647751	222647786	DQ584993	35	0.600000
chr1	222648391	222648423	DQ584971	32	0.531250
chr1	222648536	222648596	DQ575983	60	0.550000
chr1	222648680	222648717	DQ597892	37	0.594595
chr1	222649002	222649064	DQ574659	62	0.532258
chr1	222649161	222649251	DQ584609	90	0.577778
chr1	222650319	222650381	DQ600234	62	0.564516
chr1	222650411	222650443	DQ599872	32	0.468750
chr1	222695601	222721444	HHIPL2	25843	0.437565
chr1	222731243	222763275	TAF1A	32032	0.363418
chr1	222791443	222841351	MIA3	49908	0.391400
chr1	222841354	222885864	AIDA	44510	0.382161
chr1	222885905	222906106	BROX	20201	0.371813
chr1	222900275	222946483	AK094916	46208	0.391318
chr1	222906202	222908533	AK025140	2331	0.335907
chr1	222910557	222924002	FAM177B	13445	0.397025
chr1	222988430	223179337	DISP1	190907	0.372328
chr1	223282747	223316624	TLR5	33877	0.466098
chr1	223394160	223537544	SUSD4	143384	0.442330
chr1	223566714	223568812	C1orf65	2098	0.632984
chr1	223714971	223853436	CAPN8	138465	0.307775
chr1	223900118	223963720	CAPN2	63602	0.489654
chr1	223967594	224033674	TP53BP2	66080	0.397912
chr1	224051997	224052306	HM358976	309	0.601942
chr1	224139721	224139941	DQ599872	220	0.559091
chr1	224189608	224197818	AK124970	8210	0.340560
chr1	224294983	224295243	7SK	260	0.415385
chr1	224301788	224349749	FBXO28	47961	0.409750
chr1	224370909	224381142	DEGS1	10233	0.451871
chr1	224415035	224517891	NVL	102856	0.415571
chr1	224444705	224444843	MIR320B2	138	0.369565
chr1	224544512	224566223	CNIH4	21711	0.431256
chr1	224572844	224622001	WDR26	49157	0.376732
chr1	224585928	224586013	MIR4742	85	0.341176
chr1	224586541	224586601	DL490795	60	0.250000
chr1	224804178	224928249	CNIH3	124071	0.462098
chr1	225117355	225586996	DNAH14	469641	0.372280
chr1	225589203	225615815	LBR	26612	0.411281
chr1	225674533	225840845	ENAH	166312	0.385516
chr1	225888305	225939945	AK124056	51640	0.468029
chr1	225965514	225978168	SRP9	12654	0.406038
chr1	225997796	226033262	EPHX1	35466	0.507641
chr1	226033232	226070420	TMEM63A	37188	0.518017
chr1	226073981	226076846	LEFTY1	2865	0.597557
chr1	226107576	226112040	PYCR2	4464	0.549731
chr1	226124297	226129083	LEFTY2	4786	0.562683
chr1	226170402	226187066	SDE2	16664	0.406505
chr1	226250407	226259703	H3F3A	9296	0.415340
chr1	226271655	226277994	BC032899	6339	0.481937
chr1	226332379	226374423	ACBD3	42044	0.414447
chr1	226374532	226385086	BC033346	10554	0.452530
chr1	226411382	226413513	MIXL1	2131	0.535899
chr1	226418849	226497204	LIN9	78355	0.395891
chr1	226548391	226595801	PARP1	47410	0.468045
chr1	226723318	226730469	AK055856	7151	0.448609
chr1	226736500	226796915	C1orf95	60415	0.496632
chr1	226819390	226926876	ITPKB	107486	0.498037
chr1	227058272	227083804	PSEN2	25532	0.522677
chr1	227127937	227175246	ADCK3	47309	0.537086
chr1	227177565	227505826	CDC42BPA	328261	0.366251
chr1	227581291	227618723	BC039356	37432	0.424503
chr1	227751219	227850164	ZNF678	98945	0.403295
chr1	227884732	227885408	ZNF847P	676	0.408284
chr1	227922696	227968932	SNAP47	46236	0.530344
chr1	227918889	227923112	JMJD4	4223	0.616860
chr1	228003417	228034171	PRSS38	30754	0.426221
chr1	228109164	228135676	WNT9A	26512	0.573853
chr1	228129290	228129384	MIR5008	94	0.702128
chr1	228155293	228155325	DQ597235	32	0.468750
chr1	228155355	228155417	DQ599768	62	0.564516
chr1	228156485	228156575	DQ590432	90	0.577778
chr1	228156672	228156704	DQ574660	32	0.531250
chr1	228157022	228157062	DQ584939	40	0.600000
chr1	228157172	228157203	DQ599799	31	0.516129
chr1	228160064	228160098	DQ575010	34	0.558824
chr1	228160168	228160213	DQ575955	45	0.644444
chr1	228194722	228248972	WNT3A	54250	0.524959
chr1	228270360	228286913	ARF1	16553	0.523289
chr1	228284963	228285042	MIR3620	79	0.708861
chr1	228288427	228291022	C1orf35	2595	0.648170
chr1	228294379	228297013	MRPL55	2634	0.566819
chr1	228327928	228336655	GUK1	8727	0.615905
chr1	228337414	228347527	GJC2	10113	0.625037
chr1	228353428	228369958	IBA57	16530	0.547005
chr1	228391206	228401365	C1orf145	10159	0.601142
chr1	228395830	228566575	OBSCN	170745	0.538692
chr1	228581376	228594517	TRIM11	13141	0.569515
chr1	228595635	228604583	TRIM17	8948	0.567725
chr1	228612545	228613026	HIST3H3	481	0.634096
chr1	228645064	228645560	HIST3H2A	496	0.657258
chr1	228645807	228646259	HIST3H2BB	452	0.601770
chr1	228649774	228649853	MIR4666A	79	0.354430
chr1	228651845	228651891	Histone3	46	0.543478
chr1	228673888	228674821	BC015435	933	0.584137
chr1	228675067	228683889	RNF187	8822	0.555430
chr1	228780393	228788159	DUSP5P1	7766	0.542364
chr1	228870823	228882416	RHOU	11593	0.465367
chr1	229050379	229052954	AX748369	2575	0.468350
chr1	229406808	229441640	RAB4A	34832	0.413241
chr1	229440128	229441250	SPHAR	1122	0.332442
chr1	229456751	229478688	CCSAP	21937	0.430870
chr1	229566992	229569843	ACTA1	2851	0.625395
chr1	229577043	229644088	NUP133	67045	0.401805
chr1	229589676	229591617	AX747652	1941	0.394642
chr1	229652328	229694442	ABCB10	42114	0.436244
chr1	229728865	229761794	TAF5L	32929	0.419144
chr1	229761980	229795946	URB2	33966	0.435936
chr1	230202955	230417875	GALNT2	214920	0.461553
chr1	230457391	230561674	PGBD5	104283	0.481382
chr1	230778201	230829731	COG2	51530	0.394450
chr1	230838271	230850336	AGT	12065	0.538748
chr1	230883129	230937749	CAPN9	54620	0.478506
chr1	230972864	231004302	C1orf198	31438	0.473408
chr1	231010591	231014761	BC032911	4170	0.476019
chr1	231041986	231114618	TTC13	72632	0.397304
chr1	231114822	231136479	ARV1	21657	0.415339
chr1	231154703	231175995	FAM89A	21292	0.470271
chr1	231298673	231357314	TRIM67	58641	0.485838
chr1	231319844	231323373	LOC149373	3529	0.512893
chr1	231359508	231376924	C1orf131	17416	0.434887
chr1	231376918	231413719	GNPAT	36801	0.418086
chr1	231468481	231473578	EXOC8	5097	0.431234
chr1	231473681	231490769	SPRTN	17088	0.404085
chr1	231499496	231560790	EGLN1	61294	0.396483
chr1	231611509	231612271	SNRPD2P2	762	0.461942
chr1	231762560	232177019	DISC1	414459	0.421772
chr1	231664398	231702269	TSNAX	37871	0.376594
chr1	231727037	231747836	LINC00582	20799	0.418722
chr1	231950371	231954263	DISC2	3892	0.377698
chr1	232533711	232651243	SIPA1L2	117532	0.412688
chr1	232940637	232946092	MAP10	5455	0.395784
chr1	233086369	233114219	NTPCR	27850	0.419892
chr1	233119881	233431459	PCNXL2	311578	0.408620
chr1	233463513	233520894	KIAA1804	57381	0.398703
chr1	233584371	233584527	U4	156	0.403846
chr1	233749749	233808258	KCNK1	58509	0.421576
chr1	233759897	233759965	MIR4427	68	0.397059
chr1	234040678	234460262	SLC35F3	419584	0.423574
chr1	234348351	234350834	AK054726	2483	0.555779
chr1	234442212	234442285	MIR4671	73	0.369863
chr1	234509428	234519795	COA6	10367	0.445934
chr1	234527058	234614849	TARBP1	87791	0.402741
chr1	234663636	234667525	LOC100506795	3889	0.458730
chr1	234740014	234745271	IRF2BP2	5257	0.480122
chr1	234765056	234770526	LINC00184	5470	0.419927
chr1	234782034	234796670	BC032040	14636	0.429352
chr1	234859788	234867390	LOC100506810	7602	0.506183
chr1	235093089	235099746	BC016972	6657	0.489109
chr1	235272657	235292256	TOMM20	19599	0.416807
chr1	235291117	235291252	SNORA14B	135	0.466667
chr1	235294497	235324772	RBM34	30275	0.444756
chr1	235330209	235491532	ARID4B	161323	0.389634
chr1	235353348	235353431	MIR4753	83	0.385542
chr1	235491752	235507844	GGPS1	16092	0.415113
chr1	235530727	235612280	TBCE	81553	0.443883
chr1	235610504	235667781	B3GALNT2	57277	0.402605
chr1	235710984	235814054	GNG4	103070	0.480654
chr1	235712454	235714587	AX747026	2133	0.478669
chr1	235824330	236030227	LYST	205897	0.373488
chr1	236016299	236016360	MIR1537	61	0.409836
chr1	236139131	236228481	NID1	89350	0.449905
chr1	236227659	236229779	AX747246	2120	0.615566
chr1	236305831	236372209	GPR137B	66378	0.453629
chr1	236378421	236445339	ERO1LB	66918	0.374907
chr1	236557679	236648008	EDARADD	90329	0.454461
chr1	236686738	236716279	LGALS8	29541	0.437968
chr1	236686368	236687808	LGALS8-AS1	1440	0.607639
chr1	236712304	236767841	HEATR1	55537	0.385203
chr1	236849769	236927558	ACTN2	77789	0.431012
chr1	236958580	237067281	MTR	108701	0.407264
chr1	236973802	236992568	MTR	18766	0.386923
chr1	237167402	237167718	MT1HL1	316	0.585443
chr1	237205701	237997288	RYR2	791587	0.385165
chr1	237284106	237284409	7SK	303	0.534653
chr1	238025474	238091619	LOC100130331	66145	0.419669
chr1	238041163	238054222	ZP4	13059	0.438165
chr1	238643683	238649317	LOC339535	5634	0.406638
chr1	239792372	240072717	CHRM3	280345	0.391646
chr1	240170823	240176560	RPS7P5	5737	0.503225
chr1	240255184	240638489	FMN2	383305	0.391341
chr1	240652872	240775462	GREM2	122590	0.405775
chr1	240938816	241520478	RGS7	581662	0.391468
chr1	241295571	241295646	MIR3123	75	0.386667
chr1	241660856	241683085	FH	22229	0.368798
chr1	241695433	241758949	KMO	63516	0.380046
chr1	241756451	241803701	OPN3	47250	0.389630
chr1	241792166	241799232	CHML	7066	0.349420
chr1	241815579	241965434	WDR64	149855	0.385106
chr1	242011492	242053241	EXO1	41749	0.394596
chr1	242158791	242162385	MAP1LC3C	3594	0.490262
chr1	242251688	242687998	PLD5	436310	0.403949
chr1	243218732	243218763	DQ576410	31	0.516129
chr1	243219238	243219328	DQ584609	90	0.577778
chr1	243219615	243265046	LOC731275	45431	0.455262
chr1	243287729	243418708	CEP170	130979	0.362852
chr1	243419306	243663393	SDCCAG8	244087	0.398129
chr1	243509477	243509557	MIR4677	80	0.462500
chr1	243663020	244006584	AKT3	343564	0.367064
chr1	244080703	244210619	LOC339529	129916	0.425052
chr1	244212240	244220780	ZBTB18	8540	0.443443
chr1	244515936	244552388	C1orf100	36452	0.448590
chr1	244571793	244615436	ADSS	43643	0.382971
chr1	244624672	244803662	C1orf101	178990	0.393860
chr1	244816351	244872334	DESI2	55983	0.403372
chr1	244998638	245008359	COX20	9721	0.394815
chr1	245003939	245010243	HNRNPU-AS1	6304	0.371034
chr1	245013601	245027827	HNRNPU	14226	0.403979
chr1	245133170	245251148	EFCAB2	117978	0.412077
chr1	245318286	245866428	KIF26B	548142	0.447962
chr1	245912641	246670644	SMYD3	758003	0.405984
chr1	246679340	246687589	LOC255654	8249	0.576070
chr1	246703862	246729565	TFB2M	25703	0.419056
chr1	246729638	246831884	CNST	102246	0.413376
chr1	246887377	246931440	SCCPDH	44063	0.419218
chr1	246939314	246955685	LOC149134	16371	0.522815
chr1	246970416	246970487	SNORD112	71	0.450704
chr1	247002401	247094726	AHCTF1	92325	0.385259
chr1	247148624	247171395	ZNF695	22771	0.408941
chr1	247197939	247242115	ZNF670	44176	0.411287
chr1	247263263	247267674	ZNF669	4411	0.430741
chr1	247273461	247275719	C1orf229	2258	0.645261
chr1	247319202	247335318	ZNF124	16116	0.399106
chr1	247337903	247338870	BC043220	967	0.449845
chr1	247365268	247365362	MIR3916	94	0.478723
chr1	247419373	247420447	VN1R5	1074	0.424581
chr1	247463621	247495045	ZNF496	31424	0.480143
chr1	247579457	247612406	NLRP3	32949	0.466873
chr1	247614330	247615284	OR2B11	954	0.560797
chr1	247654369	247655711	OR2W5	1342	0.514903
chr1	247681594	247683942	AK130400	2348	0.466780
chr1	247693433	247697141	OR2C3	3708	0.475189
chr1	247712346	247739848	GCSAML	27502	0.386990
chr1	247751661	247752615	OR2G2	954	0.484277
chr1	247768887	247769817	OR2G3	930	0.462366
chr1	247835419	247836343	OR13G1	924	0.452381
chr1	247875130	247876057	OR6F1	927	0.505933
chr1	247920763	247921708	OR1C1	945	0.478307
chr1	247978101	247979031	OR14A16	930	0.422581
chr1	248004229	248005198	OR11L1	969	0.510836
chr1	248020500	248043438	TRIM58	22938	0.437135
chr1	248058888	248059833	OR2W3	945	0.569312
chr1	248084319	248085258	OR2T8	939	0.533546
chr1	248100492	248264224	OR2L13	163732	0.367460
chr1	248112159	248113098	OR2L8	939	0.449414
chr1	248128633	248129641	OR2AK2	1008	0.444444
chr1	248153568	248154493	OR2L1P	925	0.447568
chr1	248185249	248186188	OR2L5	939	0.446219
chr1	248201473	248202607	OR2L2	1134	0.430335
chr1	248223983	248224922	OR2L3	939	0.451544
chr1	248285437	248286082	OR2M1P	645	0.460465
chr1	248308449	248309388	OR2M5	939	0.478168
chr1	248343287	248344331	OR2M2	1044	0.448276
chr1	248366369	248367308	OR2M3	939	0.480298
chr1	248402230	248403166	OR2M4	936	0.464744
chr1	248436153	248437116	OR2T33	963	0.526480
chr1	248457917	248458880	OR2T12	963	0.532710
chr1	248486931	248487870	OR2M7	939	0.467519
chr1	248512076	248513015	OR14C36	939	0.464324
chr1	248524882	248525929	OR2T4	1047	0.496657
chr1	248550909	248551836	OR2T6	927	0.502697
chr1	248569295	248570405	OR2T1	1110	0.472973
chr1	248616098	248617073	OR2T2	975	0.529231
chr1	248636651	248637608	OR2T3	957	0.535005
chr1	248651889	248652837	OR2T5	948	0.508439
chr1	248684947	248685898	OR2G6	951	0.495268
chr1	248721844	248722792	OR2T29	948	0.508439
chr1	248737101	248738058	OR2T34	957	0.536050
chr1	248756130	248757069	OR2T10	939	0.476038
chr1	248789478	248790429	OR2T11	951	0.498423
chr1	248801587	248802559	OR2T35	972	0.528807
chr1	248813231	248814185	OR2T27	954	0.526205
chr1	248844669	248845605	OR14I1	936	0.481838
chr1	248881947	248885507	BC033943	3560	0.391573
chr1	248902716	248903151	LYPD8	435	0.540230
chr1	249104650	249120154	SH3BP5L	15504	0.521349
chr1	249120575	249120642	MIR3124	67	0.582090
chr1	249132529	249143714	ZNF672	11185	0.522128
chr1	249144202	249153315	ZNF692	9113	0.541315
chr1	249200441	249213345	PGBD2	12904	0.467064
chr10	92827	95178	TUBB8	2351	0.590812
chr10	225933	295729	ZMYND11	69796	0.370480
chr10	320129	735608	DIP2C	415479	0.484270
chr10	468763	531104	DIP2C	62341	0.453762
chr10	687628	687718	MIR5699	90	0.577778
chr10	696016	711109	PRR26	15093	0.489035
chr10	852853	977645	LARP4B	124792	0.426966
chr10	988073	988583	BC127786	510	0.433333
chr10	1034348	1063708	GTPBP4	29360	0.469619
chr10	1064846	1071799	IDI2	6953	0.469581
chr10	1068576	1090141	IDI2-AS1	21565	0.424530
chr10	1085963	1095061	IDI1	9098	0.434271
chr10	1094996	1096202	BC046483	1206	0.548922
chr10	1102775	1178237	WDR37	75462	0.456945
chr10	1136094	1138119	AX748285	2025	0.503210
chr10	1205707	1210612	LINC00200	4905	0.496228
chr10	1223252	1779670	ADARB2	556418	0.477391
chr10	1568824	1599179	ADARB2-AS1	30355	0.520046
chr10	2047666	2056542	LINC00700	8876	0.453245
chr10	2342512	2357268	LINC00701	14756	0.375712
chr10	3109711	3178997	PFKP	69286	0.510608
chr10	3179918	3215033	PITRM1	35115	0.461740
chr10	3183792	3190821	PITRM1-AS1	7029	0.483710
chr10	3206389	3208567	BC039685	2178	0.431129
chr10	3360886	3791666	BC037918	430780	0.431385
chr10	3818187	3827473	KLF6	9286	0.480831
chr10	4093917	4131205	AK055803	37288	0.418741
chr10	4426437	4452804	AK095699	26367	0.388137
chr10	4557143	4557249	U6	106	0.433962
chr10	4621442	4720262	LINC00704	98820	0.370047
chr10	4698347	4704606	LINC00705	6259	0.399265
chr10	4868368	4890251	AKR1E2	21883	0.472102
chr10	4913858	4958465	AKR1C6P	44607	0.384558
chr10	5090957	5149878	AKR1C3	58921	0.399874
chr10	5029967	5060225	AKR1C2	30258	0.389913
chr10	5196654	5227150	AKR1CL1	30496	0.385362
chr10	5238797	5260910	AKR1C4	22113	0.386424
chr10	5406975	5416169	UCN3	9194	0.465847
chr10	5435060	5446793	TUBAL3	11733	0.427512
chr10	5454513	5501019	NET1	46506	0.369974
chr10	5540657	5541533	CALML5	876	0.667808
chr10	5558892	5565140	AK128534	6248	0.420935
chr10	5566923	5568225	CALML3	1302	0.648233
chr10	5680819	5708558	ASB13	27739	0.509716
chr10	5726800	5805703	FAM208B	78903	0.388300
chr10	5734565	5754480	C10orf18	19915	0.366407
chr10	5807185	5855512	GDI2	48327	0.410392
chr10	5903688	5931860	ANKRD16	28172	0.469012
chr10	5936348	5979558	FBXO18	43210	0.455982
chr10	5994333	6019574	IL15RA	25241	0.474585
chr10	6052656	6104333	IL2RA	51677	0.444821
chr10	6130948	6159422	RBM17	28474	0.412727
chr10	6244839	6277507	PFKFB3	32668	0.548978
chr10	6194158	6194240	MIR3155A	82	0.658537
chr10	6194170	6194225	MIR3155B	55	0.690909
chr10	6319649	6377937	LOC399715	58288	0.439113
chr10	6469104	6622254	PRKCQ	153150	0.431022
chr10	6567125	6569172	AX748236	2047	0.458720
chr10	6622386	6627323	PRKCQ-AS1	4937	0.427790
chr10	6821559	6884868	LINC00707	63309	0.406151
chr10	7200585	7451303	SFMBT2	250718	0.435784
chr10	7601231	7708961	ITIH5	107730	0.437232
chr10	7745235	7791483	ITIH2	46248	0.433943
chr10	7792924	7829990	KIN	37066	0.399719
chr10	7830092	7849762	ATP5C1	19670	0.401525
chr10	7860466	8057016	TAF3	196550	0.395701
chr10	8092412	8095447	GATA3-AS1	3035	0.607249
chr10	8096666	8117164	GATA3	20498	0.481023
chr10	8301294	8310268	BC031880	8974	0.412859
chr10	9405819	9407057	HV745896	1238	0.401454
chr10	9421810	9421835	HV745902	25	0.360000
chr10	9421978	9422036	HV745905	58	0.465517
chr10	9421997	9422022	HV745899	25	0.520000
chr10	9424346	9424369	HV745905	23	0.478261
chr10	10100684	10105465	BC032914	4781	0.344698
chr10	10826401	10836877	SFTA1P	10476	0.366648
chr10	10976902	10994126	LINC00710	17224	0.445135
chr10	11059892	11378672	CELF2	318780	0.427637
chr10	11113505	11147451	CELF2-AS2	33946	0.403199
chr10	11295753	11298627	AF007147	2874	0.476688
chr10	11502508	11574274	USP6NL	71766	0.382493
chr10	11784355	11806065	ECHDC3	21710	0.475357
chr10	11865396	11914276	PROSER2	48880	0.463891
chr10	11891606	11936709	PROSER2-AS1	45103	0.505864
chr10	11962020	12084840	UPF2	122820	0.401685
chr10	12110915	12165227	DHTKD1	54312	0.462421
chr10	12171639	12207403	SEC61A2	35764	0.432278
chr10	12209572	12238143	NUDT5	28571	0.446047
chr10	12237960	12292589	CDC123	54629	0.429168
chr10	12391582	12871733	CAMK1D	480151	0.455548
chr10	12620751	12620822	MIR4480	71	0.535211
chr10	12875132	12877545	LOC283070	2413	0.477000
chr10	12938624	13043704	CCDC3	105080	0.444899
chr10	13048110	13141713	AK311458	93603	0.428149
chr10	13142081	13180276	OPTN	38195	0.421783
chr10	13203553	13253104	MCM10	49551	0.435894
chr10	13263766	13276328	UCMA	12562	0.489890
chr10	13319795	13342130	PHYH	22335	0.455339
chr10	13359437	13390298	SEPHS1	30861	0.457827
chr10	13480483	13544976	BEND7	64493	0.428326
chr10	13628938	13672868	PRPF18	43930	0.389461
chr10	13680942	13686169	AK055017	5227	0.430075
chr10	13685705	14372866	FRMD4A	687161	0.440694
chr10	14478574	14478660	MIR1265	86	0.395349
chr10	14560558	14816896	FAM107B	256338	0.431910
chr10	14861250	14879983	CDNF	18733	0.423264
chr10	14880158	14888998	HSPA14	8840	0.446154
chr10	14880158	14913740	HSPA14	33582	0.395569
chr10	14920781	14946304	SUV39H2	25523	0.400306
chr10	14948870	14996094	DCLRE1C	47224	0.430692
chr10	15001437	15014850	MEIG1	13413	0.426899
chr10	15057070	15130775	ACBD7	73705	0.440296
chr10	15085894	15115851	OLAH	29957	0.415662
chr10	15117473	15130775	ACBD7	13302	0.451887
chr10	15137383	15139318	C10orf111	1935	0.481654
chr10	15139178	15146256	RPP38	7078	0.488274
chr10	15147770	15210695	NMT2	62925	0.431307
chr10	15196720	15197346	PPIAP30	626	0.482428
chr10	15253643	15413058	FAM171A1	159415	0.449801
chr10	15559087	15761770	ITGA8	202683	0.399604
chr10	15820174	15902519	FAM188A	82345	0.358820
chr10	16478941	16555744	PTER	76803	0.408890
chr10	16518001	16518163	U2	162	0.388889
chr10	16555741	16564004	C1QL3	8263	0.448989
chr10	16632616	16859453	RSU1	226837	0.411388
chr10	16865964	17171816	CUBN	305852	0.394917
chr10	17184981	17244070	TRDMT1	59089	0.366092
chr10	17257194	17271983	BC078172	14789	0.442559
chr10	17270257	17279592	VIM	9335	0.462453
chr10	17362675	17496254	ST8SIA6	133579	0.408717
chr10	17428934	17452630	ST8SIA6-AS1	23696	0.432267
chr10	17631957	17659373	PTPLA	27416	0.421177
chr10	17686123	17758821	STAM	72698	0.371138
chr10	17794259	17842866	TMEM236	48607	0.407637
chr10	17851341	18200091	MRC1	348750	0.341941
chr10	17887106	17887193	MIR511-2	87	0.390805
chr10	18041226	18089854	TMEM236	48628	0.407440
chr10	18134035	18134122	MIR511-2	87	0.390805
chr10	18240767	18332221	SLC39A12	91454	0.391771
chr10	18290714	18299491	LOC100129213	8777	0.398769
chr10	18429605	18830688	CACNB2	401083	0.404674
chr10	18834263	18940550	NSUN6	106287	0.401686
chr10	18948312	18966940	ARL5B	18628	0.383992
chr10	18967048	18970568	AK022915	3520	0.313068
chr10	19248677	19248708	DQ600701	31	0.451613
chr10	19778022	19896829	C10orf112	118807	0.365534
chr10	19904783	20023405	AK297683	118622	0.374172
chr10	19999259	20017479	BC014575	18220	0.372283
chr10	20081926	20082030	U6	104	0.365385
chr10	20105371	20569115	PLXDC2	463744	0.373406
chr10	20840898	20840975	MIR4675	77	0.545455
chr10	21068902	21186531	NEBL	117629	0.371209
chr10	21414691	21435488	C10orf113	20797	0.392220
chr10	21462918	21463852	NEBL-AS1	934	0.705567
chr10	21783420	21786213	C10orf114	2793	0.647691
chr10	21785490	21785570	MIR1915	80	0.787500
chr10	21804024	21806751	SKIDA1	2727	0.570590
chr10	21803939	21805798	AK055656	1859	0.502959
chr10	21823573	22032559	MLLT10	208986	0.395912
chr10	22045476	22292650	DNAJC1	247174	0.377228
chr10	22222071	22222367	7SK	296	0.547297
chr10	22497742	22498912	EBLN1	1170	0.423077
chr10	22541000	22547477	LOC100130992	6477	0.403736
chr10	22605311	22620414	COMMD3-BMI1	15103	0.424022
chr10	22634373	22706539	SPAG6	72166	0.370382
chr10	22724353	22726858	LOC100499489	2505	0.584032
chr10	22823765	23003503	PIP4K2A	179738	0.418899
chr10	23216953	23326514	ARMC3	109561	0.386086
chr10	23384426	23410942	MSRB2	26516	0.430683
chr10	23455913	23456030	SNORA40	117	0.341880
chr10	23481459	23483181	PTF1A	1722	0.583043
chr10	23510445	23510574	U4	129	0.403101
chr10	23605519	23633772	C10orf67	28253	0.423212
chr10	23728197	23731310	OTUD1	3113	0.514616
chr10	24497719	24836772	KIAA1217	339053	0.424497
chr10	24564613	24564710	MIR603	97	0.371134
chr10	24736418	24736989	BC141952	571	0.464098
chr10	24872537	25012597	ARHGAP21	140060	0.389554
chr10	25137553	25241533	PRTFDC1	103980	0.418677
chr10	25197450	25197741	7SK	291	0.536082
chr10	25270907	25305085	ENKUR	34178	0.380830
chr10	25305507	25315593	THNSL1	10086	0.379139
chr10	25447000	25465205	GPR158-AS1	18205	0.411535
chr10	25464289	25891157	GPR158	426868	0.369388
chr10	25940640	26021864	AK123440	81224	0.410199
chr10	26108291	26108355	U6	64	0.468750
chr10	26223001	26501465	MYO3A	278464	0.376214
chr10	26505235	26590048	GAD2	84813	0.429309
chr10	26727265	26856732	APBB1IP	129467	0.415310
chr10	26878793	26883251	LINC00264	4458	0.435846
chr10	26932036	26942383	LINC00202-2	10347	0.457427
chr10	26986594	27035726	PDSS1	49132	0.441851
chr10	27035524	27150016	ABI1	114492	0.384394
chr10	27220134	27230930	LINC00202-1	10796	0.461282
chr10	27293044	27389427	ANKRD26	96383	0.376322
chr10	27399039	27443349	YME1L1	44310	0.380659
chr10	27443752	27475848	MASTL	32096	0.414912
chr10	27484142	27529808	ACBD5	45666	0.404612
chr10	27534781	27541235	LRRC37A6P	6454	0.485126
chr10	27547690	27577753	AK125237	30063	0.388251
chr10	27687116	27703297	PTCHD3	16181	0.387244
chr10	27793102	27831166	RAB18	38064	0.366541
chr10	27961802	28034778	MKX	72976	0.401255
chr10	28101096	28287977	ARMC4	186881	0.382398
chr10	28339922	28571067	MPP7	231145	0.381263
chr10	28808845	28821460	WAC-AS1	12615	0.424574
chr10	28808845	28821283	WAC-AS1	12438	0.420244
chr10	28822420	28912041	WAC	89621	0.373919
chr10	28835324	28835346	MIR5586	22	0.545455
chr10	28966423	28971868	BAMBI	5445	0.460973
chr10	29078239	29084979	LINC00837	6740	0.451929
chr10	29577989	29600158	LYZL1	22169	0.421895
chr10	29698500	29776785	PTCHD3P1	78285	0.429112
chr10	29743270	29744631	AX747507	1361	0.443057
chr10	29745064	29746228	AX747507	1164	0.413230
chr10	29746276	29923901	SVIL	177625	0.437438
chr10	29833932	29834026	MIR604	94	0.542553
chr10	29891192	29891275	MIR938	83	0.481928
chr10	30301728	30348488	KIAA1462	46760	0.457549
chr10	30598729	30638267	MTPAP	39538	0.397997
chr10	30653906	30653938	DQ589067	32	0.625000
chr10	30653996	30654016	JB175342	20	0.700000
chr10	30656840	30656874	DQ593032	34	0.588235
chr10	30722949	30750762	MAP3K8	27813	0.426168
chr10	30900707	30918647	LYZL2	17940	0.418673
chr10	30981202	31005942	AK302694	24740	0.453274
chr10	31133564	31320866	ZNF438	187302	0.386162
chr10	31605456	31607959	AK296146	2503	0.436276
chr10	31608100	31818742	ZEB1	210642	0.359430
chr10	31840033	31840054	JB175196	21	0.619048
chr10	32094325	32217804	ARHGAP12	123479	0.369375
chr10	32297937	32345371	KIF5B	47434	0.375870
chr10	32556643	32636146	EPC1	79503	0.387080
chr10	32735040	32863492	CCDC7	128452	0.375829
chr10	32856597	33171792	C10orf68	315195	0.371792
chr10	33189245	33247293	ITGB1	58048	0.383545
chr10	33466418	33623833	NRP1	157415	0.411066
chr10	34048640	34061608	LINC00838	12968	0.402838
chr10	34398487	35104253	PARD3	705766	0.400052
chr10	34398808	34399992	AX765719	1184	0.482264
chr10	35297478	35363258	CUL2	65780	0.389343
chr10	35416384	35501886	CREM	85502	0.389500
chr10	35625801	35860847	CCNY	235046	0.431367
chr10	35894337	35897863	GJD4	3526	0.516733
chr10	35927176	35930362	FZD8	3186	0.616133
chr10	36051232	36051252	FW312330	20	0.350000
chr10	37414784	37521495	ANKRD30A	106711	0.345250
chr10	37890365	37891859	MTRNR2L7	1494	0.380857
chr10	38117692	38147012	ZNF248	29320	0.388199
chr10	38082865	38084103	ZNF33BP1	1238	0.357027
chr10	38238794	38265453	ZNF25	26659	0.400840
chr10	38299577	38348995	ZNF33A	49418	0.384678
chr10	38383263	38412278	ZNF37A	29015	0.392521
chr10	38464598	38503273	LOC100129055	38675	0.383685
chr10	38645307	38654939	HSD17B7P2	9632	0.393376
chr10	38671997	38691780	SEPT7P9	19783	0.370571
chr10	38717073	38741081	LOC399744	24008	0.480590
chr10	38989726	38991371	ACTR3BP5	1645	0.401216
chr10	42827313	42863493	LOC441666	36180	0.372360
chr10	42903621	42967688	BC039000	64067	0.397100
chr10	42970938	42990785	LINC00839	19847	0.434474
chr10	43008960	43048256	ZNF37BP	39296	0.390625
chr10	43084554	43133992	ZNF33B	49438	0.380598
chr10	43169007	43187207	AK123067	18200	0.418516
chr10	43277953	43330385	BMS1	52432	0.407556
chr10	43493010	43493129	MIR5100	119	0.621849
chr10	43572516	43625797	RET	53281	0.557140
chr10	43633892	43680754	CSGALNACT2	46862	0.389207
chr10	43689983	43762367	RASGEF1A	72384	0.563619
chr10	43867091	43871783	FXYD4	4692	0.539855
chr10	43881064	43903299	HNRNPF	22235	0.466787
chr10	43882085	43883132	HNRPF	1047	0.543458
chr10	43932573	43978007	ZNF487P	45434	0.467491
chr10	44051792	44070066	ZNF239	18274	0.428149
chr10	44101854	44113352	ZNF485	11498	0.409115
chr10	44124264	44170147	ZNF32-AS3	45883	0.435085
chr10	44139306	44144326	ZNF32	5020	0.464940
chr10	44139319	44140495	ZNF32-AS1	1176	0.450680
chr10	44141389	44143467	ZNF32-AS2	2078	0.424928
chr10	44282859	44285865	HNRNPA3P1	3006	0.389554
chr10	44340753	44346070	LINC00619	5317	0.438593
chr10	44354858	44390881	LINC00840	36023	0.449046
chr10	44434450	44439914	LINC00841	5464	0.513543
chr10	44788197	44790097	LOC100130539	1900	0.580000
chr10	44872509	44880545	CXCL12	8036	0.518790
chr10	45306471	45455137	TMEM72-AS1	148666	0.467767
chr10	45406763	45430642	TMEM72	23879	0.513966
chr10	45455218	45490172	RASSF4	34954	0.532614
chr10	45471708	45474330	C10orf10	2622	0.559115
chr10	45493145	45496470	C10orf25	3325	0.457744
chr10	45496272	45500777	ZNF22	4505	0.413762
chr10	45497678	45567036	ZNF22	69358	0.387598
chr10	45594923	45650044	RSU1P2	55121	0.408683
chr10	45642841	45666837	ANKRD30BP3	23996	0.389398
chr10	45659461	45659536	MIR3156-1	75	0.426667
chr10	45798101	45811056	OR13A1	12955	0.384099
chr10	45869623	45941567	ALOX5	71944	0.477288
chr10	45950378	45952578	DL492557	2200	0.534545
chr10	45952816	46030819	MARCH8	78003	0.408484
chr10	46111038	46168251	ZFAND4	57213	0.380088
chr10	46194865	46194895	DQ577099	30	0.566667
chr10	46222647	46288412	FAM21C	65765	0.425257
chr10	46321049	46342921	AGAP4	21872	0.405541
chr10	46322146	46322176	DQ588224	30	0.566667
chr10	46550122	46620058	PTPN20B	69936	0.363504
chr10	46657759	46675703	FRMPD2	17944	0.464779
chr10	46737612	46762892	BMS1P1	25280	0.412302
chr10	46764667	46768346	GLUD1P7	3679	0.377548
chr10	46914586	46939145	FAM35BP	24559	0.380553
chr10	46957880	46970601	SYT15	12721	0.540052
chr10	46993545	47000568	GPRIN2	7023	0.576392
chr10	47083533	47088320	NPY4R	4787	0.523292
chr10	47096453	47151400	LINC00842	54947	0.435310
chr10	47133294	47133836	HNRNPA1P33	542	0.470480
chr10	47157983	47174143	ANXA8	16160	0.541275
chr10	47177221	47181688	FAM25C	4467	0.499888
chr10	47191843	47213626	AGAP9	21783	0.404811
chr10	47192841	47192871	DQ588224	30	0.566667
chr10	47225570	47243511	BMS1P6	17941	0.401092
chr10	47270680	47273431	AK309109	2751	0.499091
chr10	47396658	47421238	FAM35DP	24580	0.379943
chr10	47658233	47701017	AK057316	42784	0.508999
chr10	47729119	47729149	DQ577099	30	0.566667
chr10	47746919	47763040	ANXA8L2	16121	0.540351
chr10	47894022	47949417	FAM21B	55395	0.423017
chr10	48155942	48158691	CTSL1P2	2749	0.499454
chr10	48185838	48203780	BMS1P6	17942	0.401014
chr10	48215723	48237508	AGAP9	21785	0.404774
chr10	48236480	48236510	DQ577099	30	0.566667
chr10	48247661	48252125	FAM25C	4464	0.500224
chr10	48255203	48271368	ANXA8	16165	0.541169
chr10	48355088	48373866	ZNF488	18778	0.495899
chr10	48381486	48390991	RBP3	9505	0.550237
chr10	48413091	48416853	GDF2	3762	0.513822
chr10	48425787	48439138	GDF10	13351	0.529324
chr10	48737041	48806985	PTPN20B	69944	0.363219
chr10	48844035	48862688	FRMPD2P1	18653	0.464483
chr10	48901193	48906921	AGAP8	5728	0.441341
chr10	48902198	48902228	DQ588224	30	0.566667
chr10	48927373	48952629	BMS1P1	25256	0.411387
chr10	48954404	48958083	GLUD1P7	3679	0.377276
chr10	49203372	49207825	FAM25C	4453	0.501235
chr10	49218158	49239658	LOC399753	21500	0.405163
chr10	49218978	49219008	DQ588224	30	0.566667
chr10	49278238	49338996	AK309922	60758	0.365203
chr10	49364600	49482941	FRMPD2	118341	0.442205
chr10	49609654	49643183	MAPK8	33529	0.364371
chr10	49654067	49860561	ARHGAP22	206494	0.476600
chr10	49676049	49687239	BC043540	11190	0.484808
chr10	49717903	49719721	AX747901	1818	0.523652
chr10	49893517	50191001	WDFY4	297484	0.453503
chr10	50117528	50122280	LRRC18	4752	0.455177
chr10	50193556	50193632	MIR4294	76	0.631579
chr10	50222332	50323559	VSTM4	101227	0.448922
chr10	50329883	50359592	FAM170B-AS1	29709	0.443367
chr10	50339200	50342065	FAM170B	2865	0.498429
chr10	50363890	50396407	C10orf128	32517	0.473967
chr10	50507186	50535537	C10orf71	28351	0.499771
chr10	50574160	50604062	DRGX	29902	0.482677
chr10	50662525	50747169	ERCC6	84644	0.403478
chr10	50822082	50873150	CHAT	51068	0.496671
chr10	50818346	50820766	SLC18A3	2420	0.671901
chr10	50861611	50861631	JB022694	20	0.550000
chr10	50887683	50916956	C10orf53	29273	0.435487
chr10	50942686	50970425	OGDHL	27739	0.554562
chr10	51026324	51371331	PARG	345007	0.336573
chr10	51188370	51189564	BC039561	1194	0.419598
chr10	51224680	51246409	AGAP8	21729	0.404436
chr10	51225773	51225803	DQ588224	30	0.566667
chr10	51371394	51734610	TIMM23	363216	0.356022
chr10	51383525	51383726	SNORA74	201	0.512438
chr10	51464150	51486327	AGAP7	22177	0.408080
chr10	51465247	51465277	DQ588224	30	0.566667
chr10	51549552	51562518	MSMB	12966	0.450332
chr10	51565107	51590734	NCOA4	25627	0.412417
chr10	51592080	51623386	TIMM23	31306	0.401201
chr10	51611023	51611224	SNORA74	201	0.512438
chr10	51623416	51631894	PARG	8478	0.417080
chr10	51748077	51770259	AGAP6	22182	0.408079
chr10	51769132	51769162	DQ577099	30	0.566667
chr10	51780941	51827563	FLJ31813	46622	0.441530
chr10	51827683	51893269	FAM21A	65586	0.425746
chr10	51946999	52008370	ASAH2	61371	0.371674
chr10	52065344	52383737	SGMS1	318393	0.392653
chr10	52388909	52391396	AK022382	2487	0.455971
chr10	52499687	52514569	ASAH2B	14882	0.357143
chr10	52559168	52645435	A1CF	86267	0.362387
chr10	52724029	52724980	BC044765	951	0.402734
chr10	52834233	54058110	PRKG1	1223877	0.364335
chr10	53059332	53059415	MIR605	83	0.445783
chr10	53455245	53459355	CSTF2T	4110	0.433577
chr10	54056607	54073888	PRKG1-AS1	17281	0.376830
chr10	54074040	54077417	DKK1	3377	0.447439
chr10	54210636	54215032	BC015429	4396	0.379208
chr10	54525139	54531460	MBL2	6321	0.386331
chr10	55580859	56561051	PCDH15	980192	0.349116
chr10	57358749	57360487	MTRNR2L5	1738	0.406214
chr10	58117198	58121034	ZWINT	3836	0.493483
chr10	59064238	59064319	MIR3924	81	0.259259
chr10	59951277	60027694	IPMK	76417	0.386184
chr10	60028861	60049019	CISD1	20158	0.368886
chr10	60094738	60130513	UBE2D1	35775	0.360559
chr10	60144902	60158990	TFAM	14088	0.379401
chr10	60272903	60588845	BICC1	315942	0.379915
chr10	60474774	60477293	FAM133CP	2519	0.359667
chr10	60936347	61007534	PHYHIPL	71187	0.351848
chr10	61005888	61122352	FAM13C	116464	0.399643
chr10	61410521	61469649	SLC16A9	59128	0.397324
chr10	61496747	61513203	LINC00948	16456	0.415532
chr10	61548505	61666414	CCDC6	117909	0.409256
chr10	61715187	61720671	C10orf40	5484	0.366521
chr10	61786055	62149634	ANK3	363579	0.382214
chr10	62538211	62554610	CDK1	16399	0.348863
chr10	62629197	62704033	RHOBTB1	74836	0.398819
chr10	62672522	62672685	U2	163	0.398773
chr10	63166400	63213208	TMEM26	46808	0.359554
chr10	63212396	63253189	BC041470	40793	0.384159
chr10	63422718	63526091	C10orf107	103373	0.351688
chr10	63661012	63856707	ARID5B	195695	0.403230
chr10	63736060	63736088	MIR548AV	28	0.357143
chr10	63952952	64028466	RTKN2	75514	0.344850
chr10	64133915	64431771	ZNF365	297856	0.402607
chr10	64564515	64568239	ADO	3724	0.481740
chr10	64571755	64576126	EGR2	4371	0.552505
chr10	64893006	64914786	NRBF2	21780	0.422268
chr10	64926987	65225722	JMJD1C	298735	0.380833
chr10	65005259	65007599	AX747628	2340	0.373932
chr10	65132716	65132808	MIR1296	92	0.576087
chr10	65224988	65226322	JMJD1C-AS1	1334	0.639430
chr10	65281122	65384883	REEP3	103761	0.383420
chr10	66585284	66586634	ANXA2P3	1350	0.469630
chr10	66585343	66585369	DJ439558	26	0.500000
chr10	66586101	66586126	DJ439576	25	0.520000
chr10	66586203	66586227	DJ439561	24	0.416667
chr10	67679724	69455949	CTNNA3	1776225	0.361914
chr10	68254456	68254557	SnoU40	101	0.346535
chr10	68685791	68860867	LRRTM3	175076	0.357159
chr10	69524260	69524407	HI650153	147	0.469388
chr10	69556426	69597937	DNAJC12	41511	0.396377
chr10	69568259	69568366	U6	107	0.429907
chr10	69644426	69678147	SIRT1	33721	0.408677
chr10	69681655	69835103	HERC4	153448	0.379979
chr10	69865873	69971773	MYPN	105900	0.405911
chr10	69917835	69918165	7SK	330	0.490909
chr10	69990351	69991870	ATOH7	1519	0.538512
chr10	70042416	70092684	PBLD	50268	0.432542
chr10	70091767	70102953	HNRNPH3	11186	0.384945
chr10	70103274	70166946	RUFY2	63672	0.410447
chr10	70173820	70231730	DNA2	57910	0.421931
chr10	70242089	70287280	SLC25A16	45191	0.434843
chr10	70320116	70454239	TET1	134123	0.421591
chr10	70480970	70551309	CCAR1	70339	0.417663
chr10	70514928	70514995	SNORD98	67	0.388060
chr10	70587293	70652816	STOX1	65523	0.451933
chr10	70661033	70706603	DDX50	45570	0.403226
chr10	70715878	70744825	DDX21	28947	0.411753
chr10	70748476	70776739	KIAA1279	28263	0.406645
chr10	70847827	70864567	SRGN	16740	0.424791
chr10	70883907	70932616	VPS26A	48709	0.393808
chr10	70939992	70968849	SUPV3L1	28857	0.417958
chr10	70980058	71027315	HKDC1	47257	0.479590
chr10	71029755	71161637	HK1	131882	0.476433
chr10	71163957	71176674	TACR2	12717	0.522922
chr10	71211225	71267423	TSPAN15	56198	0.514431
chr10	71331790	71333210	NEUROG3	1420	0.652817
chr10	71390002	71393355	C10orf35	3353	0.561587
chr10	71561643	71718904	COL13A1	157261	0.519251
chr10	71812356	71872040	H2AFY2	59684	0.458381
chr10	71872022	71892690	AIFM2	20668	0.511370
chr10	71897736	71906496	TYSND1	8760	0.532991
chr10	71909960	71930285	SAR1A	20325	0.399213
chr10	71962585	71993190	PPA1	30605	0.394609
chr10	72014712	72043450	NPFFR1	28738	0.469796
chr10	72058725	72142406	LRRC20	83681	0.494115
chr10	72163860	72188374	EIF4EBP2	24514	0.440116
chr10	72191691	72201465	NODAL	9774	0.520769
chr10	72238563	72328206	PALD1	89643	0.522037
chr10	72357103	72362531	PRF1	5428	0.565217
chr10	72432558	72522195	ADAMTS14	89637	0.528744
chr10	72530994	72545157	TBATA	14163	0.539151
chr10	72575703	72640932	SGPL1	65229	0.410768
chr10	72643266	72648541	PCBD1	5275	0.533081
chr10	72972291	73062635	UNC5B	90344	0.543777
chr10	72976980	72977985	UNC5B-AS1	1005	0.612935
chr10	73079009	73123147	SLC29A3	44138	0.518555
chr10	73156690	73575704	CDH23	419014	0.523002
chr10	73471457	73479578	C10orf105	8121	0.559660
chr10	73507313	73533337	C10orf54	26024	0.539233
chr10	73576054	73611082	PSAP	35028	0.476847
chr10	73724119	73773322	CHST3	49203	0.513891
chr10	73818791	73848531	SPOCK2	29740	0.559583
chr10	73821847	73822403	BC127952	556	0.559353
chr10	73855789	73976199	ASCC1	120410	0.413064
chr10	73975757	73995618	ANAPC16	19861	0.434570
chr10	74033676	74035797	DDIT4	2121	0.586516
chr10	74034139	74034165	JA700173	26	0.576923
chr10	74034533	74034554	JA700174	21	0.571429
chr10	74034884	74034905	JA700157	21	0.476190
chr10	74035073	74035094	JA700158	21	0.523810
chr10	74035095	74035116	JA700151	21	0.476190
chr10	74035137	74035158	JA700163	21	0.523810
chr10	74035201	74035226	JA700167	25	0.440000
chr10	74035366	74035387	JA700164	21	0.428571
chr10	74035399	74035423	JA700154	24	0.375000
chr10	74035448	74035469	JA700170	21	0.428571
chr10	74035487	74035508	JA700172	21	0.380952
chr10	74035526	74035553	JA700165	27	0.370370
chr10	74035668	74035696	JA700183	28	0.428571
chr10	74035718	74035753	JA700161	35	0.314286
chr10	74092587	74114907	DNAJB12	22320	0.530063
chr10	74119697	74336541	MIR1256	216844	0.402215
chr10	74127083	74385949	MICU1	258866	0.401671
chr10	74451888	74647452	MCU	195564	0.388006
chr10	74480786	74480858	MIR4676	72	0.444444
chr10	74653338	74692787	OIT3	39449	0.417628
chr10	74694937	74714510	PLA2G12B	19573	0.418791
chr10	74766979	74856732	P4HA1	89753	0.387898
chr10	74870209	74891581	NUDT13	21372	0.412034
chr10	74884658	74885290	BC069792	632	0.460443
chr10	74885837	74885965	SNORA11	128	0.507812
chr10	74894281	74927853	ECD	33572	0.390534
chr10	74927876	75001939	FAM149B1	74063	0.399133
chr10	74993865	75001939	FAM149B1	8074	0.414540
chr10	75002581	75007262	DNAJC9	4681	0.443281
chr10	75007124	75036742	DNAJC9-AS1	29618	0.411979
chr10	75008600	75012451	MRPS16	3851	0.474682
chr10	75012548	75014101	BC033983	1553	0.424340
chr10	75013515	75118617	TTC18	105102	0.398632
chr10	75135188	75173841	ANXA7	38653	0.408481
chr10	75183336	75193319	MSS51	9983	0.421416
chr10	75196562	75255782	PPP3CB	59220	0.389598
chr10	75255281	75256029	BC080555	748	0.656417
chr10	75257295	75335433	USP54	78138	0.420167
chr10	75288808	75288915	U6	107	0.364486
chr10	75391369	75401515	MYOZ1	10146	0.480879
chr10	75404643	75415832	SYNPO2L	11189	0.524891
chr10	75434032	75457554	AGAP5	23522	0.419182
chr10	75491298	75495367	GLUD1P3	4069	0.598919
chr10	75504130	75531933	SEC24C	27803	0.470309
chr10	75532048	75535976	FUT11	3928	0.509420
chr10	75541807	75543406	CHCHD1	1599	0.454034
chr10	75545334	75546950	KIAA0913	1616	0.584158
chr10	75545381	75561556	ZSWIM8	16175	0.544111
chr10	75547342	75547998	AX747098	656	0.452744
chr10	75561668	75571589	NDST2	9921	0.531196
chr10	75572258	75634349	CAMK2G	62091	0.516468
chr10	75669726	75682535	C10orf55	12809	0.516122
chr10	75670861	75677258	PLAU	6397	0.543536
chr10	75757871	75879914	VCL	122043	0.412756
chr10	75880014	75910826	AP3M1	30812	0.412534
chr10	75910942	76469061	ADK	558119	0.374227
chr10	76045372	76047223	BC045784	1851	0.421934
chr10	76586170	76792380	KAT6B	206210	0.404864
chr10	76797593	76818272	DUPD1	20679	0.476425
chr10	76854189	76868970	DUSP13	14781	0.548677
chr10	76871392	76941881	SAMD8	70489	0.411483
chr10	76969911	76991207	VDAC2	21296	0.440364
chr10	76993728	76995770	COMTD1	2042	0.705681
chr10	77056140	77121436	ZNF503-AS1	65296	0.426014
chr10	77157602	77161513	ZNF503	3911	0.612120
chr10	77161285	77168740	ZNF503-AS2	7455	0.596512
chr10	77163513	77168740	ZNF503-AS2	5227	0.582361
chr10	77542518	78317126	C10orf11	774608	0.407964
chr10	78644634	79397577	KCNMA1	752943	0.439622
chr10	78647801	78663848	BC030624	16047	0.378887
chr10	79317423	79320001	AX748385	2578	0.480605
chr10	79374158	79374179	JB149426	21	0.476190
chr10	79525156	79525186	DQ597779	30	0.466667
chr10	79525269	79525311	DQ592502	42	0.476190
chr10	79525457	79525498	DQ579128	41	0.390244
chr10	79525647	79525683	DQ583633	36	0.500000
chr10	79526256	79526294	DQ592298	38	0.500000
chr10	79526649	79526682	DQ590885	33	0.424242
chr10	79526706	79526760	DQ596761	54	0.462963
chr10	79526804	79526838	DQ590620	34	0.529412
chr10	79526970	79527009	DQ598931	39	0.358974
chr10	79527034	79527064	DQ591313	30	0.466667
chr10	79527665	79527727	DQ577698	62	0.403226
chr10	79527791	79527820	DQ600644	29	0.310345
chr10	79527872	79527916	DQ592472	44	0.454545
chr10	79527958	79528032	DQ586106	74	0.500000
chr10	79528151	79528204	DQ583233	53	0.433962
chr10	79529654	79529693	DQ582272	39	0.435897
chr10	79529974	79530013	DQ597620	39	0.564103
chr10	79530237	79530269	DQ579258	32	0.468750
chr10	79530290	79530320	DQ580247	30	0.566667
chr10	79530347	79530380	DQ596518	33	0.606061
chr10	79530385	79530417	DQ577458	32	0.593750
chr10	79530484	79530534	DQ596791	50	0.540000
chr10	79530542	79530583	DQ580728	41	0.536585
chr10	79533523	79533557	DQ582813	34	0.500000
chr10	79533658	79533698	DQ581582	40	0.550000
chr10	79534365	79534400	DQ577219	35	0.514286
chr10	79534531	79534570	DQ577365	39	0.461538
chr10	79534697	79534740	DQ573199	43	0.511628
chr10	79537922	79537973	DQ601889	51	0.431373
chr10	79538926	79538956	DQ590525	30	0.500000
chr10	79539400	79539440	DQ583130	40	0.450000
chr10	79539478	79539523	DQ579700	45	0.600000
chr10	79539621	79539656	DQ596633	35	0.600000
chr10	79539807	79539838	DQ597117	31	0.580645
chr10	79539989	79540022	DQ573683	33	0.484848
chr10	79540116	79540164	DQ586243	48	0.583333
chr10	79540163	79540193	DQ582762	30	0.466667
chr10	79540182	79540213	DQ570642	31	0.516129
chr10	79540227	79540306	DQ596613	79	0.582278
chr10	79540330	79540366	DQ585850	36	0.583333
chr10	79540541	79540571	DQ576802	30	0.533333
chr10	79540609	79540659	DQ589398	50	0.580000
chr10	79540676	79540714	DQ574810	38	0.631579
chr10	79540764	79540827	DQ581179	63	0.476190
chr10	79540775	79540807	DQ575045	32	0.531250
chr10	79540838	79540868	DQ580595	30	0.600000
chr10	79540919	79540967	DQ594771	48	0.562500
chr10	79540985	79541016	DQ593302	31	0.548387
chr10	79541029	79541072	DQ570592	43	0.465116
chr10	79541041	79541081	DQ594020	40	0.525000
chr10	79541092	79541123	DQ570533	31	0.548387
chr10	79541134	79541163	DQ593224	29	0.551724
chr10	79541182	79541208	DQ584676	26	0.653846
chr10	79541500	79541568	DQ586086	68	0.485294
chr10	79541795	79541824	DQ576634	29	0.517241
chr10	79550548	79686348	DLG5	135800	0.500250
chr10	79553148	79553185	DQ591438	37	0.513514
chr10	79626632	79629368	AK125684	2736	0.510965
chr10	79686569	79689583	DLG5-AS1	3014	0.537160
chr10	79734906	79789298	POLR3A	54392	0.445874
chr10	79793517	79816571	RPS24	23054	0.474321
chr10	80008381	80012402	LINC00856	4021	0.493658
chr10	80027084	80159502	LINC00595	132418	0.476718
chr10	80127263	80127380	SNORA71	117	0.478632
chr10	80777213	80828536	ZMIZ1-AS1	51323	0.514019
chr10	80760240	80763560	AX747983	3320	0.528313
chr10	80828791	81076285	ZMIZ1	247494	0.553169
chr10	80928942	80930381	BC128552	1439	0.528145
chr10	81107219	81115089	PPIF	7870	0.556417
chr10	81142082	81203928	ZCCHC24	61846	0.531093
chr10	81142082	81205383	ZCCHC24	63301	0.534447
chr10	81266125	81270678	AK302451	4553	0.500769
chr10	81272356	81276192	EIF5AL1	3836	0.456465
chr10	81315607	81320163	SFTPA2	4556	0.546752
chr10	81370694	81375199	SFTPA1	4505	0.544284
chr10	81442730	81448650	BEND3P3	5920	0.508108
chr10	81522330	81524958	AX747158	2628	0.352740
chr10	81526044	81526071	DQ586890	27	0.555556
chr10	81585657	81587358	LOC642361	1701	0.637272
chr10	81679933	81682875	MBL1P	2942	0.515976
chr10	81697495	81708861	SFTPD	11366	0.521731
chr10	81805988	81838949	TMEM254-AS1	32961	0.428749
chr10	81838778	81852307	TMEM254	13529	0.422869
chr10	81892257	81904784	PLAC9	12527	0.504989
chr10	81914879	81965328	ANXA11	50449	0.504371
chr10	81967465	81979413	LINC00857	11948	0.435052
chr10	82031575	82049434	MAT1A	17859	0.502772
chr10	82095860	82116514	DYDC1	20654	0.403699
chr10	82104500	82127829	DYDC2	23329	0.431180
chr10	82173574	82192753	FAM213A	19179	0.464153
chr10	82214037	82282391	TSPAN14	68354	0.493373
chr10	82297657	82406316	SH2D4B	108659	0.449986
chr10	82904457	82904477	hsa-miR-3198-3p	20	0.600000
chr10	83635069	84746935	NRG3	1111866	0.375045
chr10	84100526	84100632	U6	106	0.405660
chr10	85524113	85524220	U6	107	0.336449
chr10	85899184	85913311	GHITM	14127	0.378424
chr10	85926983	85931832	BC051760	4849	0.406269
chr10	85933553	85945050	C10orf99	11497	0.483517
chr10	85954411	85977121	CDHR1	22710	0.519243
chr10	85980248	85985284	LRIT2	5036	0.455123
chr10	85991275	86001217	LRIT1	9942	0.498491
chr10	86004808	86018944	RGR	14136	0.496251
chr10	86039735	86054415	LINC00858	14680	0.417030
chr10	86088409	86278276	CCSER2	189867	0.375400
chr10	86150917	86150937	DD413707	20	0.550000
chr10	86953176	86958694	AK097624	5518	0.417361
chr10	87337487	87366972	GRID1-AS1	29485	0.420180
chr10	87359311	88126250	GRID1	766939	0.450362
chr10	87403829	87407823	AX746544	3994	0.474462
chr10	87409768	87410017	7SK	249	0.506024
chr10	88024450	88024545	MIR346	95	0.673684
chr10	88195012	88281541	WAPAL	86529	0.398595
chr10	88414313	88426216	OPN4	11903	0.586911
chr10	88428425	88495824	LDB3	67399	0.529756
chr10	88492148	88495009	AX747977	2861	0.458581
chr10	88516395	88684945	BMPR1A	168550	0.398843
chr10	88695297	88717425	MMRN2	22128	0.527748
chr10	88718287	88723017	SNCG	4730	0.614588
chr10	88726913	88730571	AL157440	3658	0.608803
chr10	88728187	88730666	ADIRF	2479	0.615167
chr10	88730497	88769960	AGAP11	39463	0.419507
chr10	88780045	88784487	FAM25A	4442	0.498874
chr10	88809958	88854776	GLUD1	44818	0.421594
chr10	88854952	88951222	FAM35A	96270	0.400862
chr10	89003888	89102315	NUTM2A-AS1	98427	0.380993
chr10	88985204	88994733	NUTM2A	9529	0.583062
chr10	89102167	89103331	LOC439994	1164	0.599656
chr10	89114946	89117058	BC082979	2112	0.485322
chr10	89117476	89126950	NUTM2D	9474	0.582647
chr10	89156330	89167457	LINC00864	11127	0.405141
chr10	89263637	89263711	MIR4678	74	0.324324
chr10	89264222	89313218	MINPP1	48996	0.382439
chr10	89419475	89507462	PAPSS2	87987	0.403605
chr10	89512874	89577917	ATAD1	65043	0.354535
chr10	89578069	89605369	CFL1P1	27300	0.384689
chr10	89618917	89623194	KLLN	4277	0.491466
chr10	89623194	89728532	PTEN	105338	0.358342
chr10	89706924	89708694	AK130076	1770	0.401130
chr10	90043858	90343082	RNLS	299224	0.367377
chr10	90346518	90366733	LIPJ	20215	0.329359
chr10	90424145	90438572	LIPF	14427	0.363624
chr10	90484300	90512513	LIPK	28213	0.392656
chr10	90521162	90537999	LIPN	16837	0.358080
chr10	90562486	90580303	LIPM	17817	0.393669
chr10	90579658	90611732	ANKRD22	32074	0.378967
chr10	90639943	90683259	STAMBPL1	43316	0.381499
chr10	90692440	90699731	AX748062	7291	0.434645
chr10	90694830	90712580	ACTA2	17750	0.418366
chr10	90750287	90775542	FAS	25255	0.378974
chr10	90751180	90752732	FAS-AS1	1552	0.397552
chr10	90762787	90762816	HV303528	29	0.413793
chr10	90762864	90762934	HV303525	70	0.471429
chr10	90823091	90823168	MIR4679-2	77	0.298701
chr10	90823092	90823167	MIR4679-1	75	0.293333
chr10	90965693	90967071	CH25H	1378	0.494920
chr10	90973325	91011660	LIPA	38335	0.405165
chr10	91037420	91102431	BC040833	65011	0.414638
chr10	91061705	91069033	IFIT2	7328	0.400246
chr10	91092238	91100725	IFIT3	8487	0.425946
chr10	91137812	91144962	IFIT1B	7150	0.432727
chr10	91152302	91166244	IFIT1	13942	0.385526
chr10	91174324	91180759	IFIT5	6435	0.414918
chr10	91190050	91295313	SLC16A12	105263	0.398079
chr10	91339253	91405329	PANK1	66076	0.399116
chr10	91352503	91352584	MIR107	81	0.469136
chr10	91352514	91352535	JB022994	21	0.476190
chr10	91451056	91457685	FLJ37201	6629	0.353900
chr10	91461366	91534700	KIF20B	73334	0.351501
chr10	91492812	91493018	KRMP1	206	0.344660
chr10	91589249	91600618	LINC00865	11369	0.421057
chr10	91675245	91717130	AK093219	41885	0.396156
chr10	92213925	92261194	BC037970	47269	0.367979
chr10	92500575	92617671	HTR7	117096	0.406829
chr10	92631473	92668312	RPP30	36839	0.379272
chr10	92671856	92681032	ANKRD1	9176	0.399085
chr10	92682487	92682592	U6	105	0.342857
chr10	92805564	92821916	LINC00502	16352	0.399523
chr10	92911760	92912837	NUDT9P1	1077	0.392758
chr10	92922768	93044088	PCGF5	121320	0.381289
chr10	93066718	93371217	LOC100188947	304499	0.397965
chr10	93170095	93274520	HECTD2	104425	0.364309
chr10	93388196	93392858	PPP1R3C	4662	0.407121
chr10	93558150	93625232	TNKS2	67082	0.375615
chr10	93666344	93669258	FGFBP3	2914	0.523679
chr10	93683735	93790080	BTAF1	106345	0.373050
chr10	93808396	94050875	CPEB3	242479	0.408794
chr10	93835998	93836122	SNORA25	124	0.419355
chr10	94050919	94113721	MARCH5	62802	0.404446
chr10	94178242	94180347	AK124121	2105	0.521140
chr10	94178417	94179363	MARK2P9	946	0.498943
chr10	94211440	94333852	IDE	122412	0.407150
chr10	94352824	94415152	KIF11	62328	0.392633
chr10	94449680	94455408	HHEX	5728	0.464909
chr10	94608224	94819251	EXOC6	211027	0.369844
chr10	94821020	94828454	CYP26C1	7434	0.584342
chr10	94833646	94837641	CYP26A1	3995	0.516896
chr10	95066185	95242074	MYOF	175889	0.443638
chr10	95256368	95288849	CEP55	32481	0.406946
chr10	95326421	95349829	FFAR4	23408	0.477358
chr10	95351592	95360993	RBP4	9401	0.483672
chr10	95372344	95425429	PDE6C	53085	0.411661
chr10	95427639	95462329	FRA10AC1	34690	0.348198
chr10	95517565	95557916	LGI1	40351	0.407474
chr10	95653729	95662491	SLC35G1	8762	0.410523
chr10	95717896	95721672	PIPSL	3776	0.492320
chr10	95753745	96088148	PLCE1	334403	0.411515
chr10	95859405	95868542	BC035380	9137	0.433074
chr10	96039046	96046827	PLCE1-AS1	7781	0.384398
chr10	96092988	96122683	NOC3L	29695	0.369894
chr10	96162185	96296089	TBC1D12	133904	0.385470
chr10	96305573	96361856	HELLS	56283	0.387222
chr10	96522462	96612671	CYP2C19	90209	0.395238
chr10	96698414	96749148	CYP2C9	50734	0.377833
chr10	96796528	96829254	CYP2C8	32726	0.375940
chr10	96953956	96988686	C10orf129	34730	0.397783
chr10	96986468	96990901	BC043227	4433	0.438980
chr10	96997324	97050905	PDLIM1	53581	0.438458
chr10	97071529	97200937	SORBS1	129408	0.445660
chr10	97365685	97416567	ALDH18A1	50882	0.432019
chr10	97423152	97453900	TCTN3	30748	0.395408
chr10	97515408	97637023	ENTPD1	121615	0.409818
chr10	97512962	97849992	ENTPD1-AS1	337030	0.394567
chr10	97667721	97698415	C10orf131	30694	0.387144
chr10	97678694	97849992	ENTPD1-AS1	171298	0.386490
chr10	97759847	97792441	CC2D2B	32594	0.383353
chr10	97803158	97820625	CCNJ	17467	0.397435
chr10	97824071	97824156	MIR3157	85	0.564706
chr10	97889471	97923517	ZNF518A	34046	0.379487
chr10	97951454	98031333	BLNK	79879	0.427396
chr10	98064084	98098321	DNTT	34237	0.426147
chr10	98102974	98119092	OPALIN	16118	0.416243
chr10	98124362	98273683	TLL2	149321	0.464335
chr10	98277866	98346809	TM9SF3	68943	0.368391
chr10	98353068	98480279	PIK3AP1	127211	0.443594
chr10	98741040	98745585	C10orf12	4545	0.456766
chr10	98757794	98945683	SLIT1	187889	0.504463
chr10	98862512	98863504	LOC100505540	992	0.506048
chr10	98981929	99052430	ARHGAP19	70501	0.427739
chr10	99079021	99081672	FRAT1	2651	0.622784
chr10	99092253	99094458	FRAT2	2205	0.601814
chr10	99116457	99161127	RRP12	44670	0.516051
chr10	99178540	99185802	LOC644215	7262	0.496007
chr10	99186026	99193198	PGAM1	7172	0.471417
chr10	99195665	99205768	EXOSC1	10103	0.462041
chr10	99205929	99217127	ZDHHC16	11198	0.497678
chr10	99218080	99258366	MMS19	40286	0.447773
chr10	99258767	99330960	UBTD1	72193	0.494549
chr10	99332255	99343641	ANKRD2	11386	0.523625
chr10	99400442	99436187	PI4K2A	35745	0.447419
chr10	99349449	99350691	C10orf62	1242	0.564412
chr10	99354974	99354995	MIR5692C2	21	0.333333
chr10	99374309	99393913	MORN4	19604	0.467354
chr10	99378561	99382516	AX746617	3955	0.461947
chr10	99437180	99447015	AVPI1	9835	0.489375
chr10	99473464	99477909	MARVELD1	4445	0.564229
chr10	99496877	99520664	ZFYVE27	23787	0.485349
chr10	99526507	99531756	SFRP5	5249	0.579158
chr10	99609994	99631335	GOLGA7B	21341	0.487419
chr10	99624756	99790585	CRTAC1	165829	0.481478
chr10	99836117	99836178	KCNQ1DN	61	0.278689
chr10	99894380	100004654	R3HCC1L	110274	0.378348
chr10	100007442	100028007	LOXL4	20565	0.532653
chr10	100143321	100174978	PYROXD2	31657	0.504091
chr10	100175954	100206704	HPS1	30750	0.497236
chr10	100191048	100191117	MIR4685	69	0.594203
chr10	100216833	100995632	HPSE2	778799	0.384221
chr10	101088855	101154087	CNNM1	65232	0.444812
chr10	101156626	101190530	GOT1	33904	0.429979
chr10	101262421	101262464	U7	43	0.372093
chr10	101286106	101290907	DQ372722	4801	0.510310
chr10	101286704	101288224	chromosome 10 open reading frame 139	1520	0.567763
chr10	101292689	101296280	NKX2-3	3591	0.594263
chr10	101370274	101380221	SLC25A28	9947	0.448376
chr10	101419262	101471002	ENTPD7	51740	0.397642
chr10	101468504	101492423	COX15	23919	0.423053
chr10	101491957	101515894	CUTC	23937	0.381293
chr10	101542462	101611662	ABCC2	69200	0.451792
chr10	101635333	101769676	DNMBP	134343	0.437023
chr10	101686965	101718755	DNMBP-AS1	31790	0.429789
chr10	101802064	101841642	CPN1	39578	0.438779
chr10	101909846	101945814	ERLIN1	35968	0.381812
chr10	101948123	101989344	CHUK	41221	0.383931
chr10	101992054	102027437	CWF19L1	35383	0.425685
chr10	101996912	101997059	SNORA12	147	0.421769
chr10	102018327	102018434	U6	107	0.383178
chr10	102033034	102046469	BLOC1S2	13435	0.473688
chr10	102047902	102090243	PKD2L1	42341	0.450367
chr10	102106771	102124588	SCD	17817	0.471291
chr10	102133332	102148116	LINC00263	14784	0.457386
chr10	102222811	102243399	WNT8B	20588	0.427191
chr10	102246402	102279595	SEC31B	33193	0.462537
chr10	102283496	102289636	NDUFB8	6140	0.474756
chr10	102295640	102313681	HIF1AN	18041	0.460174
chr10	102505467	102589698	PAX2	84231	0.503295
chr10	102568914	102568935	JB136480	21	0.476190
chr10	102672325	102719347	FAM178A	47022	0.394135
chr10	102732285	102745373	SEMA4G	13088	0.522845
chr10	102734741	102734841	MIR608	100	0.570000
chr10	102741133	102747272	MRPL43	6139	0.535266
chr10	102747292	102754158	C10orf2	6866	0.519953
chr10	102756863	102767593	LZTS2	10730	0.603076
chr10	102767439	102790914	PDZD7	23475	0.551310
chr10	102790995	102800998	SFXN3	10003	0.540438
chr10	102820998	102825351	KAZALD1	4353	0.596370
chr10	102826055	102827891	FKSG40	1836	0.616558
chr10	102849077	102890903	TLX1NB	41826	0.511141
chr10	102891060	102897546	TLX1	6486	0.611008
chr10	102986732	102988717	LBX1	1985	0.655919
chr10	102989350	102998616	FLJ41350	9266	0.551694
chr10	103012577	103023307	AX747408	10730	0.493290
chr10	103113789	103317078	BTRC	203289	0.389632
chr10	103348088	103369410	DPCD	21322	0.467123
chr10	103338638	103348027	POLL	9389	0.529556
chr10	103361173	103361254	MIR3158-2	81	0.567901
chr10	103361173	103361254	MIR3158-1	81	0.567901
chr10	103370420	103454743	FBXW4	84323	0.456839
chr10	103529886	103535759	FGF8	5873	0.581475
chr10	103541081	103543170	NPM3	2089	0.574438
chr10	103544199	103578222	MGEA5	34023	0.419158
chr10	103578824	103588646	LOC100289509	9822	0.495215
chr10	103585730	103603677	KCNIP2	17947	0.553964
chr10	103605355	103815932	C10orf76	210577	0.423441
chr10	103825123	103827795	HPS6	2672	0.642216
chr10	103867324	103880210	LDB1	12886	0.556263
chr10	103892786	103910090	PPRC1	17304	0.519591
chr10	103911932	103923627	NOLC1	11695	0.472253
chr10	103986142	103989344	ELOVL3	3202	0.521237
chr10	103989945	104001231	PITX3	11286	0.546252
chr10	104005254	104142656	GBF1	137402	0.436173
chr10	104154336	104162286	NFKB2	7950	0.608302
chr10	104162373	104179691	PSD	17318	0.596605
chr10	104179570	104182893	FBXL15	3323	0.617815
chr10	104183001	104192423	CUEDC2	9422	0.529187
chr10	104196268	104196341	MIR146B	73	0.561644
chr10	104209573	104216050	LOC100505761	6477	0.534970
chr10	104209593	104211300	C10orf95	1707	0.676040
chr10	104213596	104216049	AX746750	2453	0.471667
chr10	104221169	104236802	TMEM180	15633	0.534318
chr10	104238985	104262512	ACTR1A	23527	0.488885
chr10	104263718	104393214	SUFU	129496	0.479737
chr10	104404251	104418076	TRIM8	13825	0.574033
chr10	104433483	104474190	ARL3	40707	0.445869
chr10	104474297	104498946	SFXN2	24649	0.490284
chr10	104503726	104576021	WBP1L	72295	0.467252
chr10	104590287	104597290	CYP17A1	7003	0.524775
chr10	104629209	104661655	AS3MT	32446	0.437527
chr10	104613966	104624718	C10orf32	10752	0.416946
chr10	104678074	104838344	CNNM2	160270	0.424471
chr10	104847773	104953063	NT5C2	105290	0.400874
chr10	104958488	105036751	BC040734	78263	0.452040
chr10	105005643	105007773	LOC729020	2130	0.395775
chr10	105036919	105050108	INA	13189	0.458791
chr10	105062552	105110891	PCGF6	48339	0.438942
chr10	105127723	105148822	TAF5	21099	0.433622
chr10	105148808	105156270	USMG5	7462	0.434334
chr10	105156411	105206019	PDCD11	49608	0.468090
chr10	105206542	105212162	CALHM2	5620	0.556762
chr10	105213143	105218648	CALHM1	5505	0.565668
chr10	105232560	105238997	CALHM3	6437	0.520584
chr10	105253734	105352309	NEURL	98575	0.504601
chr10	105353783	105615164	SH3PXD2A	261381	0.515653
chr10	105506536	105515167	SH3PXD2A-AS1	8631	0.480014
chr10	105637317	105678045	OBFC1	40728	0.427372
chr10	105727469	105787342	SLK	59873	0.361499
chr10	105791045	105845638	COL17A1	54593	0.483249
chr10	105807846	105807944	MIR936	98	0.540816
chr10	105881928	105886143	SFR1	4215	0.372242
chr10	105889645	105992120	WDR96	102475	0.392867
chr10	105978546	105978641	MIR609	95	0.484211
chr10	106014467	106027222	GSTO1	12755	0.402430
chr10	106028093	106028163	MIR4482-1	70	0.485714
chr10	106028630	106059176	GSTO2	30546	0.430400
chr10	106061961	106064704	AK094859	2743	0.441487
chr10	106069453	106088750	ITPRIP	19297	0.531793
chr10	106113521	106214848	CCDC147	101327	0.398956
chr10	106400858	107024993	SORCS3	624135	0.409387
chr10	106424365	106425958	BC042079	1593	0.461394
chr10	107899923	107923512	BC036309	23589	0.354614
chr10	108333420	108924466	SORCS1	591046	0.401243
chr10	110700726	110701068	7SK	342	0.459064
chr10	110999457	110999490	RNU6-53P	33	0.424242
chr10	111624523	111683311	XPNPEP1	58788	0.446196
chr10	111705316	111768139	LOC100505933	62823	0.415596
chr10	111767710	111895323	ADD3	127613	0.383049
chr10	111967362	112047123	MXI1	79761	0.401286
chr10	112052797	112064707	SMNDC1	11910	0.375819
chr10	112257624	112271302	DUSP5	13678	0.490569
chr10	112327448	112364392	SMC3	36944	0.368585
chr10	112404154	112599227	RBM20	195073	0.439328
chr10	112516213	112516481	7SK	268	0.481343
chr10	112628647	112630662	PDCD4-AS1	2015	0.464516
chr10	112631552	112659764	PDCD4	28212	0.346909
chr10	112658487	112678694	BBIP1	20207	0.384471
chr10	112679300	112773425	SHOC2	94125	0.350799
chr10	112696360	112697013	RPL13AP6	653	0.554364
chr10	112836789	112840662	ADRA2A	3873	0.597470
chr10	113909621	113943537	GPAM	33916	0.381000
chr10	114043492	114063070	TECTB	19578	0.443150
chr10	114067935	114116353	GUCY2GP	48418	0.453778
chr10	114135955	114188138	ACSL5	52183	0.426576
chr10	114190057	114206672	ZDHHC6	16615	0.377310
chr10	114206755	114578504	VTI1A	371749	0.391000
chr10	114393928	114394013	MIR4295	85	0.458824
chr10	114583254	114587484	AL050000	4230	0.495508
chr10	114613476	114615123	BC112004	1647	0.507590
chr10	114710008	114927436	TCF7L2	217428	0.446005
chr10	115312777	115349360	HABP2	36583	0.468961
chr10	115312777	115338557	HABP2	25780	0.467300
chr10	115348582	115423829	NRAP	75247	0.435499
chr10	115439427	115490668	CASP7	51241	0.427802
chr10	115524577	115537489	PLEKHS1	12912	0.402726
chr10	115537751	115537813	MIR4483	62	0.322581
chr10	115594482	115614163	DCLRE1A	19681	0.367817
chr10	115614390	115672265	NHLRC2	57875	0.353417
chr10	115803805	115806667	ADRB1	2862	0.575122
chr10	115881973	115934364	C10orf118	52391	0.373442
chr10	115939028	115992063	TDRD1	53035	0.390591
chr10	115999012	116054259	VWA2	55247	0.482397
chr10	116054582	116164515	AFAP1L2	109933	0.482621
chr10	116190868	116418058	ABLIM1	227190	0.427074
chr10	116524546	116538327	AK098198	13781	0.423046
chr10	116581502	116624474	FAM160B1	42972	0.380899
chr10	116697951	116737439	TRUB1	39488	0.368846
chr10	116729218	116729327	U6	109	0.376147
chr10	116853123	117708496	ATRNL1	855373	0.354051
chr10	117816441	118033126	GFRA1	216685	0.440206
chr10	118083939	118139541	CCDC172	55602	0.344304
chr10	118187423	118237468	PNLIPRP3	50045	0.385573
chr10	118261313	118261387	JA611286	74	0.527027
chr10	118305427	118327367	PNLIP	21940	0.391386
chr10	118350489	118368686	PNLIPRP1	18197	0.449085
chr10	118380464	118404654	PNLIPRP2	24190	0.441174
chr10	118423206	118429481	C10orf82	6275	0.487331
chr10	118430702	118502085	HSPA12A	71383	0.491406
chr10	118588285	118590480	DQ596646	2195	0.432346
chr10	118609022	118642112	ENO4	33090	0.430251
chr10	118642887	118765088	KIAA1598	122201	0.386085
chr10	118892800	118897812	VAX1	5012	0.612729
chr10	118918166	118928566	BC039338	10400	0.514615
chr10	118927188	118927285	MIR3663	97	0.690722
chr10	118956999	118969810	KCNK18	12811	0.505815
chr10	119000583	119038941	SLC18A2	38358	0.457949
chr10	119042605	119134937	PDZD8	92332	0.377226
chr10	119243803	119304579	EMX2OS	60776	0.476208
chr10	119301955	119309057	EMX2	7102	0.562518
chr10	119764426	119806114	RAB11FIP2	41688	0.354251
chr10	119806331	119815736	CASC2	9405	0.386603
chr10	120068571	120101839	FAM204A	33268	0.368492
chr10	120352915	120355160	PRLHR	2245	0.568820
chr10	120440493	120514758	CACUL1	74265	0.396014
chr10	120789227	120793854	NANOS1	4627	0.497515
chr10	120794540	120840334	EIF3A	45794	0.417959
chr10	120819524	120819650	SNORA19	126	0.333333
chr10	120820494	120820623	SNORA19	129	0.364341
chr10	120863610	120897376	FAM45B	33766	0.452319
chr10	120871441	120873209	BC042590	1768	0.421946
chr10	120900424	120925204	SFXN4	24780	0.477845
chr10	120927214	120938345	PRDX3	11131	0.460336
chr10	120967196	121215131	GRK5	247935	0.504172
chr10	121137483	121137555	MIR4681	72	0.597222
chr10	121259338	121302222	RGS10	42884	0.494194
chr10	121332977	121356541	TIAL1	23564	0.375785
chr10	121410881	121437329	BAG3	26448	0.497731
chr10	121485558	121588662	INPP5F	103104	0.412302
chr10	121588915	121632395	MCMBP	43480	0.401564
chr10	121652084	121704170	SEC23IP	52086	0.401663
chr10	121718024	121718104	MIR4682	80	0.637500
chr10	122216465	122349367	PPAPDC1A	132902	0.423139
chr10	122521323	122610691	WDR11-AS1	89368	0.429997
chr10	122610686	122669038	WDR11	58352	0.368179
chr10	122666806	122667788	AX747838	982	0.419552
chr10	122806839	122806858	MIR5694	19	0.526316
chr10	123237843	123357972	FGFR2	120129	0.454120
chr10	123502624	123687546	ATE1	184922	0.390278
chr10	123716602	123734743	NSMCE4A	18141	0.438509
chr10	123748688	124014057	TACC2	265369	0.482950
chr10	124030820	124097676	BTBD16	66856	0.454170
chr10	124134093	124191871	PLEKHA1	57778	0.367458
chr10	124176480	124176583	MIR3941	103	0.407767
chr10	124214178	124216868	ARMS2	2690	0.442007
chr10	124221040	124274424	HTRA1	53384	0.491983
chr10	124320180	124403252	DMBT1	83072	0.491345
chr10	124457224	124459338	C10orf120	2114	0.467360
chr10	124516209	124557161	FLJ46361	40952	0.428599
chr10	124591670	124610310	FAM24B-CUZD1	18640	0.410032
chr10	124608609	124639157	FAM24B	30548	0.410272
chr10	124639148	124658230	LOC399815	19082	0.373389
chr10	124670216	124672627	FAM24A	2411	0.449606
chr10	124690418	124713919	C10orf88	23501	0.362368
chr10	124739555	124749923	PSTK	10368	0.416474
chr10	124750321	124768203	IKZF5	17882	0.381669
chr10	124765881	124765902	JA611253	21	0.333333
chr10	124768428	124817806	ACADSB	49378	0.407651
chr10	124895566	124897247	HMX3	1681	0.690660
chr10	124907637	124910188	HMX2	2551	0.600941
chr10	124913759	124924886	BUB3	11127	0.383841
chr10	125425870	125456913	GPR26	31043	0.501562
chr10	125505151	125651500	CPXM2	146349	0.449802
chr10	125767181	125851940	CHST15	84759	0.499109
chr10	126085871	126107545	OAT	21674	0.424933
chr10	126135997	126138550	NKX1-2	2553	0.629064
chr10	126150340	126302710	LHPP	152370	0.533596
chr10	126307862	126432930	FAM53B	125068	0.527017
chr10	126392596	126403329	BC041007	10733	0.515699
chr10	126447405	126480439	METTL10	33034	0.413120
chr10	126490353	126525239	FAM175B	34886	0.426245
chr10	126630691	126676005	ZRANB1	45314	0.397008
chr10	126676417	126716453	CTBP2	40036	0.539514
chr10	126721351	126721439	MIR4296	88	0.568182
chr10	127262939	127267014	LOC100169752	4075	0.475092
chr10	127344262	127371713	TEX36	27451	0.414994
chr10	127371811	127398246	LOC283038	26435	0.441801
chr10	127393858	127408062	FLJ37035	14204	0.418544
chr10	127408083	127452712	C10orf137	44629	0.390889
chr10	127455026	127464390	MMP21	9364	0.523281
chr10	127477146	127511837	UROS	34691	0.460091
chr10	127508308	127508391	MIR4484	83	0.457831
chr10	127512103	127542264	BCCIP	30161	0.428666
chr10	127524908	127569884	DHX32	44976	0.418379
chr10	127579134	127579247	U2	113	0.327434
chr10	127585107	127698161	FANK1	113054	0.414873
chr10	127660756	127661842	FANK1-AS1	1086	0.436464
chr10	127702901	128077127	ADAM12	374226	0.431130
chr10	128102437	128110448	LINC00601	8011	0.431282
chr10	128113573	128210010	C10orf90	96437	0.427792
chr10	128594022	129250780	DOCK1	656758	0.347250
chr10	128933689	128994422	FAM196A	60733	0.444816
chr10	129347612	129350935	NPS	3323	0.356305
chr10	129534478	129535260	BC132944	782	0.682864
chr10	129535537	129539450	FOXI2	3913	0.615640
chr10	129676113	129691211	CLRN3	15098	0.474434
chr10	129705324	129884164	PTPRE	178840	0.478869
chr10	129894924	129924468	MKI67	29544	0.433015
chr10	129979399	130115990	AK124226	136591	0.454547
chr10	131265453	131565783	MGMT	300330	0.454836
chr10	131633495	131762091	EBF3	128596	0.487853
chr10	131641562	131641638	MIR4297	76	0.684211
chr10	131862161	131909081	LOC387723	46920	0.426641
chr10	131904272	131907101	CTAGE7P	2829	0.408978
chr10	131934638	131977932	GLRX3	43294	0.420197
chr10	132760850	132760931	MIR378C	81	0.543210
chr10	132890654	133109984	TCERG1L	219330	0.487165
chr10	133604733	133622535	FLJ46300	17802	0.508707
chr10	133747959	133770053	PPP2R2D	22094	0.481986
chr10	133781203	133795435	BNIP3	14232	0.495503
chr10	133810241	133813350	AX746857	3109	0.526214
chr10	133918312	133998313	JAKMIP3	80001	0.553656
chr10	134000413	134019280	DPYSL4	18867	0.616526
chr10	134020995	134121477	STK32C	100482	0.566042
chr10	134145613	134195010	LRRC27	49397	0.516813
chr10	134210701	134231358	PWWP2B	20657	0.622210
chr10	134258713	134261825	C10orf91	3112	0.640103
chr10	134325129	134331695	AF086154	6566	0.522997
chr10	134351352	134596984	INPP5A	245632	0.541314
chr10	134598319	134599537	NKX6-2	1218	0.736453
chr10	134621895	134756089	TTC40	134194	0.553892
chr10	134779037	134790001	LOC399829	10964	0.526085
chr10	134884432	134945179	GPR123	60747	0.603256
chr10	134958377	134958397	CS330190	20	0.650000
chr10	134973970	135039916	KNDC1	65946	0.592803
chr10	135043777	135045062	UTF1	1285	0.769650
chr10	135051407	135055433	VENTX	4026	0.577745
chr10	135061014	135061124	MIR202	110	0.581818
chr10	135075919	135090407	ADAM8	14488	0.637838
chr10	135092133	135122660	TUBGCP2	30527	0.558587
chr10	135122422	135126666	ZNF511	4244	0.552780
chr10	135137575	135138249	BC047942	674	0.655786
chr10	135138927	135150475	CALY	11548	0.592310
chr10	135168794	135171529	FUOM	2735	0.674589
chr10	135175986	135186908	ECHS1	10922	0.556400
chr10	135185059	135185167	MIR3944	108	0.638889
chr10	135192740	135205198	PAOX	12458	0.527934
chr10	135207620	135234174	MTG1	26554	0.473789
chr10	135234169	135238121	SPRN	3952	0.661943
chr10	135269740	135278678	LOC619207	8938	0.557507
chr10	135340866	135352620	CYP2E1	11754	0.524502
chr10	135368347	135379138	SYCE1	10791	0.476694
chr10	135438602	135440299	FRG2B	1697	0.511491
chr10	135480557	135485241	DUX4	4684	0.726943
chr10	135487176	135491849	DUX4L3	4673	0.726300
chr10	135493785	135498458	DUX4L3	4673	0.727156
chr11	126986	133778	LOC100133161	6792	0.566549
chr11	141452	180341	AL137655	38889	0.441873
chr11	193079	194573	SCGB1C1	1494	0.570281
chr11	196760	200258	ODF3	3498	0.602344
chr11	202923	207422	BET1L	4499	0.574128
chr11	208529	215110	RIC8A	6581	0.570734
chr11	215029	236362	SIRT3	21333	0.480992
chr11	236807	252984	PSMD13	16177	0.442418
chr11	278569	285388	NLRP6	6819	0.635430
chr11	289137	295688	ATHL1	6551	0.649214
chr11	298200	299526	IFITM5	1326	0.649321
chr11	308106	309410	IFITM2	1304	0.585890
chr11	313990	315272	IFITM1	1282	0.571763
chr11	318652	325631	BC040735	6979	0.556097
chr11	319672	320914	IFITM3	1242	0.590177
chr11	369794	382117	B4GALNT4	12323	0.659742
chr11	394216	404908	PKP3	10692	0.701646
chr11	405715	417397	SIGIRR	11682	0.651258
chr11	417929	442011	ANO9	24082	0.594303
chr11	450279	491387	PTDSS2	41108	0.559842
chr11	494511	506821	RNH1	12310	0.598538
chr11	532241	535550	HRAS	3309	0.692656
chr11	537521	554916	LRRC56	17395	0.599598
chr11	554849	560779	C11orf35	5930	0.670826
chr11	557594	560107	AX748330	2513	0.630720
chr11	559476	560107	BC031953	631	0.568938
chr11	561449	564025	RASSF7	2576	0.659162
chr11	565656	568457	MIR210HG	2801	0.615137
chr11	568088	568198	MIR210	110	0.727273
chr11	573807	575885	LOC143666	2078	0.603946
chr11	576482	612222	PHRF1	35740	0.563039
chr11	612554	615999	IRF7	3445	0.670537
chr11	616564	625067	CDHR5	8503	0.626720
chr11	626312	627173	SCT	861	0.724739
chr11	637304	640705	DRD4	3401	0.669215
chr11	644224	695740	DEAF1	51516	0.521799
chr11	695590	705028	TMEM80	9438	0.556686
chr11	706119	727727	EPS8L2	21608	0.601166
chr11	747431	765024	TALDO1	17593	0.518729
chr11	767222	777487	PDDC1	10265	0.602533
chr11	779453	780755	NS3BP	1302	0.620584
chr11	787109	790126	CEND1	3017	0.662579
chr11	790474	798269	SLC25A22	7795	0.655164
chr11	799178	805250	PIDD	6072	0.663702
chr11	809935	812876	RPLP2	2941	0.562734
chr11	811680	811814	SNORA52	134	0.604478
chr11	818900	825571	PNPLA2	6671	0.645780
chr11	826156	829352	EFCAB4A	3196	0.643304
chr11	827584	831991	EFCAB4A	4407	0.666667
chr11	830712	830732	JB050151	20	0.800000
chr11	832951	838835	CD151	5884	0.636132
chr11	839720	842529	POLR2L	2809	0.598790
chr11	842823	867116	TSPAN4	24293	0.650105
chr11	856879	858707	AK126635	1828	0.605580
chr11	867858	910874	CHID1	43016	0.597313
chr11	880866	881475	AX747537	609	0.515599
chr11	881475	882176	AX747537	701	0.556348
chr11	925808	1012245	AP2A2	86437	0.528986
chr11	1012823	1036706	MUC6	23883	0.634091
chr11	1074874	1104417	MUC2	29543	0.638188
chr11	1244294	1283406	MUC5B	39112	0.655579
chr11	1213089	1222366	MUC5AC	9277	0.651719
chr11	1295597	1330892	TOLLIP	35295	0.574897
chr11	1330937	1331937	TOLLIP-AS1	1000	0.614000
chr11	1432381	1483919	BRSK2	51538	0.634988
chr11	1490684	1507948	MOB2	17264	0.580109
chr11	1490692	1502115	MOB2	11423	0.553270
chr11	1575280	1593150	DUSP8	17870	0.641074
chr11	1594476	1620414	KRTAP5-AS1	25938	0.499537
chr11	1605571	1606513	KRTAP5-1	942	0.647558
chr11	1618406	1619524	KRTAP5-2	1118	0.593023
chr11	1628794	1629693	KRTAP5-3	899	0.632925
chr11	1642187	1643368	KRTAP5-4	1181	0.585944
chr11	1651032	1652159	KRTAP5-5	1127	0.620231
chr11	1686828	1689086	FAM99A	2258	0.629318
chr11	1704499	1706859	FAM99B	2360	0.660593
chr11	1709526	1710286	AF085962	760	0.489474
chr11	1718424	1718985	KRTAP5-6	561	0.614973
chr11	1753639	1771824	IFITM10	18185	0.551883
chr11	1773981	1785222	CTSD	11241	0.643537
chr11	1855673	1858750	SYT8	3077	0.666558
chr11	1861431	1862910	TNNI2	1479	0.669371
chr11	1886394	1913493	LSP1	27099	0.631389
chr11	1880693	1880766	MIR4298	73	0.561644
chr11	1940798	1959936	TNNT3	19138	0.611924
chr11	1968501	1977839	MRPL23	9338	0.606554
chr11	1994988	1999674	AK126380	4686	0.623346
chr11	2004438	2011150	MRPL23-AS1	6712	0.639303
chr11	2016405	2019065	H19	2660	0.639850
chr11	2150341	2162341	IGF2	12000	0.632833
chr11	2155363	2155439	MIR483	76	0.605263
chr11	2161757	2169896	IGF2-AS	8139	0.574026
chr11	2167852	2182439	INS-IGF2	14587	0.608487
chr11	2185158	2193035	TH	7877	0.652660
chr11	2194292	2194368	MIR4686	76	0.618421
chr11	2289727	2292182	ASCL2	2455	0.695723
chr11	2317506	2323143	C11orf21	5637	0.613979
chr11	2323242	2339430	TSPAN32	16188	0.630282
chr11	2349978	2399222	BC019904	49244	0.507717
chr11	2398546	2418649	CD81	20103	0.635328
chr11	2423523	2425106	TSSC4	1583	0.642451
chr11	2425745	2444275	TRPM5	18530	0.637075
chr11	2466220	2870340	KCNQ1	404120	0.515243
chr11	2629557	2721228	KCNQ1OT1	91671	0.437183
chr11	2891262	2893336	KCNQ1DN	2074	0.609450
chr11	2892666	2892728	KCNQ1DN	62	0.322581
chr11	2904447	2906995	CDKN1C	2548	0.675824
chr11	2909326	2925175	SLC22A18AS	15849	0.591899
chr11	2920950	2946476	SLC22A18	25526	0.614824
chr11	2949502	2950650	PHLDA2	1148	0.648084
chr11	2965659	3013607	NAP1L4	47948	0.442709
chr11	2985000	2985123	SNORA54	123	0.495935
chr11	3022151	3078681	CARS	56530	0.519689
chr11	3050623	3062490	AX747870	11867	0.470970
chr11	3108345	3186582	OSBPL5	78237	0.569091
chr11	3239173	3240043	MRGPRG	870	0.683908
chr11	3239561	3244361	MRGPRG-AS1	4800	0.618542
chr11	3249040	3253616	MRGPRE	4576	0.626530
chr11	3379156	3400452	ZNF195	21296	0.394628
chr11	3402190	3430378	LOC650368	28188	0.486590
chr11	3411936	3413145	OR7E12P	1209	0.473118
chr11	3647689	3658789	TRPC2	11100	0.499730
chr11	3659735	3663485	ART5	3750	0.566400
chr11	3666360	3685646	ART1	19286	0.492845
chr11	3686816	3692614	CHRNA10	5798	0.562608
chr11	3696239	3819022	NUP98	122783	0.415196
chr11	3819048	3847601	PGAP2	28553	0.503835
chr11	3848207	3862213	RHOG	14006	0.512209
chr11	3876932	4114440	STIM1	237508	0.424053
chr11	4115923	4160106	RRM1	44183	0.404002
chr11	4208381	4223883	LOC100506082	15502	0.444910
chr11	4388492	4389616	OR52B4	1124	0.446619
chr11	4406126	4414926	TRIM21	8800	0.463636
chr11	4470524	4471591	OR52K2	1067	0.521087
chr11	4510108	4511138	OR52K1	1030	0.501942
chr11	4566420	4567374	OR52M1	954	0.514675
chr11	4592652	4599050	C11orf40	6398	0.434354
chr11	4608020	4609135	OR52I2	1115	0.486996
chr11	4615268	4616243	OR52I1	975	0.501538
chr11	4619901	4629489	TRIM68	9588	0.465373
chr11	4660944	4662068	OR51D1	1124	0.506228
chr11	4665155	4676716	OR51E1	11561	0.431364
chr11	4701400	4719076	OR51E2	17676	0.396866
chr11	4790208	4791147	OR51F1	939	0.440895
chr11	4824662	4825610	OR52R1	948	0.508439
chr11	4842615	4843644	OR51F2	1029	0.455782
chr11	4869466	4870438	OR51S1	972	0.527778
chr11	4903048	4904113	OR51T1	1065	0.458216
chr11	4928599	4929538	OR51A7	939	0.443024
chr11	4935948	4936893	OR51G2	945	0.501587
chr11	4944603	4945569	OR51G1	966	0.497930
chr11	4967388	4968330	OR51A4	942	0.427813
chr11	4976001	4976943	OR51A2	942	0.429936
chr11	5009423	5013659	MMP26	4236	0.390699
chr11	5020212	5021160	OR51L1	948	0.456751
chr11	5067755	5068691	OR52J3	936	0.455128
chr11	5079879	5080857	OR52E2	978	0.449898
chr11	5142384	5145743	DQ656008	3359	0.388211
chr11	5152921	5153872	OR52A5	951	0.418507
chr11	5172660	5173599	OR52A1	939	0.439830
chr11	5199340	5199783	OR52Z1	443	0.478555
chr11	5220964	5221930	OR51V1	966	0.456522
chr11	5246695	5248301	HBB	1606	0.401619
chr11	5246721	5246744	DL074624	23	0.565217
chr11	5254058	5255858	HBD	1800	0.410556
chr11	5263184	5264822	HBBP1	1638	0.420635
chr11	5269501	5271087	HBG1	1586	0.473518
chr11	5289579	5291386	HBE1	1807	0.431101
chr11	5322243	5323176	OR51B4	933	0.448017
chr11	5344527	5345582	OR51B2	1055	0.429384
chr11	5363743	5526882	OR51B5	163139	0.392659
chr11	5372737	5373676	OR51B6	939	0.452609
chr11	5410606	5411664	OR51M1	1058	0.494329
chr11	5443340	5444436	OR51Q1	1096	0.484489
chr11	5461771	5462783	OR51I1	1012	0.480237
chr11	5474637	5475707	OR51I2	1070	0.483178
chr11	5509914	5510978	OR52D1	1064	0.484962
chr11	5528529	5531153	UBQLN3	2624	0.532012
chr11	5535622	5537956	UBQLNL	2334	0.507712
chr11	5565790	5566753	OR52H1	963	0.474559
chr11	5602106	5603114	OR52B6	1008	0.493056
chr11	5617864	5665625	TRIM6-TRIM34	47761	0.420343
chr11	5684424	5706339	TRIM5	21915	0.414511
chr11	5686441	5687610	TRIpartite motif protein	1169	0.396065
chr11	5710816	5732093	TRIM22	21277	0.390328
chr11	5757677	5758768	OR56B1	1091	0.447296
chr11	5775922	5776959	OR52N4	1037	0.460945
chr11	5798863	5799897	OR52N5	1034	0.438104
chr11	5809083	5810046	OR52N1	963	0.465213
chr11	5841565	5842531	OR52N2	966	0.486542
chr11	5862185	5863127	OR52E6	942	0.455414
chr11	5877978	5878932	OR52E8	954	0.459119
chr11	5905522	5906461	OR52E4	939	0.435570
chr11	5968576	5969524	OR56A3	948	0.507384
chr11	5988782	5989724	OR56A5	942	0.500000
chr11	6007121	6008215	OR52L1	1094	0.498172
chr11	6023280	6024378	OR56A4	1098	0.499089
chr11	6047900	6048971	OR56A1	1071	0.506069
chr11	6129008	6129968	OR56B4	960	0.501042
chr11	6172912	6173819	OLFR690	907	0.464168
chr11	6190584	6191556	OR52B2	972	0.488683
chr11	6220453	6221416	OR52W1	963	0.538941
chr11	6226797	6232365	C11orf42	5568	0.462644
chr11	6232563	6255941	FAM160A2	23378	0.445462
chr11	6260321	6265707	CNGA4	5386	0.518195
chr11	6280903	6293357	CCKBR	12454	0.460976
chr11	6340175	6341740	PRKCDBP	1565	0.646006
chr11	6411643	6416228	SMPD1	4585	0.566848
chr11	6416354	6417804	APBB1	1450	0.571034
chr11	6416354	6440644	APBB1	24290	0.518691
chr11	6452267	6462254	HPX	9987	0.480525
chr11	6469842	6495689	TRIM3	25847	0.486788
chr11	6495912	6502709	ARFIP2	6797	0.528027
chr11	6502676	6505911	TIMM10B	3235	0.475734
chr11	6518525	6593254	DNHD1	74729	0.447377
chr11	6621143	6624880	RRP8	3737	0.518063
chr11	6624963	6632099	ILK	7136	0.496917
chr11	6632047	6633475	TAF10	1428	0.604342
chr11	6633996	6640692	TPP1	6696	0.502838
chr11	6642557	6677074	DCHS1	34517	0.526552
chr11	6701615	6704632	MRPL17	3017	0.477958
chr11	6734380	6743110	GVINP1	8730	0.419359
chr11	6789237	6790188	OR2AG2	951	0.514196
chr11	6806247	6807245	OR2AG1	998	0.517034
chr11	6815755	6817139	OR6A2	1384	0.463873
chr11	6866913	6867867	OR10A5	954	0.477987
chr11	6890985	6891897	OR10A2	912	0.487939
chr11	6897855	6898850	OR10A4	995	0.499497
chr11	6912804	6913731	OR2D2	927	0.461704
chr11	6942232	6943225	OR2D3	993	0.445116
chr11	6947653	6979278	ZNF215	31625	0.381976
chr11	7020548	7041586	ZNF214	21038	0.351079
chr11	7041699	7092757	NLRP14	51058	0.373027
chr11	7078055	7078075	JB175177	20	0.300000
chr11	7110164	7112379	RBMXL2	2215	0.561174
chr11	7273180	7490276	SYT9	217096	0.400984
chr11	7458867	7487042	BC040358	28175	0.448554
chr11	7506599	7532606	OLFML1	26007	0.421963
chr11	7534995	7674996	PPFIBP2	140001	0.452004
chr11	7686325	7694821	CYB5R2	8496	0.510476
chr11	7710668	7727941	OVCH2	17273	0.417241
chr11	7794439	7795197	PJCG1	758	0.468338
chr11	7817520	7818489	OR5P2	969	0.439628
chr11	7846583	7847519	OR5P3	936	0.457265
chr11	7870597	7871118	OR5E1P	521	0.483685
chr11	7872297	7927502	LOC283299	55205	0.387900
chr11	7910728	7910826	U6	98	0.397959
chr11	7949264	7950209	OR10A6	945	0.414815
chr11	7960122	7961067	OR10A3	945	0.435979
chr11	7981155	7985059	NLRP10	3904	0.503074
chr11	8008444	8017719	EIF3F	9275	0.443450
chr11	8032824	8038036	BC027619	5212	0.449731
chr11	8060179	8127654	TUB	67475	0.496110
chr11	8081584	8090920	AK055772	9336	0.530099
chr11	8127596	8190590	RIC3	62994	0.399101
chr11	8245850	8290182	LMO1	44332	0.528354
chr11	8413417	8615503	STK33	202086	0.375919
chr11	8576562	8576693	SCARNA20	131	0.519084
chr11	8633583	8680383	TRIM66	46800	0.464872
chr11	8693132	8701271	BC068088	8139	0.411230
chr11	8703994	8711419	RPL27A	7425	0.483367
chr11	8705773	8705903	SNORA3	130	0.523077
chr11	8706985	8707116	SNORA45	131	0.526718
chr11	8714898	8832224	ST5	117326	0.475547
chr11	8932700	8941626	AKIP1	8926	0.463477
chr11	8941622	8954553	C11orf16	12931	0.498801
chr11	8959118	8964580	ASCL3	5462	0.425668
chr11	8968839	8985989	TMEM9B	17150	0.418834
chr11	8986221	8997830	TMEM9B-AS1	11609	0.438453
chr11	9002122	9025596	NRIP3	23474	0.429454
chr11	9041046	9113150	SCUBE2	72104	0.448671
chr11	9111858	9111926	MIR5691	68	0.544118
chr11	9115909	9117737	KRT8P41	1828	0.566740
chr11	9160374	9286873	DENND5A	126499	0.429964
chr11	9302200	9336315	TMEM41B	34115	0.424857
chr11	9406168	9469674	IPO7	63506	0.404009
chr11	9450312	9450501	SNORA23	189	0.465608
chr11	9481102	9482245	LOC644656	1143	0.492563
chr11	9482511	9550071	ZNF143	67560	0.426303
chr11	9499970	9499995	DM376721	25	0.480000
chr11	9522766	9522791	DM376720	25	0.440000
chr11	9537858	9537883	DM376719	25	0.480000
chr11	9595227	9611313	WEE1	16086	0.406192
chr11	9685627	9774507	SWAP70	88880	0.399685
chr11	9776316	9781080	LOC440028	4764	0.559614
chr11	9779839	9832866	SBF2-AS1	53027	0.440813
chr11	9780544	9801489	BC073899	20945	0.460874
chr11	9800213	10315754	SBF2	515541	0.383147
chr11	9801925	9812791	BC073899	10866	0.440364
chr11	9860688	9950808	U80769	90120	0.387661
chr11	10326641	10328923	ADM	2282	0.593339
chr11	10352116	10432385	EF537580	80269	0.432309
chr11	10472223	10529126	AMPD3	56903	0.487145
chr11	10529433	10530723	MTRNR2L8	1290	0.424031
chr11	10530773	10530804	DQ582265	31	0.451613
chr11	10531731	10531752	JB137816	21	0.476190
chr11	10533224	10562774	RNF141	29550	0.360981
chr11	10562782	10621479	MRVI1-AS1	58697	0.423855
chr11	10579412	10590365	LYVE1	10953	0.416507
chr11	10594637	10673848	MRVI1	79211	0.454129
chr11	10772810	10801290	CTR9	28480	0.388062
chr11	10818592	10830582	EIF4G2	11990	0.415763
chr11	10823013	10823155	SNORD97	142	0.380282
chr11	10833620	10848129	BC026354	14509	0.396030
chr11	10874250	10879620	ZBED5	5370	0.387151
chr11	10879763	10900823	ZBED5-AS1	21060	0.394919
chr11	10905705	10920824	AK056982	15119	0.411932
chr11	11292420	11643561	GALNT18	351141	0.463478
chr11	11373488	11374904	CSNK2A3	1416	0.463277
chr11	11678197	11678269	MIR4299	72	0.444444
chr11	11862969	11980872	USP47	117903	0.353189
chr11	11984542	12030629	DKK3	46087	0.487903
chr11	12132137	12285331	MICAL2	153194	0.474744
chr11	12308446	12380691	MICALCL	72245	0.414465
chr11	12399025	12556903	PARVA	157878	0.435007
chr11	12695065	12695086	DD413619	21	0.523810
chr11	12695968	12966284	TEAD1	270316	0.427588
chr11	12926363	12926535	SCARNA16	172	0.447674
chr11	13001080	13011095	LOC100506305	10015	0.432451
chr11	13030969	13033653	RASSF10	2684	0.584203
chr11	13299324	13408812	ARNTL	109488	0.452890
chr11	13374754	13375070	7SK	316	0.468354
chr11	13409555	13484838	BTBD10	75283	0.362260
chr11	13513600	13517567	PTH	3967	0.331737
chr11	13690205	13753893	FAR1	63688	0.360398
chr11	13984183	14289679	SPON1	305496	0.419871
chr11	14299465	14380730	RRAS2	81265	0.388236
chr11	14479048	14521415	COPB1	42367	0.373711
chr11	14500437	14500499	U7	62	0.387097
chr11	14526421	14541991	PSMA1	15570	0.387926
chr11	14665268	14893604	PDE3B	228336	0.369618
chr11	14899555	14913751	CYP2R1	14196	0.398211
chr11	14989219	14993832	CALCA	4613	0.507912
chr11	15095145	15100177	CALCB	5032	0.500596
chr11	15133969	15268756	INSC	134787	0.436993
chr11	15987994	16424413	SOX6	436419	0.351332
chr11	16760147	16779901	C11orf58	19754	0.389187
chr11	16798843	16802232	AL833346	3389	0.510770
chr11	16809206	17035963	PLEKHA7	226757	0.461154
chr11	17073432	17074591	OR7E14P	1159	0.471096
chr11	17095938	17099220	RPS13	3282	0.459171
chr11	17096200	17096291	SNORD14	91	0.428571
chr11	17108123	17191353	PIK3C2A	83230	0.383912
chr11	17298285	17353070	NUCB2	54785	0.386529
chr11	17336932	17371521	NUCB2	34589	0.383995
chr11	17373308	17398868	NCR3LG1	25560	0.444836
chr11	17406795	17410206	KCNJ11	3411	0.595720
chr11	17414431	17498449	ABCC8	84018	0.500262
chr11	17515441	17565963	USH1C	50522	0.517755
chr11	17568919	17667491	OTOG	98572	0.487035
chr11	17741109	17743678	MYOD1	2569	0.636824
chr11	17757494	17804602	KCNC1	47108	0.542923
chr11	17809596	18034637	SERGEF	225041	0.426629
chr11	18042083	18062335	TPH1	20252	0.370482
chr11	18101889	18127638	SAAL1	25749	0.391549
chr11	18134018	18137679	SAA3P	3661	0.453701
chr11	18142501	18160027	MRGPRX3	17526	0.421374
chr11	18194383	18195827	MRGPRX4	1444	0.522161
chr11	18230684	18233055	LOC494141	2371	0.435259
chr11	18252901	18270221	SAA2-SAA4	17320	0.418476
chr11	18287807	18291523	SAA1	3716	0.503767
chr11	18300216	18343721	HPS5	43505	0.397426
chr11	18343815	18388590	GTF2H1	44775	0.407259
chr11	18417812	18429765	LDHA	11953	0.418138
chr11	18433852	18472793	LDHC	38941	0.412059
chr11	18477373	18501147	LDHAL6A	23774	0.415748
chr11	18501857	18548503	TSG101	46646	0.396454
chr11	18552949	18610293	UEVLD	57344	0.409738
chr11	18573219	18573239	JA429845	20	0.550000
chr11	18621350	18631802	SPTY2D1-AS1	10452	0.421546
chr11	18624533	18625440	SPTY2D1-AS1	907	0.452040
chr11	18627947	18656020	SPTY2D1	28073	0.417198
chr11	18720350	18726332	TMEM86A	5982	0.556670
chr11	18725851	18747777	IGSF22	21926	0.504515
chr11	18749474	18814268	PTPN5	64794	0.500185
chr11	18955359	18956549	MRGPRX1	1190	0.523529
chr11	19076002	19082228	MRGPRX2	6226	0.444748
chr11	19138691	19197967	ZDHHC13	59276	0.379631
chr11	19203576	19232118	CSRP3	28542	0.428737
chr11	19245609	19263167	E2F8	17558	0.419182
chr11	19734880	20143147	NAV2	408267	0.444444
chr11	19524219	19528776	NAV2-AS5	4557	0.439324
chr11	19532439	19545625	NAV2-AS4	13186	0.475959
chr11	19596856	19596919	MIR4486	63	0.571429
chr11	19612702	19612838	SNORA1	136	0.433824
chr11	19732479	19736218	LOC100126784	3739	0.576892
chr11	19781549	19781629	MIR4694	80	0.362500
chr11	20177759	20181870	DBX1	4111	0.546339
chr11	20221785	20221851	TRNA	66	0.378788
chr11	20385288	20405329	HTATIP2	20041	0.423931
chr11	20409075	20530879	PRMT3	121804	0.360120
chr11	20620945	20676610	SLC6A5	55665	0.459247
chr11	20691116	21597229	NELL1	906113	0.382929
chr11	22214721	22304913	ANO5	90192	0.344898
chr11	22359666	22401046	SLC17A6	41380	0.365297
chr11	22644078	22647387	FANCF	3309	0.437594
chr11	22696318	22834547	GAS2	138229	0.357327
chr11	22843597	22851382	SVIP	7785	0.360437
chr11	22868467	22881972	CCDC179	13505	0.338986
chr11	23959354	23960351	endogenous retrovirus ERV9	997	0.476429
chr11	24518515	25104186	LUZP2	585671	0.351498
chr11	26353677	26684836	ANO3	331159	0.363363
chr11	26524764	26526329	BC045791	1565	0.322684
chr11	26580578	26593815	MUC15	13237	0.331948
chr11	26688565	26743574	SLC5A12	55009	0.364086
chr11	27015627	27018632	FIBIN	3005	0.447920
chr11	27062508	27149354	BBOX1	86846	0.373512
chr11	27360060	27384795	CCDC34	24735	0.365676
chr11	27387507	27494334	LGR4	106827	0.390875
chr11	27515964	27528326	LIN7C	12362	0.370005
chr11	27528398	27699350	BDNF-AS	170952	0.395760
chr11	27639172	27656174	LINC00678	17002	0.440242
chr11	27676441	27722600	BDNF	46159	0.402522
chr11	28042162	28129746	KIF18A	87584	0.339765
chr11	28078361	28078457	MIR610	96	0.406250
chr11	28078414	28078435	JB074938	21	0.476190
chr11	28129797	28355054	METTL15	225257	0.352753
chr11	30031287	30038577	KCNA4	7290	0.448285
chr11	30252562	30256824	FSHB	4262	0.365556
chr11	30344648	30359165	ARL14EP	14517	0.366536
chr11	30431617	30602041	MPPED2	170424	0.394358
chr11	30900090	31128507	DCDC5	228417	0.362223
chr11	31284170	31391357	DCDC1	107187	0.367022
chr11	31391376	31454382	DNAJC24	63006	0.365140
chr11	31453948	31531169	IMMP1L	77221	0.349063
chr11	31531296	31805329	ELP4	274033	0.358096
chr11	31806339	31839509	PAX6	33170	0.496834
chr11	32112476	32127272	RCN1	14796	0.469654
chr11	32103309	32103519	U3	210	0.423810
chr11	32409321	32457081	WT1	47760	0.464112
chr11	32457584	32461620	WT1-AS	4036	0.549058
chr11	32605312	32624037	EIF3M	18725	0.379866
chr11	32623625	32816204	CCDC73	192579	0.373504
chr11	32851480	32879669	PRRG4	28189	0.391820
chr11	32914791	33001814	QSER1	87023	0.382129
chr11	33037409	33055128	DEPDC7	17719	0.385236
chr11	33061560	33095109	TCP11L1	33549	0.438016
chr11	33097695	33101000	LINC00294	3305	0.451135
chr11	33106129	33183037	CSTF3	76908	0.366334
chr11	33183202	33213142	CSTF3-AS1	29940	0.406045
chr11	33278217	33378568	HIPK3	100351	0.388267
chr11	33563876	33695646	KIAA1549L	131770	0.438211
chr11	33719653	33722286	C11orf91	2633	0.535131
chr11	33724555	33744273	CD59	19718	0.429100
chr11	33762489	33796071	FBXO3	33582	0.370049
chr11	33880122	33913836	LMO2	33714	0.463991
chr11	34073229	34124157	CAPRIN1	50928	0.400369
chr11	34127110	34168458	NAT10	41348	0.456999
chr11	34172533	34379555	ABTB2	207022	0.479229
chr11	34460471	34493607	CAT	33136	0.405963
chr11	34500341	34535347	ELF5	35006	0.457836
chr11	34654010	34684834	EHF	30824	0.437419
chr11	34903842	34937939	APIP	34097	0.398012
chr11	34937676	35017675	PDHX	79999	0.361117
chr11	34963383	34963467	MIR1343	84	0.797619
chr11	35160416	35253949	CD44	93533	0.415618
chr11	35272751	35441105	SLC1A2	168354	0.421237
chr11	35453375	35547176	PAMR1	93801	0.417757
chr11	35639734	35642421	FJX1	2687	0.645702
chr11	35684352	35830930	TRIM44	146578	0.399112
chr11	35835881	35839556	DQ573949	3675	0.423129
chr11	35965611	36252841	LDLRAD3	287230	0.441361
chr11	36031647	36031754	MIR3973	107	0.467290
chr11	36084833	36099448	BC036209	14615	0.426069
chr11	36293841	36310999	COMMD9	17158	0.409780
chr11	36397534	36486754	PRR5L	89220	0.457644
chr11	36505316	36531863	TRAF6	26547	0.383395
chr11	36589562	36601310	RAG1	11748	0.394450
chr11	36613492	36619829	RAG2	6337	0.386145
chr11	36616321	36680841	C11orf74	64520	0.367359
chr11	40135750	41481186	LRRC4C	1345436	0.366987
chr11	41144456	41144562	U6	106	0.377358
chr11	42209292	42275240	LOC100507205	65948	0.376888
chr11	43283053	43290919	HNRNPKP3	7866	0.422324
chr11	43333504	43366080	API5	32576	0.377517
chr11	43380434	43516483	TTC17	136049	0.379025
chr11	43456681	43456947	7SK	266	0.406015
chr11	43581205	43581303	MIR670	98	0.489796
chr11	43590855	43591945	BC031305	1090	0.442202
chr11	43602943	43603033	MIR129-2	90	0.533333
chr11	43602999	43603021	JA715139	22	0.454545
chr11	43702142	43878169	HSD17B12	176027	0.381555
chr11	43851258	43855297	AK094325	4039	0.388958
chr11	43902356	43941825	ALKBH3	39469	0.407991
chr11	43918852	43921424	SEC14L1P1	2572	0.481726
chr11	43930838	43942494	LOC100507300	11656	0.405371
chr11	43964105	43965433	C11orf96	1328	0.691265
chr11	43965336	43968756	AX748080	3420	0.535380
chr11	44069530	44081527	ACCSL	11997	0.475119
chr11	44087728	44105569	ACCS	17841	0.488482
chr11	44117746	44266980	EXT2	149234	0.402214
chr11	44282277	44331716	ALX4	49439	0.528914
chr11	44587140	44641315	CD82	54175	0.533198
chr11	44785975	44953977	TSPAN18	168002	0.503976
chr11	44953898	44972608	TP53I11	18710	0.585195
chr11	44995452	44999578	LOC221122	4126	0.521086
chr11	45168893	45256675	PRDM11	87782	0.499316
chr11	45234021	45236293	AK097878	2272	0.588468
chr11	45261852	45307884	SYT13	46032	0.462830
chr11	45392947	45410059	FLJ41423	17112	0.504850
chr11	45669238	45687206	CHST1	17968	0.564893
chr11	45692990	45693023	DQ585118	33	0.606061
chr11	45697693	45697737	DQ600225	44	0.522727
chr11	45699745	45699781	DQ592142	36	0.444444
chr11	45700329	45700393	DQ576495	64	0.546875
chr11	45700505	45700538	DQ582894	33	0.545455
chr11	45701969	45701999	DQ585921	30	0.433333
chr11	45702305	45702361	DQ580411	56	0.482143
chr11	45702649	45702685	DQ595780	36	0.472222
chr11	45702995	45703036	DQ597512	41	0.512195
chr11	45703416	45703480	DQ573877	64	0.546875
chr11	45704258	45704288	DQ592387	30	0.433333
chr11	45704711	45704746	DQ601209	35	0.542857
chr11	45704771	45704803	DQ577945	32	0.500000
chr11	45704850	45704883	DQ583935	33	0.545455
chr11	45705063	45705103	DQ601289	40	0.600000
chr11	45705353	45705413	DQ583612	60	0.516667
chr11	45706042	45706090	DQ578720	48	0.500000
chr11	45706254	45706285	DQ577602	31	0.451613
chr11	45706456	45706485	DQ592882	29	0.482759
chr11	45706777	45706811	DQ597935	34	0.529412
chr11	45707324	45707364	DQ581231	40	0.550000
chr11	45707655	45707698	DQ586202	43	0.418605
chr11	45708665	45708715	DQ592671	50	0.380000
chr11	45708827	45708860	DQ575460	33	0.545455
chr11	45709424	45709481	DQ584372	57	0.473684
chr11	45709996	45710037	DQ573744	41	0.487805
chr11	45710613	45710645	DQ577649	32	0.437500
chr11	45710774	45710820	DQ576239	46	0.456522
chr11	45710878	45710932	DQ571241	54	0.425926
chr11	45711114	45711143	DQ583646	29	0.413793
chr11	45711156	45711190	DQ585551	34	0.470588
chr11	45711249	45711278	DQ579617	29	0.379310
chr11	45712230	45712262	DQ577288	32	0.375000
chr11	45712928	45712965	DQ589925	37	0.540541
chr11	45713441	45713473	DQ590864	32	0.468750
chr11	45714032	45714070	DQ594732	38	0.526316
chr11	45714555	45714598	DQ580378	43	0.534884
chr11	45714866	45714913	DQ592890	47	0.489362
chr11	45714926	45714960	DQ570013	34	0.500000
chr11	45715055	45715085	DQ595261	30	0.466667
chr11	45715375	45715433	DQ584722	58	0.551724
chr11	45715765	45715842	DQ584505	77	0.532468
chr11	45715868	45715899	DQ595026	31	0.419355
chr11	45715957	45716005	DQ593386	48	0.562500
chr11	45716016	45716046	DQ569946	30	0.500000
chr11	45717158	45717188	DQ582305	30	0.466667
chr11	45717259	45717302	DQ600902	43	0.511628
chr11	45717507	45717542	DQ575455	35	0.485714
chr11	45717586	45717619	DQ596355	33	0.424242
chr11	45717776	45717812	DQ589384	36	0.527778
chr11	45718118	45718182	DQ595965	64	0.484375
chr11	45718234	45718273	DQ580359	39	0.615385
chr11	45718319	45718352	DQ570864	33	0.424242
chr11	45718360	45718391	DQ596865	31	0.483871
chr11	45718415	45718457	DQ594571	42	0.523810
chr11	45718629	45718659	DQ576075	30	0.566667
chr11	45718742	45718804	DQ594374	62	0.451613
chr11	45719135	45719173	DQ576996	38	0.447368
chr11	45719348	45719377	DQ580332	29	0.482759
chr11	45719385	45719456	DQ570497	71	0.478873
chr11	45719768	45719801	DQ594520	33	0.515152
chr11	45719806	45719840	DQ585153	34	0.441176
chr11	45719873	45719913	DQ577389	40	0.450000
chr11	45720190	45720221	DQ594870	31	0.548387
chr11	45720279	45720335	DQ585460	56	0.553571
chr11	45720819	45720849	DQ588034	30	0.500000
chr11	45721044	45721082	DQ591858	38	0.500000
chr11	45721129	45721167	DQ591724	38	0.526316
chr11	45721205	45721235	DQ588704	30	0.600000
chr11	45721245	45721278	DQ578236	33	0.454545
chr11	45721295	45721329	DQ587050	34	0.470588
chr11	45721533	45721608	DQ575869	75	0.533333
chr11	45722054	45722087	DQ589570	33	0.575758
chr11	45722120	45722149	DQ571892	29	0.517241
chr11	45722696	45722732	DQ573752	36	0.500000
chr11	45723090	45723142	DQ585760	52	0.500000
chr11	45723503	45723563	DQ572786	60	0.483333
chr11	45723604	45723632	DQ599212	28	0.571429
chr11	45723742	45723788	DQ585275	46	0.500000
chr11	45724549	45724589	DQ582903	40	0.525000
chr11	45724688	45724728	DQ582858	40	0.525000
chr11	45724816	45724883	DQ577965	67	0.417910
chr11	45725040	45725069	DQ581441	29	0.517241
chr11	45725557	45725590	DQ596759	33	0.454545
chr11	45725697	45725766	DQ599610	69	0.405797
chr11	45726074	45726106	DQ600737	32	0.375000
chr11	45726262	45726296	DQ590560	34	0.441176
chr11	45727085	45727116	DQ585129	31	0.451613
chr11	45727811	45727877	DQ594272	66	0.409091
chr11	45728719	45728755	DQ577812	36	0.416667
chr11	45731274	45731324	DQ595836	50	0.420000
chr11	45732245	45732281	DQ573660	36	0.500000
chr11	45732388	45732442	DQ572425	54	0.444444
chr11	45734298	45734345	DQ588228	47	0.404255
chr11	45734505	45734541	DQ587623	36	0.555556
chr11	45734964	45734994	DQ599087	30	0.466667
chr11	45735054	45735084	DQ592381	30	0.500000
chr11	45735837	45735870	DQ589460	33	0.484848
chr11	45736138	45736166	DQ601287	28	0.464286
chr11	45736325	45736354	DQ573895	29	0.517241
chr11	45736365	45736402	DQ599539	37	0.432432
chr11	45737590	45737655	DQ592438	65	0.507692
chr11	45738135	45738166	DQ590971	31	0.516129
chr11	45738422	45738463	DQ587606	41	0.560976
chr11	45738846	45738876	DQ575274	30	0.500000
chr11	45739264	45739299	DQ584521	35	0.514286
chr11	45739628	45739666	DQ597700	38	0.421053
chr11	45739736	45739772	DQ601595	36	0.527778
chr11	45739825	45739906	DQ598045	81	0.481481
chr11	45740150	45740194	DQ575059	44	0.409091
chr11	45740300	45740342	DQ578791	42	0.500000
chr11	45740741	45740778	DQ576584	37	0.459459
chr11	45740815	45740854	DQ574428	39	0.487179
chr11	45740990	45741065	DQ579844	75	0.493333
chr11	45741235	45741290	DQ573749	55	0.418182
chr11	45741297	45741328	DQ572830	31	0.387097
chr11	45741354	45741388	DQ595071	34	0.500000
chr11	45741419	45741457	DQ576722	38	0.500000
chr11	45741541	45741571	DQ595234	30	0.433333
chr11	45741616	45741652	DQ576379	36	0.472222
chr11	45741830	45741881	DQ571263	51	0.588235
chr11	45741995	45742036	DQ583098	41	0.512195
chr11	45742129	45742161	DQ589004	32	0.468750
chr11	45742173	45742208	DQ570173	35	0.457143
chr11	45742537	45742603	DQ589697	66	0.454545
chr11	45742695	45742727	DQ598861	32	0.500000
chr11	45742830	45742860	DQ598733	30	0.366667
chr11	45742869	45742907	DQ594059	38	0.421053
chr11	45743089	45743119	DQ582888	30	0.466667
chr11	45743150	45743205	DQ576346	55	0.509091
chr11	45743432	45743477	DQ589248	45	0.555556
chr11	45743507	45743536	DQ595146	29	0.482759
chr11	45743609	45743640	DQ577434	31	0.451613
chr11	45743857	45746106	LOC100507384	2249	0.504669
chr11	45792982	45793909	DKFZp779M0652	927	0.583603
chr11	45825622	45834567	SLC35C1	8945	0.569368
chr11	45868956	45904799	CRY2	35843	0.489831
chr11	45907046	45928016	MAPK8IP1	20970	0.582308
chr11	45928085	45928833	C11orf94	748	0.622995
chr11	45931219	45939674	PEX16	8455	0.579302
chr11	45943195	45950647	GYLTL1B	7452	0.614868
chr11	45945704	45950647	GYLTL1B	4943	0.579001
chr11	45950869	46142985	PHF21A	192116	0.388187
chr11	46299227	46342972	CREB3L1	43745	0.528243
chr11	46383144	46402104	DGKZ	18960	0.613291
chr11	46397951	46398034	MIR4688	83	0.638554
chr11	46402617	46405387	MDK	2770	0.662816
chr11	46406639	46408107	CHRM4	1468	0.606948
chr11	46417961	46615619	AMBRA1	197658	0.436243
chr11	46473354	46473439	MIR3160-1	85	0.600000
chr11	46473356	46473437	MIR3160-2	81	0.592593
chr11	46624855	46638777	HARBI1	13922	0.453527
chr11	46638825	46697568	ATG13	58743	0.446215
chr11	46698624	46722215	ARHGAP1	23591	0.531050
chr11	46722643	46727466	ZNF408	4823	0.540120
chr11	46740742	46761056	F2	20314	0.506350
chr11	46765083	46867859	CKAP5	102776	0.404053
chr11	46774674	46774742	MIR5582	68	0.323529
chr11	46780315	46780423	SNORD67	108	0.453704
chr11	46783938	46784049	SNORD67	111	0.513514
chr11	46867961	46895967	LRP4-AS1	28006	0.448975
chr11	46878267	46940173	LRP4	61906	0.486770
chr11	46958239	47183798	C11orf49	225559	0.412593
chr11	47185848	47198676	ARFGAP2	12828	0.531883
chr11	47199072	47208010	PACSIN3	8938	0.597225
chr11	47236492	47260769	DDB2	24277	0.468756
chr11	47260852	47270457	ACP2	9605	0.527538
chr11	47279467	47290584	NR1H3	11117	0.511379
chr11	47291198	47351582	MADD	60384	0.469777
chr11	47353395	47374253	MYBPC3	20858	0.579538
chr11	47376408	47400127	SPI1	23719	0.526160
chr11	47430045	47438051	SLC39A13	8006	0.609168
chr11	47440319	47448024	PSMC3	7705	0.549254
chr11	47459307	47470730	RAPSN	11423	0.534185
chr11	47487488	47510576	CELF1	23088	0.445729
chr11	47600561	47606115	NDUFS3	5554	0.487396
chr11	47586981	47595013	PTPMT1	8032	0.478337
chr11	47593748	47600567	KBTBD4	6819	0.489368
chr11	47608229	47610746	FAM180B	2517	0.585618
chr11	47611215	47615961	C1QTNF4	4746	0.591867
chr11	47638857	47664206	MTCH2	25349	0.435047
chr11	47681142	47736928	AGBL2	55786	0.448966
chr11	47738068	47788993	FNBP4	50925	0.434227
chr11	47799669	47870057	NUP160	70388	0.418395
chr11	48002109	48192394	PTPRJ	190285	0.453804
chr11	48238361	48239291	OR4B1	930	0.469892
chr11	48266655	48267567	OR4X2	912	0.491228
chr11	48285412	48286330	OR4X1	918	0.496732
chr11	48327774	48328704	OR4S1	930	0.480645
chr11	48346492	48347482	OR4C3	990	0.452525
chr11	48366899	48373999	OR4C45	7100	0.417887
chr11	48510344	48511274	OR4A47	930	0.433333
chr11	49053151	49059529	TRIM49B	6378	0.373628
chr11	49075265	49080664	TRIM64C	5399	0.382108
chr11	49168186	49230222	FOLH1	62036	0.356374
chr11	49580079	49831969	LOC440040	251890	0.358446
chr11	49973942	49974971	OR4C13	1029	0.421769
chr11	50003008	50004071	OR4C12	1063	0.418627
chr11	50238998	50257633	LOC441601	18635	0.389697
chr11	50375234	50379802	LOC646813	4568	0.378065
chr11	51411377	51412448	OR4A5	1071	0.421102
chr11	51515281	51516211	OR4C46	930	0.445161
chr11	55029657	55038595	TRIM48	8938	0.368427
chr11	55061178	55065708	TRIM51HP	4530	0.369757
chr11	55110676	55111663	OR4A16	987	0.412361
chr11	55135359	55136394	OR4A15	1035	0.414493
chr11	55321782	55322895	OR4C15	1113	0.424978
chr11	55339603	55340536	OR4C16	933	0.423365
chr11	55370829	55371874	OR4C11	1045	0.406699
chr11	55405833	55406772	OR4P4	939	0.391906
chr11	55418379	55419315	OR4S2	936	0.425214
chr11	55432642	55433572	OR4C6	930	0.464516
chr11	55540913	55541858	OR5D13	945	0.403175
chr11	55563031	55563976	OR5D14	945	0.448677
chr11	55578942	55579878	OR5L1	936	0.476496
chr11	55587105	55588047	OR5D18	942	0.457537
chr11	55594694	55595630	OR5L2	936	0.485043
chr11	55606227	55607214	OR5D16	987	0.426545
chr11	55650772	55659284	TRIM51	8512	0.365836
chr11	55681125	55682058	OR5W2	933	0.406217
chr11	55702931	55703876	OR5I1	945	0.405291
chr11	55735033	55735939	OR10AG1	906	0.379691
chr11	55746178	55753881	OR7E5P	7703	0.394911
chr11	55761156	55762101	OR5F1	945	0.457143
chr11	55797894	55798869	OR5AS1	975	0.394872
chr11	55860783	55861716	OR8I2	933	0.426581
chr11	55872518	55873457	OR8H2	939	0.414270
chr11	55889848	55890787	OR8H3	939	0.427050
chr11	55904246	55905194	OR8J3	948	0.417722
chr11	55926869	55927793	OR8K5	924	0.400433
chr11	55944093	55945032	OR5J2	939	0.436635
chr11	55999581	56000661	OR5T2	1080	0.392593
chr11	56019675	56020698	OR5T3	1023	0.388074
chr11	56043114	56044095	OR5T1	981	0.388379
chr11	56057602	56058538	OR8H1	936	0.410256
chr11	56085782	56086721	OR8K3	939	0.390841
chr11	56113514	56114474	OR8K1	960	0.398958
chr11	56127690	56128764	OR8J1	1074	0.404097
chr11	56143099	56508560	OR8U8	365461	0.366510
chr11	56184733	56185708	OR5R1	975	0.424615
chr11	56229944	56230877	OR5M9	933	0.455520
chr11	56236963	56238014	OR5M3	1051	0.396765
chr11	56257910	56258846	OR5M8	936	0.447650
chr11	56309815	56310733	OR5M11	918	0.462963
chr11	56344249	56345197	OR5M10	948	0.445148
chr11	56380030	56380978	OR5M1	948	0.447257
chr11	56408964	56409915	OR5AP2	951	0.436383
chr11	56431161	56432094	OR5AR1	933	0.468382
chr11	56467863	56468781	OR9G9	918	0.477124
chr11	56510303	56511287	OR9G4	984	0.452236
chr11	56570000	56587123	AB231741	17123	0.357823
chr11	56615953	56645554	AK096987	29601	0.380663
chr11	56756388	56757318	OR5AK2	930	0.390323
chr11	56805008	56805935	OR5AK4P	927	0.386192
chr11	56949220	56959188	LRRC55	9968	0.481641
chr11	57001051	57004927	APLNR	3876	0.550052
chr11	57067102	57092413	TNKS1BP1	25311	0.555450
chr11	57093458	57103351	SSRP1	9893	0.505408
chr11	57105840	57137549	P2RX3	31709	0.501624
chr11	57144241	57148623	PRG3	4382	0.496120
chr11	57174426	57195053	SLC43A3	20627	0.481650
chr11	57219162	57219495	7SK	333	0.522523
chr11	57228338	57244384	RTN4RL2	16046	0.538452
chr11	57252003	57282358	SLC43A1	30355	0.502125
chr11	57295935	57298232	TIMM10	2297	0.479321
chr11	57310113	57317747	SMTNL1	7634	0.538381
chr11	57319127	57335180	UBE2L6	16053	0.478353
chr11	57365026	57382326	SERPING1	17300	0.474566
chr11	57405848	57420263	AK096335	14415	0.520499
chr11	57408670	57408759	MIR130A	89	0.505618
chr11	57412559	57417417	YPEL4	4858	0.552079
chr11	57425215	57429337	CLP1	4122	0.467006
chr11	57435473	57468659	ZDHHC5	33186	0.452088
chr11	57471186	57479673	MED19	8487	0.456227
chr11	57529233	57586652	CTNND1	57419	0.425208
chr11	57479994	57508445	TMX2	28451	0.452322
chr11	57508721	57510883	C11orf31	2162	0.525439
chr11	57510985	57519253	BTBD18	8268	0.457547
chr11	57791352	57949038	OR9Q1	157686	0.400137
chr11	57798424	57799378	OR6Q1	954	0.495807
chr11	57876434	57877133	OR9I1	699	0.499285
chr11	57885971	57886916	OR9I1	945	0.491005
chr11	57957905	57958990	OR9Q2	1085	0.515207
chr11	57970675	57971653	OR1S2	978	0.450920
chr11	57982216	57983194	OR1S1	978	0.440695
chr11	57995353	57996390	OR10Q1	1037	0.572806
chr11	58034263	58035732	OR10W1	1469	0.469027
chr11	58125597	58126542	OR5B17	945	0.417989
chr11	58169937	58170882	OR5B3	945	0.424339
chr11	58189737	58190786	OR5B2	1049	0.445186
chr11	58206592	58207646	OR5B12	1054	0.430740
chr11	58274648	58275578	OR5B21	930	0.479570
chr11	58294343	58343390	LPXN	49047	0.383775
chr11	58346586	58389023	ZFP91	42437	0.364446
chr11	58390145	58393205	CNTF	3060	0.416013
chr11	58476229	58499447	GLYAT	23218	0.365535
chr11	58601539	58611997	GLYATL2	10458	0.369669
chr11	58652423	58660266	AB231721	7843	0.359684
chr11	58672896	58676071	AK294973	3175	0.479685
chr11	58710721	58724543	GLYATL1	13822	0.375344
chr11	58701115	58825925	LOC283194	124810	0.392741
chr11	58746331	58746843	AB231722	512	0.451172
chr11	58874657	58894888	FAM111B	20231	0.389106
chr11	58901711	58910281	BC028022	8570	0.409685
chr11	58912251	58922511	FAM111A	10260	0.388304
chr11	58939811	58976060	DTX4	36249	0.472399
chr11	58975982	58980494	MPEG1	4512	0.466977
chr11	59131931	59132867	OR5AN1	936	0.423077
chr11	59189451	59190426	OR5A2	975	0.473846
chr11	59210641	59211589	OR5A1	948	0.512658
chr11	59224433	59225378	OR4D6	945	0.499471
chr11	59244902	59245838	OR4D10	936	0.480769
chr11	59271048	59271984	OR4D11	936	0.496795
chr11	59282385	59283330	OR4D9	945	0.480423
chr11	59326272	59326334	U7	62	0.338710
chr11	59332527	59332547	JB175310	20	0.400000
chr11	59341870	59383617	OSBP	41747	0.428007
chr11	59362549	59362631	MIR3162	82	0.487805
chr11	59404191	59436511	PATL1	32320	0.398948
chr11	59480388	59481318	OR10V1	930	0.478495
chr11	59516284	59517054	OR10V2P	770	0.529870
chr11	59522531	59573355	STX3	50824	0.448725
chr11	59573607	59578345	MRPL16	4738	0.445969
chr11	59596745	59612974	GIF	16229	0.408158
chr11	59620280	59634041	TCN1	13761	0.396119
chr11	59710362	59737619	AB231702	27257	0.379169
chr11	59807747	59815516	PLAC1L	7769	0.382289
chr11	59824100	59838588	MS4A3	14488	0.391703
chr11	59856136	59865940	MS4A2	9804	0.384741
chr11	59939970	59952139	MS4A6A	12169	0.405456
chr11	59980567	59997544	MS4A4E	16977	0.380456
chr11	60048013	60076445	MS4A4A	28432	0.384320
chr11	60102354	60108441	MS4A6E	6087	0.404961
chr11	60163486	60185228	MS4A14	21742	0.375494
chr11	60145957	60163426	MS4A7	17469	0.407064
chr11	60197061	60215265	MS4A5	18204	0.384256
chr11	60223281	60238225	MS4A1	14944	0.400428
chr11	60260250	60274901	MS4A12	14651	0.393215
chr11	60282885	60310191	MS4A13	27306	0.378671
chr11	60383223	60454621	LINC00301	71398	0.389675
chr11	60467046	60483285	MS4A8	16239	0.456925
chr11	60501076	60506416	AB231761	5340	0.468914
chr11	60524339	60544204	MS4A15	19865	0.501384
chr11	60552820	60568778	MS4A10	15958	0.519739
chr11	60609428	60618561	CCDC86	9133	0.549436
chr11	60618397	60623444	PTGDR2	5047	0.566871
chr11	60635014	60643164	ZP1	8150	0.553374
chr11	60658019	60674061	PRPF19	16042	0.465528
chr11	60681370	60690915	TMEM109	9545	0.511158
chr11	60691912	60704631	TMEM132A	12719	0.587232
chr11	60704554	60719257	SLC15A3	14703	0.524859
chr11	60739112	60787848	CD6	48736	0.499343
chr11	60869929	60895323	CD5	25394	0.529298
chr11	60897727	60928916	VPS37C	31189	0.497323
chr11	60970983	60980350	PGA3	9367	0.531013
chr11	60989820	60999179	PGA4	9359	0.531253
chr11	61008643	61018929	PGA5	10286	0.520805
chr11	61025757	61062788	VWCE	37031	0.515217
chr11	61066918	61100684	DDB1	33766	0.457057
chr11	61100653	61116231	DAK	15578	0.549044
chr11	61116219	61124361	CYB561A3	8142	0.524073
chr11	61129472	61136975	TMEM138	7503	0.481008
chr11	61159831	61166335	TMEM216	6504	0.482472
chr11	61170119	61197383	CPSF7	27264	0.440361
chr11	61197596	61214239	SDHAF2	16643	0.450820
chr11	61248584	61258400	PPP1R32	9816	0.573248
chr11	61276067	61276129	MIR4488	62	0.822581
chr11	61276271	61278490	LRRC10B	2219	0.674178
chr11	61281187	61348344	SYT7	67157	0.570812
chr11	61305615	61309870	SYT7	4255	0.568508
chr11	61355965	61375018	BC040894	19053	0.540335
chr11	61382507	61406921	RPLP0P2	24414	0.511059
chr11	61447904	61514474	DAGLA	66570	0.575019
chr11	61520120	61555989	MYRF	35869	0.599320
chr11	61521500	61525136	DKFZP434K028	3636	0.610561
chr11	61556601	61560085	TMEM258	3484	0.511194
chr11	61559966	61560033	MIR611	67	0.597015
chr11	61560108	61564714	FEN1	4606	0.498046
chr11	61567096	61584529	FADS1	17433	0.518270
chr11	61582632	61582712	MIR1908	80	0.800000
chr11	61595712	61634825	FADS2	39113	0.527318
chr11	61640997	61659006	FADS3	18009	0.568660
chr11	61664767	61685081	RAB3IL1	20314	0.594467
chr11	61717355	61731066	BEST1	13711	0.533003
chr11	61731756	61735132	FTH1	3376	0.494372
chr11	61735553	61736962	BC132896	1409	0.538680
chr11	61891444	61920635	INCENP	29191	0.538796
chr11	61957709	61961009	SCGB1D1	3300	0.483030
chr11	61976139	61981411	SCGB2A1	5272	0.443096
chr11	62009723	62012280	SCGB1D2	2557	0.519359
chr11	62037629	62040628	SCGB2A2	2999	0.406469
chr11	62063753	62066536	SCGB1D4	2783	0.499820
chr11	62104773	62160887	ASRGL1	56114	0.441761
chr11	62186506	62190678	SCGB1A1	4172	0.494008
chr11	62283373	62314332	AHNAK	30959	0.527375
chr11	62327072	62341460	EEF1G	14388	0.476925
chr11	62342516	62359109	TUT1	16593	0.487013
chr11	62360674	62369312	MTA2	8638	0.523964
chr11	62369690	62380237	EML3	10547	0.578269
chr11	62380212	62382592	ROM1	2380	0.611765
chr11	62382767	62389647	B3GAT3	6880	0.539535
chr11	62392297	62414198	GANAB	21901	0.500160
chr11	62414319	62420774	INTS5	6455	0.546088
chr11	62430288	62439241	C11orf48	8953	0.516922
chr11	62432778	62435954	METTL12	3176	0.527708
chr11	62432778	62434923	METTL12	2145	0.552448
chr11	62432893	62433042	SNORA57	149	0.637584
chr11	62439125	62441162	C11orf83	2037	0.555719
chr11	62443971	62446527	UBXN1	2556	0.526995
chr11	62453873	62457371	LRRN4CL	3498	0.537450
chr11	62457733	62475179	BSCL2	17446	0.506362
chr11	62475065	62476678	GNG3	1613	0.557967
chr11	62480096	62494857	HNRNPUL2	14761	0.461215
chr11	62495951	62506108	TTC9C	10157	0.468347
chr11	62518434	62521656	ZBTB3	3222	0.549348
chr11	62529010	62534187	POLR2G	5177	0.505698
chr11	62538774	62554813	TAF6L	16039	0.517613
chr11	62554873	62557872	TMEM179B	2999	0.528176
chr11	62557786	62559486	TMEM223	1700	0.561176
chr11	62559597	62572964	NXF1	13367	0.497045
chr11	62574331	62599563	STX5	25232	0.470593
chr11	62600382	62607628	WDR74	7246	0.512559
chr11	62619459	62623357	SNHG1	3898	0.417394
chr11	62621134	62621204	SNORD30	70	0.414286
chr11	62621632	62621757	SNORD22	125	0.456000
chr11	62622092	62622167	SNORD28	75	0.360000
chr11	62623483	62656355	SLC3A2	32872	0.483056
chr11	62676150	62689012	CHRM1	12862	0.536931
chr11	62744068	62752495	SLC22A6	8427	0.536846
chr11	62760295	62783317	SLC22A8	23022	0.508166
chr11	62847411	62911693	SLC22A24	64282	0.392552
chr11	62931295	62997124	SLC22A25	65829	0.395677
chr11	63057429	63079246	SLC22A10	21817	0.374708
chr11	63137260	63177712	SLC22A9	40452	0.376323
chr11	63228875	63258680	HRASLS5	29805	0.402684
chr11	63273523	63284246	LGALS12	10723	0.522801
chr11	63304272	63313930	RARRES3	9658	0.485194
chr11	63320241	63330855	HRASLS2	10614	0.478613
chr11	63341943	63381941	PLA2G16	39998	0.459573
chr11	63391555	63395325	DQ593252	3770	0.357294
chr11	63396436	63439083	ATL3	42647	0.429456
chr11	63448921	63527363	RTN3	78442	0.421190
chr11	63527363	63536113	C11orf95	8750	0.610971
chr11	63580922	63595190	C11orf84	14268	0.527965
chr11	63606399	63678492	MARK2	72093	0.496484
chr11	63678692	63684316	RCOR2	5624	0.607575
chr11	63706441	63724446	NAA40	18005	0.506970
chr11	63742078	63744015	COX8A	1937	0.569954
chr11	63753324	63765892	OTUB1	12568	0.563892
chr11	63766029	63933585	MACROD1	167556	0.580612
chr11	63871361	63886645	FLRT1	15284	0.554436
chr11	63953586	63972020	STIP1	18434	0.494304
chr11	63974151	63991363	FERMT3	17212	0.561585
chr11	63991270	63993341	TRPT1	2071	0.588122
chr11	63993729	63997488	NUDT22	3759	0.577015
chr11	63996624	63998760	AX747192	2136	0.608146
chr11	63997752	64001753	DNAJC4	4001	0.582104
chr11	64002055	64006736	VEGFB	4681	0.600085
chr11	64008412	64011607	FKBP2	3195	0.638811
chr11	64011950	64014413	PPP1R14B	2463	0.655298
chr11	64018994	64036924	PLCB3	17930	0.604239
chr11	64037299	64052176	BAD	14877	0.539222
chr11	64051810	64056972	GPR137	5162	0.643936
chr11	64058792	64067903	KCNK4	9111	0.585007
chr11	64058792	64067903	KCNK4	9111	0.585007
chr11	64066817	64072239	TEX40	5422	0.581704
chr11	64073043	64084210	ESRRA	11167	0.570699
chr11	64084164	64085033	TRMT112	869	0.581128
chr11	64085559	64089295	PRDX5	3736	0.574946
chr11	64107689	64125006	CCDC88B	17317	0.616331
chr11	64126624	64139687	RPS6KA4	13063	0.569854
chr11	64136073	64136175	MIR1237	102	0.774510
chr11	64187862	64188529	BC038767	667	0.419790
chr11	64216528	64219128	LOC100996455	2600	0.543462
chr11	64323097	64338999	SLC22A11	15902	0.567727
chr11	64358281	64369825	SLC22A12	11544	0.586019
chr11	64373645	64490660	NRXN2	117015	0.545255
chr11	64494382	64512329	RASGRP2	17947	0.549674
chr11	64509481	64512061	RASGRP2	2580	0.675969
chr11	64513860	64528187	PYGM	14327	0.570741
chr11	64532075	64545938	SF1	13863	0.488206
chr11	64556608	64570713	MAP4K2	14105	0.590571
chr11	64570985	64578188	MEN1	7203	0.583923
chr11	64591661	64612041	CDC42BPG	20380	0.611776
chr11	64620207	64646191	EHD1	25984	0.558459
chr11	64655933	64660921	AB429224	4988	0.584603
chr11	64658608	64658718	MIR192	110	0.572727
chr11	64658826	64658911	MIR194-2	85	0.623529
chr11	64658875	64658897	DM119532	22	0.454545
chr11	64662003	64684722	ATG2A	22719	0.603592
chr11	64692142	64701950	PPP2R5B	9808	0.563825
chr11	64701942	64703360	GPHA2	1418	0.576869
chr11	64705928	64727607	C11orf85	21679	0.443378
chr11	64755416	64764517	BATF2	9101	0.531150
chr11	64755417	64757986	BATF2	2569	0.576100
chr11	64794789	64808044	ARL2-SNX15	13255	0.513316
chr11	64781584	64789657	ARL2	8073	0.553326
chr11	64808375	64812300	SAC3D1	3925	0.585732
chr11	64812294	64826009	NAALADL1	13715	0.543784
chr11	64834080	64835205	AB231703	1125	0.596444
chr11	64844926	64851615	CDCA5	6689	0.520108
chr11	64851693	64855874	ZFPL1	4181	0.561588
chr11	64855843	64856542	LOC100130348	699	0.573677
chr11	64863586	64879332	VPS51	15746	0.515178
chr11	64879325	64883707	TM7SF2	4382	0.603606
chr11	64883874	64885170	ZNHIT2	1296	0.682099
chr11	64883874	64885170	BC104003	1296	0.682099
chr11	64888098	64889672	FAU	1574	0.536849
chr11	64889715	64894841	MRPL49	5126	0.508194
chr11	64894750	64902003	SYVN1	7253	0.574383
chr11	64937706	64940688	SPDYC	2982	0.566063
chr11	64948685	64979477	CAPN1	30792	0.510035
chr11	64981310	65010228	SLC22A20	28918	0.508265
chr11	64981310	64993511	SLC22A20	12201	0.536923
chr11	65029431	65065088	POLA2	35657	0.461733
chr11	65082288	65089900	CDC42EP2	7612	0.562401
chr11	65101224	65120451	DPF2	19227	0.488844
chr11	65122281	65125082	TIGD3	2801	0.631203
chr11	65142662	65150142	SLC25A45	7480	0.594652
chr11	65154040	65180995	FRMD8	26955	0.562975
chr11	65190268	65212028	NEAT1	21760	0.435156
chr11	65265232	65273939	MALAT1	8707	0.403468
chr11	65282807	65282828	MIR548AR	21	0.285714
chr11	65292547	65306182	SCYL1	13635	0.575944
chr11	65306029	65325699	LTBP3	19670	0.598932
chr11	65318325	65318368	U7	43	0.395349
chr11	65336690	65337884	SSSCA1-AS1	1194	0.588777
chr11	65337942	65339239	SSSCA1	1297	0.592907
chr11	65339819	65341669	FAM89B	1850	0.642162
chr11	65343508	65360116	EHBP1L1	16608	0.606154
chr11	65360325	65363467	KCNK7	3142	0.604074
chr11	65365225	65381720	MAP3K11	16495	0.571992
chr11	65383782	65404910	PCNXL3	21128	0.600909
chr11	65403780	65403840	MIR4690	60	0.700000
chr11	65405577	65418391	SIPA1	12814	0.607305
chr11	65416662	65416724	MIR4489	62	0.661290
chr11	65421009	65421041	DQ587981	32	0.500000
chr11	65421066	65430443	RELA	9377	0.553162
chr11	65479472	65487077	KAT5	7605	0.551611
chr11	65485143	65488409	RNASEH2C	3266	0.589406
chr11	65541368	65548062	AP5B1	6694	0.584404
chr11	65554504	65564690	OVOL1	10186	0.601217
chr11	65601409	65621172	SNX32	19763	0.487021
chr11	65622284	65626101	CFL1	3817	0.600734
chr11	65627871	65633914	MUS81	6043	0.596558
chr11	65633911	65640405	EFEMP2	6494	0.603788
chr11	65647283	65651212	CTSW	3929	0.591245
chr11	65651210	65656010	FIBP	4800	0.551042
chr11	65657874	65659106	CCDC85B	1232	0.708604
chr11	65659691	65667997	FOSL1	8306	0.556706
chr11	65684282	65686531	C11orf68	2249	0.615829
chr11	65686727	65689048	DRAP1	2321	0.655321
chr11	65713114	65727434	TSGA10IP	14320	0.514874
chr11	65729159	65747607	SART1	18448	0.552255
chr11	65764015	65769637	EIF1AD	5622	0.485059
chr11	65769549	65771617	BANF1	2068	0.581721
chr11	65779461	65780976	CST6	1515	0.615182
chr11	65784222	65793988	CATSPER1	9766	0.566865
chr11	65801869	65803659	AX746604	1790	0.541899
chr11	65808235	65816651	GAL3ST3	8416	0.560005
chr11	65819815	65836382	SF3B2	16567	0.473351
chr11	65837823	66012218	PACS1	174395	0.439720
chr11	66025173	66035332	KLC2	10159	0.601634
chr11	66036055	66044963	RAB1B	8908	0.555456
chr11	66037719	66045996	AK125412	8277	0.575571
chr11	66045671	66051685	CNIH2	6014	0.616063
chr11	66052050	66056638	YIF1A	4588	0.589146
chr11	66059372	66064135	TMEM151A	4763	0.647071
chr11	66081957	66084515	CD248	2558	0.654027
chr11	66099541	66104000	RIN1	4459	0.642521
chr11	66104803	66112582	BRMS1	7779	0.558684
chr11	66112842	66115161	B3GNT1	2319	0.575679
chr11	66129991	66139291	SLC29A2	9300	0.576129
chr11	66135746	66138329	AX747485	2583	0.587689
chr11	66188474	66194177	NPAS4	5703	0.563212
chr11	66202549	66206310	MRPL11	3761	0.514757
chr11	66234335	66244808	PELI3	10473	0.560298
chr11	66247483	66277130	DPP3	29647	0.522582
chr11	66278118	66301084	BBS1	22966	0.498868
chr11	66306734	66313671	ZDHHC24	6937	0.554707
chr11	66313865	66330799	ACTN3	16934	0.564722
chr11	66330934	66336047	CTSF	5113	0.587522
chr11	66357639	66360554	CCDC87	2915	0.551973
chr11	66360689	66373490	CCS	12801	0.512147
chr11	66384052	66397397	RBM14	13345	0.497190
chr11	66432469	66445275	RBM4B	12806	0.436592
chr11	66452719	66488870	SPTBN2	36151	0.551658
chr11	66452722	66455550	SPTBN2	2828	0.605375
chr11	66496218	66496318	SPTBN2	100	0.550000
chr11	66512206	66610987	C11orf80	98781	0.426550
chr11	66610882	66614003	RCE1	3121	0.585389
chr11	66615996	66675340	PC	59344	0.551968
chr11	66624875	66627946	LRFN4	3071	0.681863
chr11	66742753	66744479	C11orf86	1726	0.599073
chr11	66790815	66818334	SYT12	27519	0.543879
chr11	66824288	66839488	RHOD	15200	0.556184
chr11	66886739	67025550	KDM2A	138811	0.429915
chr11	67033904	67054029	ADRBK1	20125	0.609789
chr11	67056761	67069955	ANKRD13D	13194	0.522131
chr11	67064098	67065527	AK057681	1429	0.447166
chr11	67070918	67080078	SSH3	9160	0.612555
chr11	67085309	67159158	LOC100130987	73849	0.513440
chr11	67118235	67121067	POLD4	2832	0.581568
chr11	67129884	67130179	7SK	295	0.515254
chr11	67131638	67141648	CLCF1	10010	0.600599
chr11	67159422	67165883	RAD9A	6461	0.590930
chr11	67165651	67169376	PPP1CA	3725	0.617450
chr11	67171383	67177561	TBC1D10C	6178	0.618971
chr11	67183148	67193078	CARNS1	9930	0.624169
chr11	67195934	67202879	RPS6KB2	6945	0.587761
chr11	67202980	67205153	PTPRCAP	2173	0.644731
chr11	67205517	67210983	CORO1B	5466	0.640322
chr11	67218771	67220200	GPR152	1429	0.657803
chr11	67222817	67229245	CABP4	6428	0.540448
chr11	67231818	67236748	TMEM134	4930	0.602028
chr11	67250504	67258579	AIP	8075	0.562229
chr11	67259238	67272843	PITPNM1	13605	0.623080
chr11	67273960	67276199	CDK2AP2	2239	0.623493
chr11	67286417	67290899	CABP2	4482	0.582552
chr11	67351065	67354124	GSTP1	3059	0.630925
chr11	67371523	67373482	C11orf72	1959	0.522205
chr11	67374322	67380012	NDUFV1	5690	0.559930
chr11	67380123	67381052	AK129926	929	0.609257
chr11	67387474	67387866	X15673	392	0.510204
chr11	67395409	67397408	NUDT8	1999	0.651826
chr11	67398773	67407031	TBX10	8258	0.554856
chr11	67410025	67418130	ACY3	8105	0.576681
chr11	67429632	67448685	ALDH3B2	19053	0.525744
chr11	67557563	67557592	DQ584669	29	0.586207
chr11	67559237	67572807	FAM86C2P	13570	0.529919
chr11	67653966	67658816	AK091996	4850	0.442062
chr11	67758574	67771593	UNC93B1	13019	0.584530
chr11	67777789	67796743	ALDH3B1	18954	0.585101
chr11	67798083	67804114	NDUFS8	6031	0.576521
chr11	67801363	67801448	MIR4691	85	0.623529
chr11	67806461	67818366	TCIRG1	11905	0.636623
chr11	67820325	67888858	CHKA	68533	0.440707
chr11	67826216	67828536	AX747648	2320	0.440086
chr11	67923506	67980784	SUV420H1	57278	0.421855
chr11	68028802	68039469	C11orf24	10667	0.520484
chr11	68080107	68216743	LRP5	136636	0.546137
chr11	68228185	68382801	PPP6R3	154616	0.418948
chr11	68451982	68458643	GAL	6661	0.558174
chr11	68474907	68518988	MTL5	44081	0.450716
chr11	68522350	68609399	CPT1A	87049	0.498053
chr11	68658745	68671303	MRPL21	12558	0.506928
chr11	68671318	68708069	IGHMBP2	36751	0.506408
chr11	68747489	68748455	MRGPRD	966	0.597309
chr11	68771861	68780850	MRGPRF	8989	0.600845
chr11	68779898	68785916	BC039516	6018	0.577933
chr11	68816349	68858072	TPCN2	41723	0.593270
chr11	68857483	68858409	BC064339	926	0.498920
chr11	69061621	69064754	MYEOV	3133	0.579955
chr11	69229074	69231600	AX746803	2526	0.568092
chr11	69240457	69244389	AK094674	3932	0.513988
chr11	69300328	69308311	KC136303	7983	0.590380
chr11	69455872	69469242	CCND1	13370	0.586088
chr11	69467843	69469178	AK294004	1335	0.521348
chr11	69480331	69490165	ORAOV1	9834	0.509457
chr11	69471713	69472853	BC133018	1140	0.615789
chr11	69513005	69519106	FGF19	6101	0.544829
chr11	69587796	69590171	FGF4	2375	0.664421
chr11	69624735	69634192	FGF3	9457	0.612139
chr11	69924407	70035652	ANO1	111245	0.547054
chr11	70049268	70053508	FADD	4240	0.549292
chr11	70116805	70230607	PPFIA1	113802	0.449966
chr11	70130060	70130176	MIR548K	116	0.344828
chr11	70219515	70244568	AK125463	25053	0.468926
chr11	70244611	70282690	CTTN	38079	0.527351
chr11	70313960	70935842	SHANK2	621882	0.517645
chr11	70318923	70507872	BC127192	188949	0.528296
chr11	70449407	70450961	BC131767	1554	0.570785
chr11	70477198	70481595	SHANK2-AS1	4397	0.492381
chr11	70708894	70711220	SHANK2-AS3	2326	0.524935
chr11	70718374	70718473	MIR3664	99	0.454545
chr11	71116791	71134400	FLJ42102	17609	0.469249
chr11	71145456	71159477	DHCR7	14021	0.537337
chr11	71164216	71212581	NADSYN1	48365	0.517771
chr11	71238312	71239210	KRTAP5-7	898	0.591314
chr11	71249070	71250253	KRTAP5-8	1183	0.595942
chr11	71259465	71260653	KRTAP5-9	1188	0.554714
chr11	71276608	71277666	KRTAP5-10	1058	0.619093
chr11	71292900	71293921	KRTAP5-11	1021	0.566112
chr11	71498556	71512280	FAM86C1	13724	0.529583
chr11	71521023	71524905	ALG1L9P	3882	0.466512
chr11	71506860	71524905	ALG1L9P	18045	0.485453
chr11	71544245	71548608	DEFB108B	4363	0.374971
chr11	71576554	71639493	LOC100133315	62939	0.428065
chr11	71589498	71595607	LOC100129216	6109	0.337535
chr11	71639767	71708643	RNF121	68876	0.426651
chr11	71709957	71713850	IL18BP	3893	0.559979
chr11	71713910	71791573	NUMA1	77663	0.465923
chr11	71783273	71783348	MIR3165	75	0.533333
chr11	71791376	71821828	LRTOMT	30452	0.488835
chr11	71791376	71807938	LRTOMT	16562	0.459063
chr11	71808337	71814433	LAMTOR1	6096	0.523294
chr11	71820632	71823822	ANAPC15	3190	0.516614
chr11	71846770	71850934	FOLR3	4164	0.525696
chr11	71900601	71907367	FOLR1	6766	0.506208
chr11	71927818	71932994	FOLR2	5176	0.490533
chr11	71935881	71950188	INPPL1	14307	0.576571
chr11	71950120	71955220	PHOX2A	5100	0.608039
chr11	72003469	72145724	CLPB	142255	0.459197
chr11	72281703	72284266	AL832797	2563	0.477565
chr11	72287183	72385497	PDE2A	98314	0.553543
chr11	72326106	72326174	MIR139	68	0.588235
chr11	72332809	72332871	U7	62	0.403226
chr11	72396113	72463434	ARAP1	67321	0.551537
chr11	72403729	72404520	BC150585	791	0.585335
chr11	72465773	72504750	STARD10	38977	0.543115
chr11	72494574	72494637	MIR4692	63	0.492063
chr11	72525450	72540680	ATG16L2	15230	0.575509
chr11	72547789	72853143	FCHSD2	305354	0.388477
chr11	72929342	72953472	P2RY2	24130	0.548156
chr11	72983186	73009670	P2RY6	26484	0.516576
chr11	73019662	73080425	ARHGEF17	60763	0.551586
chr11	73087404	73108519	RELT	21115	0.597395
chr11	73117027	73309228	FAM168A	192201	0.413421
chr11	73358593	73373864	PLEKHB1	15271	0.528322
chr11	73363484	73373864	PLEKHB1	10380	0.517919
chr11	73386682	73472201	RAB6A	85519	0.414048
chr11	73498916	73575656	MRPL48	76740	0.432760
chr11	73583712	73587890	COA4	4178	0.464098
chr11	73588013	73638781	PAAF1	50768	0.428085
chr11	73661363	73681332	DNAJB13	19969	0.504382
chr11	73685715	73693889	UCP2	8174	0.523856
chr11	73711325	73720282	UCP3	8957	0.524283
chr11	73745479	73882064	C2CD3	136585	0.392188
chr11	73882107	73965748	PPME1	83641	0.386617
chr11	73963458	73963597	SNORA7	139	0.561151
chr11	73977701	74022699	P4HA3	44998	0.419152
chr11	74022406	74035750	BC048427	13344	0.422212
chr11	74041360	74109502	PGM2L1	68142	0.374659
chr11	74165885	74178600	KCNE3	12715	0.480220
chr11	74202922	74204755	LIPT2	1833	0.566285
chr11	74204484	74209578	MGC12965	5094	0.402238
chr11	74303574	74354105	POLD3	50531	0.396845
chr11	74407473	74442186	CHRDL2	34713	0.513871
chr11	74431312	74431382	MIR4696	70	0.442857
chr11	74459912	74553458	RNF169	93546	0.394875
chr11	74551954	74660232	XRRA1	108278	0.425220
chr11	74660291	74690076	SPCS2	29785	0.392547
chr11	74699949	74718743	NEU3	18794	0.421890
chr11	74720516	74720547	DQ592682	31	0.419355
chr11	74721025	74721141	DQ583960	116	0.482759
chr11	74721820	74721858	DQ595000	38	0.473684
chr11	74721860	74721888	DQ591572	28	0.464286
chr11	74799795	74800758	OR2AT4	963	0.529595
chr11	74862031	74917445	SLCO2B1	55414	0.511640
chr11	74951949	74954749	TPBGL	2800	0.673929
chr11	74971165	75062875	ARRB1	91710	0.520696
chr11	75046135	75046230	MIR326	95	0.642105
chr11	75110534	75117957	RPS3	7423	0.452782
chr11	75111434	75111582	SNORD15A	148	0.472973
chr11	75115464	75115610	SNORD15B	146	0.479452
chr11	75133437	75141674	KLHL35	8237	0.546922
chr11	75145684	75236599	GDPD5	90915	0.533212
chr11	75273100	75283849	SERPINH1	10749	0.553912
chr11	75297962	75379479	MAP6	81517	0.443576
chr11	75428933	75442331	MOGAT2	13398	0.517764
chr11	75469499	75479692	LOC283214	10193	0.506622
chr11	75479777	75512581	DGAT2	32804	0.522467
chr11	75526211	75855282	UVRAG	329071	0.387467
chr11	75897369	75917574	WNT11	20205	0.559070
chr11	76061003	76091880	PRKRIR	30877	0.399067
chr11	76092356	76125663	AK125821	33307	0.436125
chr11	76156068	76262589	C11orf30	106521	0.377343
chr11	76368567	76381044	LRRC32	12477	0.556143
chr11	76391209	76432833	GUCY2EP	41624	0.522583
chr11	76493356	76509198	TSKU	15842	0.553718
chr11	76571916	76734850	ACER3	162934	0.387488
chr11	76745434	76753005	B3GNT6	7571	0.537049
chr11	76777991	76837198	CAPN5	59207	0.559613
chr11	76813885	76814377	OMP	492	0.630081
chr11	76839309	76926286	MYO7A	86977	0.550502
chr11	76927602	76998463	GDPD4	70861	0.395648
chr11	77033059	77185108	PAK1	152049	0.398076
chr11	77300679	77321401	AQP11	20722	0.417527
chr11	77327195	77348851	CLNS1A	21656	0.419376
chr11	77377273	77531880	RSF1	154607	0.391826
chr11	77532207	77583398	AAMDC	51191	0.420211
chr11	77589765	77705717	INTS4	115952	0.407315
chr11	77726760	77734320	KCTD14	7560	0.492196
chr11	77726760	77791265	NDUFC2-KCTD14	64505	0.478242
chr11	77774906	77779403	THRSP	4497	0.486102
chr11	77811987	77850699	ALG8	38712	0.421394
chr11	77850838	77885023	LOC100289388	34185	0.473541
chr11	77882297	77899664	KCTD21	17367	0.478839
chr11	77899857	77925757	USP35	25900	0.530116
chr11	77926335	78128868	GAB2	202533	0.416263
chr11	78147006	78285909	NARS2	138903	0.387731
chr11	78244221	78269593	BC042472	25372	0.392913
chr11	78364327	79151695	TENM4	787368	0.444304
chr11	78673187	78673398	ODZ4	211	0.601896
chr11	78804343	78808883	BC008359	4540	0.501982
chr11	79113065	79113153	MIR708	88	0.488636
chr11	79133212	79133270	MIR5579	58	0.465517
chr11	81590895	82114955	BC041900	524060	0.360774
chr11	81601782	81601878	MIR4300	96	0.427083
chr11	82443045	82444906	FAM181B	1861	0.666308
chr11	82535408	82611557	PRCP	76149	0.392257
chr11	82612736	82645699	C11orf82	32963	0.379698
chr11	82692477	82782884	RAB30	90407	0.417645
chr11	82752505	82752640	SNORA70E	135	0.496296
chr11	82783107	82784754	LOC100506233	1647	0.464481
chr11	82868136	82896835	PCF11	28699	0.380013
chr11	82903178	82904681	AK311356	1503	0.442448
chr11	82905290	82960013	ANKRD42	54723	0.391791
chr11	82972501	82997377	CCDC90B	24876	0.375261
chr11	82997170	83134559	BC070093	137389	0.410164
chr11	83166055	85338314	DLG2	2172259	0.370134
chr11	85339616	85347583	TMEM126B	7967	0.373039
chr11	85358962	85367597	TMEM126A	8635	0.378807
chr11	85368607	85376182	CREBZF	7575	0.385875
chr11	85394892	85397320	CCDC89	2428	0.424629
chr11	85405264	85437511	SYTL2	32247	0.373647
chr11	85566143	85631051	CCDC83	64908	0.399196
chr11	85668213	85780139	PICALM	111926	0.371379
chr11	85822164	85823166	BC016143	1002	0.634731
chr11	85955805	85989785	EED	33980	0.370659
chr11	86013252	86056985	C11orf73	43733	0.378616
chr11	86085777	86134151	CCDC81	48374	0.398809
chr11	86152149	86383240	ME3	231091	0.428338
chr11	86511490	86522273	PRSS23	10783	0.423352
chr11	86534418	86648861	AL832007	114443	0.421756
chr11	86567972	86568996	OR7E2P	1024	0.463867
chr11	86656716	86666440	FZD4	9724	0.454443
chr11	86666662	86711989	LOC100506368	45327	0.420698
chr11	86748885	87039876	TMEM135	290991	0.363705
chr11	87846414	87908635	RAB38	62221	0.384259
chr11	88026759	88070941	CTSC	44182	0.385836
chr11	88157548	88161279	BC038205	3731	0.393728
chr11	88237743	88257222	GRM5-AS1	19479	0.388521
chr11	88237743	88781240	GRM5	543497	0.361203
chr11	88911039	89028927	TYR	117888	0.352920
chr11	89057521	89224653	NOX4	167132	0.353176
chr11	89385713	89391901	AB231784	6188	0.359405
chr11	89392464	89431886	FOLH1B	39422	0.355563
chr11	89443466	89451040	TRIM77	7574	0.372987
chr11	89530822	89541743	TRIM49	10921	0.370662
chr11	89553492	89559667	LOC642414	6175	0.402753
chr11	89575164	89584136	TRIM53AP	8972	0.368368
chr11	89603605	89609185	TRIM64B	5580	0.392294
chr11	89644578	89653576	TRIM49D2P	8998	0.374639
chr11	89657231	89666229	TRIM49D2P	8998	0.374639
chr11	89673687	89673722	MIR5692A1	35	0.285714
chr11	89701671	89707240	TRIM64	5569	0.390555
chr11	89726708	89735676	TRIM53AP	8968	0.367975
chr11	89751201	89757434	LOC642414	6233	0.402054
chr11	89764273	89775193	TRIM49C	10920	0.370330
chr11	89794201	89796159	LOC440061	1958	0.389683
chr11	89819117	89820299	UBTFL1	1182	0.443316
chr11	89867817	89925779	NAALAD2	57962	0.348590
chr11	89933596	89956532	CHORDC1	22936	0.357386
chr11	90224886	90596750	HP11113	371864	0.347885
chr11	90288941	90289025	MIR4490	84	0.380952
chr11	92085261	92629635	FAT3	544374	0.398099
chr11	92702788	92715948	MTNR1B	13160	0.471960
chr11	92877340	92879656	AK093898	2316	0.309585
chr11	92880849	92931095	SLC36A4	50246	0.352187
chr11	93063882	93171636	CCDC67	107754	0.371986
chr11	93211638	93276546	SMCO4	64908	0.451393
chr11	93394815	93463522	KIAA1731	68707	0.385812
chr11	93454679	93455032	SCARNA9	353	0.399433
chr11	93463446	93469014	TAF1D	5568	0.358836
chr11	93463680	93465665	SNORA8	1985	0.346599
chr11	93466393	93466466	SNORD5	73	0.356164
chr11	93466631	93466763	SNORA18	132	0.446970
chr11	93466839	93466930	MIR1304	91	0.527473
chr11	93468275	93468402	SNORA40	127	0.322835
chr11	93469095	93474703	TAF1D	5608	0.380171
chr11	93474792	93496247	C11orf54	21455	0.408529
chr11	93517404	93546496	MED17	29092	0.398426
chr11	93553734	93583668	VSTM5	29934	0.460947
chr11	93754377	93847374	HEPHL1	92997	0.398550
chr11	93800139	93862566	AF086184	62427	0.409839
chr11	93862093	93915137	PANX1	53044	0.431057
chr11	94038802	94040858	FOLR4	2056	0.537451
chr11	94110476	94134585	GPR83	24109	0.449749
chr11	94150468	94227040	MRE11A	76572	0.371898
chr11	94227152	94232744	ANKRD49	5592	0.364270
chr11	94245694	94265289	LOC643037	19595	0.404542
chr11	94277016	94283064	FUT4	6048	0.491402
chr11	94300473	94354587	PIWIL4	54114	0.396053
chr11	94501507	94609918	AMOTL1	108411	0.421590
chr11	94695786	94706776	CWC15	10990	0.374067
chr11	94706844	94732676	KDM4D	25832	0.363038
chr11	94758421	94760760	KDM4E	2339	0.505772
chr11	94800055	94804388	SRSF8	4333	0.450265
chr11	94822973	94865815	ENDOD1	42842	0.426894
chr11	94883702	94892312	AK055250	8610	0.476074
chr11	94898676	94964246	SESN3	65570	0.348269
chr11	95502105	95522954	FAM76B	20849	0.339441
chr11	95523624	95565857	CEP57	42233	0.375086
chr11	95566043	95657371	MTMR2	91328	0.365145
chr11	95711439	96076344	MAML2	364905	0.400795
chr11	96074601	96074690	MIR1260B	89	0.561798
chr11	96085928	96123083	CCDC82	37155	0.347033
chr11	96123157	96126727	JRKL	3570	0.385154
chr11	96176445	96240041	JRKL-AS1	63596	0.398594
chr11	98891705	100229616	CNTN5	1337911	0.350367
chr11	100554892	100558686	AK124326	3794	0.470743
chr11	100558406	100861656	ARHGAP42	303250	0.380267
chr11	100862810	100864666	TMEM133	1856	0.370690
chr11	100900354	101000544	PGR	100190	0.377223
chr11	100999807	101069639	LOC101054525	69832	0.365577
chr11	101322294	101454659	TRPC6	132365	0.372055
chr11	101390550	101390636	MIR3920	86	0.430233
chr11	101761404	101787253	ANGPTL5	25849	0.369802
chr11	101785745	101871793	KIAA1377	86048	0.364134
chr11	101918168	101955291	C11orf70	37123	0.399779
chr11	101978616	101980568	BC040646	1952	0.411373
chr11	101981191	102104154	YAP1	122963	0.386336
chr11	102184452	102184560	U6	108	0.435185
chr11	102188180	102210135	BIRC3	21955	0.375951
chr11	102217912	102249401	BIRC2	31489	0.388961
chr11	102267055	102323775	TMEM123	56720	0.402504
chr11	102391238	102401478	MMP7	10240	0.375391
chr11	102447565	102496063	MMP20	48498	0.396470
chr11	102562414	102576468	MMP27	14054	0.393340
chr11	102582525	102595685	MMP8	13160	0.388450
chr11	102622853	102624183	AB231724	1330	0.389474
chr11	102641232	102651359	MMP10	10127	0.361015
chr11	102654406	102707497	WTAPP1	53091	0.399258
chr11	102660640	102668966	MMP1	8326	0.397910
chr11	102706527	102714342	MMP3	7815	0.380294
chr11	102707729	102707752	DD413629	23	0.521739
chr11	102733463	102745764	MMP12	12301	0.384115
chr11	102813720	102826463	MMP13	12743	0.364357
chr11	102921412	102962944	DCUN1D5	41532	0.356159
chr11	102980159	103350591	DYNC2H1	370432	0.351006
chr11	103720633	103720708	MIR4693	75	0.293333
chr11	103777913	104035027	PDGFD	257114	0.370948
chr11	103907307	103909922	DDI1	2615	0.484895
chr11	104756444	104769397	CASP12	12953	0.372115
chr11	104772275	104788902	LOC643733	16627	0.359897
chr11	104813593	104839325	CASP4	25732	0.373582
chr11	104864966	104893895	CASP5	28929	0.371980
chr11	104896236	104905884	CASP1	9648	0.369196
chr11	104936887	104941419	AB231723	4532	0.370035
chr11	104963195	104972158	CARD17	8963	0.371751
chr11	105008447	105010461	CARD18	2014	0.399702
chr11	105480799	105852819	GRIA4	372020	0.353158
chr11	105845552	105845658	U6	106	0.367925
chr11	105878628	105892954	MSANTD4	14326	0.373447
chr11	105921824	105948465	KBTBD3	26641	0.363237
chr11	105948291	105969419	AASDHPPT	21128	0.355973
chr11	106120745	106133959	BC034795	13214	0.386181
chr11	106544737	106889171	GUCY1A2	344434	0.360171
chr11	107197071	107328572	CWF19L2	131501	0.363047
chr11	107373452	107436461	ALKBH8	63009	0.361774
chr11	107461816	107537505	ELMOD1	75689	0.389832
chr11	107462470	107463949	LOC643923	1479	0.484787
chr11	107578100	107582787	SLN	4687	0.391935
chr11	107661716	107729914	SLC35F2	68198	0.427945
chr11	107799276	107834208	RAB39A	34932	0.428347
chr11	107879407	107978488	CUL5	99081	0.394092
chr11	107992257	108018891	ACAT1	26634	0.424457
chr11	108028118	108093365	NPAT	65247	0.403068
chr11	108093558	108239826	ATM	146268	0.374662
chr11	108253726	108338258	C11orf65	84532	0.400097
chr11	108342832	108369159	KDELC2	26327	0.412124
chr11	108376157	108464374	EXPH5	88217	0.413968
chr11	108535815	108811648	DDX10	275833	0.374067
chr11	109292845	109299893	C11orf87	7048	0.446226
chr11	109964086	110042566	ZC3H12C	78480	0.372503
chr11	110045604	110167437	RDX	121833	0.399539
chr11	110199129	110278336	AK124179	79207	0.421263
chr11	110223966	110224016	SnoR4	50	0.260000
chr11	110300660	110335608	FDX1	34948	0.397734
chr11	110447758	110583451	ARHGAP20	135693	0.366592
chr11	111126706	111156972	C11orf53	30266	0.414591
chr11	111164113	111170539	C11orf92	6426	0.499533
chr11	111169270	111179460	C11orf93	10190	0.452404
chr11	111218481	111218547	MIR4491	66	0.439394
chr11	111222980	111250157	POU2AF1	27177	0.465062
chr11	111255461	111305769	BC022056	50308	0.444641
chr11	111284966	111288911	LOC100132078	3945	0.493536
chr11	111322063	111327330	AB231705	5267	0.529713
chr11	111338255	111383079	BTG4	44824	0.371520
chr11	111381326	111384613	BC021736	3287	0.471555
chr11	111385509	111407756	C11orf88	22247	0.369218
chr11	111411232	111432470	LAYN	21238	0.441049
chr11	111473169	111597632	SIK2	124463	0.393675
chr11	111597214	111597245	DQ599327	31	0.451613
chr11	111597625	111601577	LOH11CR1I	3952	0.480010
chr11	111597631	111637169	PPP2R1B	39538	0.445850
chr11	111652918	111742305	ALG9	89387	0.406871
chr11	111744779	111750181	FDXACB1	5402	0.442614
chr11	111749947	111754797	C11orf1	4850	0.425155
chr11	111779349	111782473	CRYAB	3124	0.460627
chr11	111783459	111797595	HSPB2-C11orf52	14136	0.458121
chr11	111783459	111784817	HSPB2	1358	0.610457
chr11	111848032	111893307	DIXDC1	45275	0.419812
chr11	111895537	111935002	DLAT	39465	0.413176
chr11	111938522	111944895	PIH1D2	6373	0.410952
chr11	111944967	111955874	C11orf57	10907	0.405703
chr11	111955538	111957522	TIMM8B	1984	0.465726
chr11	111957547	111966525	SDHD	8978	0.421920
chr11	112013973	112034840	IL18	20867	0.392342
chr11	112038094	112043279	TEX12	5185	0.368370
chr11	112046207	112089649	BCO2	43442	0.394526
chr11	112097087	112104695	PTS	7608	0.409437
chr11	112118875	112131583	C11orf34	12708	0.447828
chr11	112830002	112834134	AL833634	4132	0.527348
chr11	112831968	113149158	NCAM1	317190	0.417059
chr11	112848074	112848142	U7	68	0.294118
chr11	113140253	113144623	LOC100288346	4370	0.555149
chr11	113185250	113237114	TTC12	51864	0.426249
chr11	113258512	113271140	ANKK1	12628	0.509265
chr11	113280316	113346001	DRD2	65685	0.481997
chr11	113320744	113320810	MIR4301	66	0.560606
chr11	113558267	113577068	TMPRSS5	18801	0.494920
chr11	113603904	113644485	ZW10	40581	0.390996
chr11	113650517	113651207	CLDN25	690	0.560870
chr11	113659952	113661882	DL492607	1930	0.561140
chr11	113668596	113746256	USP28	77660	0.414345
chr11	113775517	113817283	HTR3B	41766	0.425681
chr11	113845796	113861034	HTR3A	15238	0.505709
chr11	113931287	114121397	ZBTB16	190110	0.473384
chr11	114166534	114183238	NNMT	16704	0.399126
chr11	114262169	114271272	C11orf71	9103	0.395035
chr11	114271383	114279635	RBM7	8252	0.364881
chr11	114310107	114321000	REXO2	10893	0.396126
chr11	114392436	114430580	NXPE1	38144	0.374528
chr11	114441312	114466484	NXPE4	25172	0.392698
chr11	114549199	114577652	NXPE2	28453	0.379714
chr11	114578109	114579042	FAM55B	933	0.390139
chr11	115044344	115375241	CADM1	330897	0.384059
chr11	115626050	115630918	LINC00900	4868	0.498973
chr11	116618885	116643714	BUD13	24829	0.415804
chr11	116649275	116658739	ZNF259	9464	0.449493
chr11	116660085	116663136	APOA5	3051	0.602425
chr11	116691417	116694011	APOA4	2594	0.577101
chr11	116700623	116703787	APOC3	3164	0.560999
chr11	116706468	116708338	APOA1	1870	0.626738
chr11	116714117	116968993	SIK3	254876	0.404585
chr11	116941480	116942325	BC042385	845	0.429586
chr11	117007261	117008585	AB231710	1324	0.533988
chr11	117014999	117041761	PAFAH1B2	26762	0.427098
chr11	117049938	117068161	SIDT2	18223	0.555946
chr11	117066328	117072630	LOC100652768	6302	0.584576
chr11	117070039	117075508	TAGLN	5469	0.578899
chr11	117075787	117102811	PCSK7	27024	0.504885
chr11	117103340	117156404	RNF214	53064	0.430216
chr11	117156401	117186972	BACE1	30571	0.496614
chr11	117158613	117158647	DQ582443	34	0.470588
chr11	117161203	117162529	BACE1	1326	0.506787
chr11	117161614	117164192	AB488780	2578	0.460434
chr11	117198570	117283982	CEP164	85412	0.480986
chr11	117298488	117667976	DSCAML1	369488	0.500950
chr11	117690789	117747746	FXYD6-FXYD2	56957	0.500290
chr11	117771355	117800168	TMPRSS13	28813	0.521744
chr11	117857105	117872199	IL10RA	15094	0.492249
chr11	117886486	117957508	TMPRSS4-AS1	71022	0.465138
chr11	117947726	117990556	TMPRSS4	42830	0.490777
chr11	118004091	118023630	SCN4B	19539	0.526639
chr11	118033518	118047337	SCN2B	13819	0.534843
chr11	118064441	118095809	AMICA1	31368	0.441023
chr11	118097408	118099840	AK289390	2432	0.402549
chr11	118100335	118123011	MPZL3	22676	0.411272
chr11	118124130	118135251	MPZL2	11121	0.388185
chr11	118175294	118186890	CD3E	11596	0.440755
chr11	118209788	118213459	CD3D	3671	0.502860
chr11	118215058	118224497	CD3G	9439	0.436063
chr11	118230295	118269926	UBE4A	39631	0.405440
chr11	118251934	118289530	LOC100131626	37596	0.408075
chr11	118272103	118280562	ATP5L	8459	0.410096
chr11	118303855	118305920	MGC13053	2065	0.495884
chr11	118307204	118397539	KMT2A	90335	0.412520
chr11	118398209	118401740	TTC36	3531	0.529029
chr11	118401802	118406550	TMEM25	4748	0.581087
chr11	118415242	118436791	IFT46	21549	0.447817
chr11	118443101	118473747	ARCN1	30646	0.423318
chr11	118478305	118528748	PHLDB1	50443	0.543068
chr11	118528941	118550381	TREH	21440	0.491931
chr11	118618472	118661657	DDX6	43185	0.413871
chr11	118754474	118766980	CXCR5	12506	0.536942
chr11	118766850	118781613	BCL9L	14763	0.591072
chr11	118781416	118781496	MIR4492	80	0.762500
chr11	118827007	118829269	UPK2	2262	0.599027
chr11	118842416	118851995	FOXR1	9579	0.493058
chr11	118868851	118886455	CCDC84	17604	0.459157
chr11	118873670	118874303	RPL23AP64	633	0.475513
chr11	118886421	118889057	RPS25	2636	0.460167
chr11	118889240	118894385	TRAPPC4	5145	0.495044
chr11	118895060	118901616	SLC37A4	6556	0.564979
chr11	118914895	118927925	HYOU1	13030	0.539754
chr11	118938492	118952688	VPS11	14196	0.487884
chr11	118955586	118964259	HMBS	8673	0.508705
chr11	118964584	118966177	H2AFX	1593	0.668550
chr11	118967212	118972785	DPAGT1	5573	0.488426
chr11	118978092	118987827	C2CD2L	9735	0.555008
chr11	118992232	119005765	HINFP	13533	0.480529
chr11	119019749	119033374	ABCG4	13625	0.544367
chr11	119039439	119054725	NLRX1	15286	0.536766
chr11	119056165	119060932	PDZD3	4767	0.577722
chr11	119060962	119066710	CCDC153	5748	0.516875
chr11	119076985	119178859	CBL	101874	0.414355
chr11	119179233	119187840	MCAM	8607	0.579064
chr11	119205209	119208024	RNF26	2815	0.592185
chr11	119209651	119217383	MFRP	7732	0.612002
chr11	119212031	119217383	MFRP	5352	0.588191
chr11	119225924	119252436	USP2	26512	0.546356
chr11	119252487	119369944	LOC100499227	117457	0.468171
chr11	119288654	119294246	THY1	5592	0.569564
chr11	119531702	119599435	PVRL1	67733	0.549230
chr11	119981993	120008863	TRIM29	26870	0.550651
chr11	120081746	120100650	OAF	18904	0.556443
chr11	120107348	120190653	POU2F3	83305	0.480739
chr11	120120467	120136641	LOC649133	16174	0.487016
chr11	120195837	120204388	TMEM136	8551	0.434803
chr11	120207617	120360645	ARHGEF12	153028	0.373938
chr11	120530977	120856969	GRIK4	325992	0.470916
chr11	120894812	120960354	TBCEL	65542	0.366238
chr11	120973374	121061515	TECTA	88141	0.441985
chr11	121163387	121184119	SC5D	20732	0.382935
chr11	121318039	121323722	AK091275	5683	0.499736
chr11	121322911	121504471	SORL1	181560	0.435597
chr11	121959813	121972874	AK123947	13061	0.376694
chr11	121966607	121969061	AK021804	2454	0.359821
chr11	121970464	121970552	MIR125B1	88	0.534091
chr11	121970516	121970538	DM119543	22	0.500000
chr11	121986061	121986923	BLID	862	0.402552
chr11	122017229	122017301	MIRLET7A2	72	0.402778
chr11	122017275	122017297	DM119500	22	0.363636
chr11	122022936	122023016	MIR100	80	0.462500
chr11	122319917	122320039	U4atac	122	0.409836
chr11	122526397	122685187	UBASH3B	158790	0.458379
chr11	122596915	122597019	SnoU13	104	0.432692
chr11	122709254	122743347	CRTAM	34093	0.409527
chr11	122753235	122830430	C11orf63	77195	0.405221
chr11	122848356	122852379	BSX	4023	0.533681
chr11	122888273	122890319	LOC341056	2046	0.519062
chr11	122928199	122932901	HSPA8	4702	0.458103
chr11	122943032	123066007	CLMP	122975	0.451262
chr11	123252147	123252220	MIR4493	73	0.534247
chr11	123396527	123493518	GRAMD1B	96991	0.479364
chr11	123496110	123498476	KIAA1201	2366	0.505495
chr11	123499894	123525315	SCN3B	25421	0.455057
chr11	123594996	123612363	ZNF202	17367	0.445327
chr11	123624287	123625226	OR6X1	939	0.470714
chr11	123676115	123677057	OR6M1	942	0.467091
chr11	123753632	123756340	TMEM225	2708	0.420606
chr11	123777138	123778083	OR8D4	945	0.416931
chr11	123810323	123811280	OR4D5	957	0.492163
chr11	123813573	123814545	OR6T1	972	0.520576
chr11	123847402	123848398	OR10S1	996	0.554217
chr11	123886281	123887217	OR10G4	936	0.539530
chr11	123893719	123894655	OR10G9	936	0.538462
chr11	123900329	123901265	OR10G8	936	0.538462
chr11	123908772	123909708	OR10G7	936	0.548077
chr11	123986110	124017618	VWA5A	31508	0.392916
chr11	124029124	124029838	OLFR959	714	0.521008
chr11	124055974	124056912	OR10D3	938	0.489339
chr11	124095397	124096312	OR8G2	915	0.468852
chr11	124120422	124135763	OR8G1	15341	0.348413
chr11	124179735	124180662	OR8D1	927	0.473571
chr11	124189157	124190093	OR8D2	936	0.435897
chr11	124252297	124253239	OR8B2	942	0.419321
chr11	124266305	124267247	OR8B3	942	0.411890
chr11	124293837	124294767	OR8B4	930	0.456989
chr11	124310045	124310981	OR8B8	936	0.472222
chr11	124412617	124413550	OR8B12	933	0.470525
chr11	124439964	124440945	OR8A1	981	0.493374
chr11	124481452	124490251	PANX3	8799	0.464371
chr11	124492741	124505822	TBRG1	13081	0.396988
chr11	124505684	124543777	SIAE	38093	0.427716
chr11	124543739	124564687	SPA17	20948	0.373067
chr11	124609828	124617102	NRGN	7274	0.531070
chr11	124617369	124622109	VSIG2	4740	0.535865
chr11	124623018	124632223	ESAM	9205	0.543183
chr11	124636393	124670299	MSANTD2	33906	0.398189
chr11	124670345	124704383	BC036195	34038	0.434162
chr11	124735304	124751370	ROBO3	16066	0.563052
chr11	124754113	124767831	ROBO4	13718	0.532658
chr11	124789145	124806308	HEPACAM	17163	0.468450
chr11	124789145	124790573	HEPN1	1428	0.512605
chr11	124824016	124911385	CCDC15	87369	0.375740
chr11	124933012	124960412	SLC37A2	27400	0.528577
chr11	124964265	124981604	TMEM218	17339	0.407232
chr11	124964265	124981604	TMEM218	17339	0.407232
chr11	125034558	125303285	PKNOX2	268727	0.490353
chr11	125315640	125366206	FEZ1	50566	0.431832
chr11	125365109	125368166	MGC39545	3057	0.548904
chr11	125439297	125454575	EI24	15278	0.431405
chr11	125462738	125491280	STT3A	28542	0.404702
chr11	125496250	125527042	CHEK1	30792	0.372434
chr11	125542228	125550793	ACRV1	8565	0.422767
chr11	125616187	125619743	PATE1	3556	0.447132
chr11	125646027	125648714	PATE2	2687	0.436546
chr11	125658005	125661495	PATE3	3490	0.421777
chr11	125703210	125709967	PATE4	6757	0.403137
chr11	125753508	125770541	HYLS1	17033	0.413374
chr11	125763379	125773116	PUS3	9737	0.402383
chr11	125774260	125793006	DDX25	18746	0.428945
chr11	125821686	125826214	BC043578	4528	0.541961
chr11	125826712	125933187	CDON	106475	0.398216
chr11	126071988	126081587	RPUSD4	9599	0.433483
chr11	126081618	126132879	FAM118B	51261	0.417823
chr11	126084154	126084373	U4	219	0.420091
chr11	126132813	126138877	SRPR	6064	0.490270
chr11	126138934	126148027	FOXRED1	9093	0.510723
chr11	126152981	126163071	TIRAP	10090	0.481467
chr11	126173646	126215644	DCPS	41998	0.494190
chr11	126211611	126225482	ST3GAL4-AS1	13871	0.507534
chr11	126225539	126284536	ST3GAL4	58997	0.518433
chr11	126293395	126870766	KIRREL3	577371	0.468020
chr11	126522696	126551995	DJ031150	29299	0.440425
chr11	126810641	126814986	KIRREL3-AS2	4345	0.461910
chr11	126858353	126858438	MIR3167	85	0.435294
chr11	126872804	126875953	KIRREL3-AS3	3149	0.540172
chr11	126936896	126971201	AK095187	34305	0.422708
chr11	127140961	127206928	BC030092	65967	0.370049
chr11	127275922	127276227	7SK	305	0.478689
chr11	128328655	128457453	ETS1	128798	0.425022
chr11	128396036	128400278	BC043517	4242	0.413956
chr11	128551134	128556814	AX747861	5680	0.488204
chr11	128563810	128683162	FLI1	119352	0.458409
chr11	128561566	128565918	FLI1-AS1	4352	0.597886
chr11	128707908	128712429	KCNJ1	4521	0.401902
chr11	128761312	128787951	KCNJ5	26639	0.494388
chr11	128769459	128775592	C11orf45	6133	0.518180
chr11	128805269	128807789	TP53AIP1	2520	0.507540
chr11	128834954	129062093	ARHGAP32	227139	0.367687
chr11	129245880	129322174	BARX2	76294	0.426967
chr11	129564512	129568140	AX746800	3628	0.549890
chr11	129685740	129729898	TMEM45B	44158	0.443249
chr11	129733669	129762904	NFRKB	29235	0.453292
chr11	129769600	129872730	PRDM10	103130	0.435227
chr11	129872518	129875381	LINC00167	2863	0.500524
chr11	129940462	130014706	APLP2	74244	0.432830
chr11	130005595	130005622	DQ600312	27	0.518519
chr11	130029681	130080257	ST14	50576	0.518527
chr11	130096573	130184607	ZBTB44	88034	0.391428
chr11	130184418	130263694	AX747213	79276	0.433586
chr11	130238788	130272193	BC144419	33405	0.467954
chr11	130272231	130273133	AX747213	902	0.477827
chr11	130274817	130298539	ADAMTS8	23722	0.533092
chr11	130318868	130346539	ADAMTS15	27671	0.516534
chr11	130542850	130587247	C11orf44	44397	0.413384
chr11	130745765	130786382	SNX19	40617	0.425019
chr11	131780711	132206716	NTM	426005	0.426871
chr11	131255143	131255258	U6atac	115	0.408696
chr11	131403750	131410761	AK128059	7011	0.463985
chr11	132284874	132813037	OPCML	528163	0.408315
chr11	132395702	132395781	U6	79	0.367089
chr11	133229923	133235975	AK056505	6052	0.509749
chr11	133667934	133670204	AK097142	2270	0.433040
chr11	133710516	133715392	SPATA19	4876	0.503897
chr11	133766329	133771635	MIR4697HG	5306	0.500377
chr11	133778519	133826649	IGSF9B	48130	0.565905
chr11	133902166	133911236	LOC100128239	9070	0.562293
chr11	133938819	134021652	JAM3	82833	0.419483
chr11	134022336	134094426	NCAPD3	72090	0.428395
chr11	134024469	134025926	AK095267	1457	0.509952
chr11	134094560	134117686	VPS26B	23126	0.483655
chr11	134118172	134123260	THYN1	5088	0.439072
chr11	134123433	134135746	ACAD8	12313	0.478031
chr11	134146274	134189458	GLB1L3	43184	0.443104
chr11	134201767	134246218	GLB1L2	44451	0.509437
chr11	134248397	134281812	B3GAT1	33415	0.556487
chr11	134306375	134375555	LOC283177	69180	0.496820
chr11	134356392	134357809	AK095081	1417	0.563867
chr11	134605838	134633704	AK125040	27866	0.505419
chr11	134855245	134856693	AK130852	1448	0.581492
chr12	67610	69070	F379	1460	0.502055
chr12	87871	91263	LOC100288778	3392	0.594634
chr12	74271	87703	DKFZp434K1323	13432	0.524494
chr12	91352	93018	DDX11L11	1666	0.581032
chr12	147945	149412	FAM138D	1467	0.503067
chr12	176048	287625	IQSEC3	111577	0.522670
chr12	246576	258332	LOC574538	11756	0.536917
chr12	299242	323371	SLC6A12	24129	0.526752
chr12	329786	372039	SLC6A13	42253	0.471943
chr12	389222	498620	KDM5A	109398	0.394596
chr12	510740	551806	CCDC77	41066	0.441898
chr12	569542	671058	B4GALNT3	101516	0.488948
chr12	673461	772755	NINJ2	99294	0.480452
chr12	740056	755044	LOC100049716	14988	0.484788
chr12	862088	1020618	WNK1	158530	0.386558
chr12	890298	890424	U4atac	126	0.436508
chr12	1021254	1058863	RAD52	37609	0.458135
chr12	1100403	1605099	ERC1	504696	0.393060
chr12	1609656	1613590	LINC00942	3934	0.551601
chr12	1615335	1616484	AX746535	1149	0.454308
chr12	1675158	1703331	FBXL14	28173	0.461754
chr12	1738411	1756378	WNT5B	17967	0.512384
chr12	1769480	1769546	MIR3649	66	0.530303
chr12	1800246	1897845	ADIPOR2	97599	0.393016
chr12	1901122	2027870	CACNA2D4	126748	0.504529
chr12	1929432	1945918	LRTM2	16486	0.578006
chr12	2038367	2045742	LINC00940	7375	0.540475
chr12	2055213	2113677	DCP1B	58464	0.387093
chr12	2080228	2080366	CACNA1C	138	0.514493
chr12	2162415	2807115	CACNA1C	644700	0.479187
chr12	2329702	2332647	CACNA1C-AS4	2945	0.427504
chr12	2378941	2397911	CACNA1C-IT3	18970	0.469320
chr12	2785166	2800323	CACNA1C-AS1	15157	0.544171
chr12	2870365	2880835	LOC283440	10470	0.474881
chr12	2904107	2914587	FKBP4	10480	0.515840
chr12	2921786	2934237	ITFG2	12451	0.495703
chr12	2934513	2944221	NRIP2	9708	0.509683
chr12	2945981	2968961	LOC100507424	22980	0.504395
chr12	2966846	2986321	FOXM1	19475	0.480668
chr12	2986364	2998691	RHNO1	12327	0.464833
chr12	3000032	3050306	TULP3	50274	0.443331
chr12	3068477	3149842	TEAD4	81365	0.516020
chr12	3186520	3395730	TSPAN9	209210	0.521333
chr12	3405367	3409390	AK056228	4023	0.578673
chr12	3427883	3434509	AK095365	6626	0.537579
chr12	3445188	3445980	BC047090	792	0.463384
chr12	3600363	3703138	PRMT8	102775	0.467993
chr12	3553532	3553563	DQ574680	31	0.548387
chr12	3565649	3565688	DQ597527	39	0.641026
chr12	3567721	3570074	DQ591569	2353	0.478538
chr12	3575436	3575477	DQ590472	41	0.609756
chr12	3579507	3579548	DQ590289	41	0.512195
chr12	3579697	3579731	DQ591331	34	0.617647
chr12	3580294	3580328	DQ599425	34	0.441176
chr12	3581012	3581048	DQ584103	36	0.527778
chr12	3581870	3581899	DQ583990	29	0.551724
chr12	3584206	3584271	DQ573743	65	0.461538
chr12	3584318	3584352	DQ594563	34	0.558824
chr12	3584494	3584528	DQ601344	34	0.500000
chr12	3585019	3585049	DQ600002	30	0.466667
chr12	3585610	3585642	DQ570426	32	0.625000
chr12	3586923	3586953	DQ589173	30	0.400000
chr12	3586955	3586984	DQ587099	29	0.379310
chr12	3587759	3587799	DQ594785	40	0.425000
chr12	3590068	3590097	DQ588300	29	0.344828
chr12	3590833	3590862	DQ596092	29	0.448276
chr12	3591678	3591708	DQ583138	30	0.466667
chr12	3592511	3592544	DQ579489	33	0.333333
chr12	3592879	3601985	AK125333	9106	0.488250
chr12	3724100	3862366	EFCAB4B	138266	0.458594
chr12	3918026	3982608	PARP11	64582	0.384782
chr12	4382901	4414522	CCND2	31621	0.491382
chr12	4430358	4469190	C12orf5	38832	0.405413
chr12	4477392	4488894	FGF23	11502	0.446879
chr12	4543307	4554780	FGF6	11473	0.484093
chr12	4596900	4647637	C12orf4	50737	0.365414
chr12	4647949	4669213	RAD51AP1	21264	0.364325
chr12	4699243	4723041	DYRK4	23798	0.429826
chr12	4724675	4754358	AKAP3	29683	0.384159
chr12	4758263	4796720	NDUFA9	38457	0.388902
chr12	4829751	4881892	GALNT8	52141	0.418481
chr12	4918341	4960278	KCNA6	41937	0.462384
chr12	5019072	5027422	KCNA1	8350	0.471737
chr12	5153084	5155954	KCNA5	2870	0.585714
chr12	5347213	5352317	BC031884	5104	0.426136
chr12	5541279	5604465	NTF3	63186	0.466274
chr12	5671816	6055398	ANO2	383582	0.445102
chr12	6058039	6233836	VWF	175797	0.465912
chr12	6309481	6347437	CD9	37956	0.508115
chr12	6419601	6437672	PLEKHG6	18071	0.557136
chr12	6437922	6451283	TNFRSF1A	13361	0.540753
chr12	6456008	6484390	SCNN1A	28382	0.506236
chr12	6493198	6500737	LTBR	7539	0.551399
chr12	6548166	6560683	CD27-AS1	12517	0.494847
chr12	6554050	6560884	CD27	6834	0.514633
chr12	6561176	6571488	TAPBPL	10312	0.507467
chr12	6571403	6579843	VAMP1	8440	0.483649
chr12	6601315	6602471	MRPL51	1156	0.476644
chr12	6603297	6641132	NCAPD2	37835	0.460737
chr12	6619387	6619717	SCARNA10	330	0.454545
chr12	6643584	6647537	GAPDH	3953	0.602833
chr12	6648126	6665249	IFFO1	17123	0.543304
chr12	6666035	6677498	NOP2	11463	0.490099
chr12	6679247	6716551	CHD4	37304	0.482951
chr12	6687787	6693905	AK096395	6118	0.473194
chr12	6690638	6690775	SCARNA11	137	0.510949
chr12	6728000	6740815	LPAR5	12815	0.505189
chr12	6747241	6756580	ACRBP	9339	0.516115
chr12	6759703	6772308	ING4	12605	0.478302
chr12	6775642	6798738	ZNF384	23096	0.463457
chr12	6802956	6810009	PIANP	7053	0.585566
chr12	6833179	6841041	COPS7A	7862	0.504325
chr12	6857157	6862082	MLF2	4925	0.530152
chr12	6875540	6880118	PTMS	4578	0.621669
chr12	6881669	6887621	LAG3	5952	0.573757
chr12	6898637	6929976	CD4	31339	0.486837
chr12	6930962	6936583	GPR162	5621	0.595979
chr12	6949374	6956557	GNB3	7183	0.544619
chr12	6957971	6960456	CDCA3	2485	0.514688
chr12	6961284	6975795	USP5	14511	0.527807
chr12	6976583	6980110	TPI1	3527	0.585767
chr12	6980099	6982449	SPSB2	2350	0.603830
chr12	6993144	6993768	RPL13P5	624	0.570513
chr12	6993845	6994950	DSTNP2	1105	0.462443
chr12	7013896	7023406	LRRC23	9510	0.482124
chr12	7023613	7032859	ENO2	9246	0.548778
chr12	7033625	7053815	ATN1	20190	0.554928
chr12	7052140	7054229	C12orf57	2089	0.531355
chr12	7053202	7055165	C12orf57	1963	0.539990
chr12	7055739	7070479	PTPN6	14740	0.576459
chr12	7072861	7072929	MIR200C	68	0.558824
chr12	7073259	7073354	MIR141	95	0.557895
chr12	7074514	7079916	PHB2	5402	0.530914
chr12	7076499	7076769	SCARNA12	270	0.577778
chr12	7079943	7085165	EMG1	5222	0.466488
chr12	7085346	7125842	LPCAT3	40496	0.440562
chr12	7167979	7178335	C1S	10356	0.468231
chr12	7187514	7245043	C1R	57529	0.069704
chr12	7247145	7261869	C1RL	14724	0.474871
chr12	7260903	7274447	C1RL-AS1	13544	0.513290
chr12	7261166	7273623	C1RL-AS1	12457	0.507907
chr12	7276279	7281466	RBP5	5187	0.490650
chr12	7282966	7311530	CLSTN3	28564	0.514704
chr12	7342281	7364079	PEX5	21798	0.430957
chr12	7456927	7480969	ACSM4	24042	0.405457
chr12	7507556	7596749	CD163L1	89193	0.359759
chr12	7623411	7656414	CD163	33003	0.374178
chr12	7801995	7818502	APOBEC1	16507	0.442903
chr12	7842380	7848360	GDF3	5980	0.462709
chr12	7864088	7870152	DPPA3	6064	0.459103
chr12	7882010	7902069	CLEC4C	20059	0.450621
chr12	7917811	7926717	NANOGNB	8906	0.450258
chr12	7941994	7948655	NANOG	6661	0.434619
chr12	7966396	8025495	SLC2A14	59099	0.451311
chr12	8025533	8051896	NANOGP1	26363	0.455032
chr12	8052069	8052674	AY455283	605	0.411570
chr12	8071823	8088892	SLC2A3	17069	0.446482
chr12	8185358	8208118	FOXJ2	22760	0.474605
chr12	8210918	8218955	C3AR1	8037	0.420555
chr12	8232080	8234759	BC039122	2679	0.387085
chr12	8234806	8250373	NECAP1	15567	0.420633
chr12	8276227	8291203	CLEC4A	14976	0.412059
chr12	8286364	8287448	POU5F1P3	1084	0.597786
chr12	8286945	8287326	POU5F1P3	381	0.627297
chr12	8325149	8332642	ZNF705A	7493	0.368878
chr12	8332804	8353596	FAM66C	20792	0.454550
chr12	8373855	8380214	FAM90A1	6359	0.542224
chr12	8383644	8395542	FAM86FP	11898	0.539502
chr12	8509559	8543565	LINC00937	34006	0.468417
chr12	8608590	8630926	CLEC6A	22336	0.367255
chr12	8666135	8674960	CLEC4D	8825	0.349348
chr12	8685900	8693558	CLEC4E	7658	0.397885
chr12	8754761	8765442	AICDA	10681	0.413913
chr12	8798539	8815433	MFAP5	16894	0.418906
chr12	8850517	8929787	RIMKLB	79270	0.409222
chr12	8931626	8935687	RIMKLB	4061	0.360749
chr12	8975149	9029381	A2ML1	54232	0.444903
chr12	9067315	9094060	PHC1	26745	0.435334
chr12	9092956	9102357	M6PR	9401	0.423678
chr12	9142220	9163340	KLRG1	21120	0.383381
chr12	9208184	9217666	LINC00612	9482	0.397595
chr12	9217772	9220651	A2M-AS1	2879	0.484196
chr12	9220303	9268558	A2M	48255	0.371443
chr12	9280497	9280518	JB175316	21	0.523810
chr12	9301435	9360966	PZP	59531	0.381935
chr12	9381128	9386803	A2MP1	5675	0.371454
chr12	9392065	9392147	MIR1244-1	82	0.329268
chr12	9392598	9395645	LOC100499405	3047	0.428290
chr12	9436288	9452059	LOC642846	15771	0.510748
chr12	9439268	9439418	SNORA75	150	0.393333
chr12	9453689	9464427	LOC642846	10738	0.534271
chr12	9481705	9481733	DQ582774	28	0.500000
chr12	9481920	9481986	DQ586985	66	0.454545
chr12	9485756	9485790	DQ577612	34	0.441176
chr12	9488358	9488396	DQ586485	38	0.473684
chr12	9488431	9488461	DQ577180	30	0.466667
chr12	9488849	9488879	DQ585706	30	0.600000
chr12	9492398	9492435	DQ575612	37	0.513514
chr12	9499998	9500028	DQ592342	30	0.400000
chr12	9555037	9555064	DQ599803	27	0.481481
chr12	9570306	9572677	DDX12P	2371	0.592155
chr12	9572768	9583336	DDX12P	10568	0.530659
chr12	9585012	9590085	DDX12P	5073	0.562586
chr12	9597653	9597801	SNORA75	148	0.391892
chr12	9709909	9728864	BX647938	18955	0.419045
chr12	9747869	9760497	KLRB1	12628	0.366566
chr12	9800642	9811010	LOC374443	10368	0.390625
chr12	9822303	9852151	CLEC2D	29848	0.372454
chr12	9868455	9885895	CLECL1	17440	0.360149
chr12	9905081	9913497	CD69	8416	0.353375
chr12	9980076	9997603	KLRF1	17527	0.351058
chr12	10004967	10022458	CLEC2B	17491	0.329941
chr12	10034087	10048432	KLRF2	14345	0.344580
chr12	10065825	10084980	CLEC2A	19155	0.363769
chr12	10103914	10138194	CLEC12A	34280	0.404813
chr12	10145661	10151899	CLEC1B	6238	0.359731
chr12	10163230	10171399	CLEC12B	8169	0.355735
chr12	10183275	10218565	CLEC9A	35290	0.369113
chr12	10223079	10251605	CLEC1A	28526	0.379408
chr12	10269375	10282868	CLEC7A	13493	0.374194
chr12	10310898	10324790	OLR1	13892	0.387489
chr12	10331556	10344403	TMEM52B	12847	0.434498
chr12	10365488	10375724	GABARAPL1	10236	0.437182
chr12	10460416	10469850	KLRD1	9434	0.378630
chr12	10516367	10551105	AK096314	34738	0.372445
chr12	10524951	10542653	KLRK1	17702	0.352672
chr12	10559982	10562356	KLRC4	2374	0.314238
chr12	10568182	10573194	KLRC3	5012	0.340184
chr12	10598637	10605979	KLRC1	7342	0.336829
chr12	10741076	10752434	KLRAP1	11358	0.335006
chr12	10756363	10766208	MAGOHB	9845	0.362519
chr12	10771537	10826891	STYK1	55354	0.394317
chr12	10851675	10875953	YBX3	24278	0.390930
chr12	10954130	10955226	TAS2R7	1096	0.400547
chr12	10958649	10959579	TAS2R8	930	0.356989
chr12	10961692	10962767	TAS2R9	1075	0.397209
chr12	10977944	10978868	TAS2R10	924	0.357143
chr12	10998447	11002075	PRR4	3628	0.402150
chr12	11033559	11036874	PRH1	3315	0.437707
chr12	11460014	11463369	PRB4	3355	0.447690
chr12	11060524	11062161	TAS2R13	1637	0.359194
chr12	11081833	11087444	PRH2	5611	0.382641
chr12	11090852	11091806	TAS2R14	954	0.395178
chr12	11138511	11139511	TAS2R50	1000	0.385000
chr12	11148560	11150474	TAS2R20	1914	0.356322
chr12	11174270	11175170	TAS2R19	900	0.402222
chr12	11182985	11184006	TAS2R31	1021	0.404505
chr12	11213963	11214893	TAS2R46	930	0.387097
chr12	11243885	11244912	TAS2R43	1027	0.389484
chr12	11285883	11286843	TAS2R30	960	0.401042
chr12	11323779	11328619	LOC100129361	4840	0.391322
chr12	11338598	11339543	TAS2R42	945	0.391534
chr12	11418856	11422641	PRB3	3785	0.462616
chr12	11504756	11508524	PRB1	3768	0.459660
chr12	11544473	11548498	PRB2	4025	0.468075
chr12	11700963	11717335	LOC338817	16372	0.403311
chr12	11802787	12048325	ETV6	245538	0.431888
chr12	12079078	12079107	RNU6-19P	29	0.448276
chr12	12202797	12208703	BC038742	5906	0.436505
chr12	12223877	12252627	BCL2L14	28750	0.465252
chr12	12264885	12264967	MIR1244-1	82	0.329268
chr12	12268960	12419811	LRP6	150851	0.385002
chr12	12482217	12503169	MANSC1	20952	0.436140
chr12	12508341	12510001	LOH12CR2	1660	0.452410
chr12	12510019	12619838	LOH12CR1	109819	0.420328
chr12	12626215	12715448	DUSP16	89233	0.403192
chr12	12764830	12798041	CREBL2	33211	0.405950
chr12	12813994	12849121	GPR19	35127	0.413272
chr12	12870301	12875305	CDKN1B	5004	0.426459
chr12	12966140	12982915	DDX47	16775	0.410075
chr12	12878850	12944399	APOLD1	65549	0.424568
chr12	12917582	12917677	MIR613	95	0.431579
chr12	13028410	13029070	RPL13AP20	660	0.560606
chr12	13043955	13066600	GPRC5A	22645	0.465931
chr12	13068762	13068852	MIR614	90	0.600000
chr12	13093708	13103318	GPRC5D	9610	0.428200
chr12	13127798	13153243	HEBP1	25445	0.435685
chr12	13132770	13137576	LOC100506314	4806	0.424886
chr12	13153375	13157764	HTR7P1	4389	0.515152
chr12	13197314	13236383	KIAA1467	39069	0.424864
chr12	13236470	13256630	GSG1	20160	0.462897
chr12	13349601	13369708	EMP1	20107	0.448550
chr12	13523604	13529679	C12orf36	6075	0.432263
chr12	13714409	14133022	GRIN2B	418613	0.404534
chr12	13836475	13836820	7SK	345	0.481159
chr12	14518610	14651697	ATF7IP	133087	0.360869
chr12	14656596	14720791	PLBD1	64195	0.405530
chr12	14765567	14849519	GUCY2C	83952	0.395690
chr12	14923653	14924065	HIST4H4	412	0.597087
chr12	14927269	14930936	H2AFJ	3667	0.457322
chr12	14939411	14956401	WBP11	16990	0.374809
chr12	14956505	14976791	C12orf60	20286	0.368284
chr12	14957583	14967116	SMCO3	9533	0.366411
chr12	14982244	14996413	ART4	14169	0.381255
chr12	15034114	15038853	MGP	4739	0.379616
chr12	15066975	15091463	ERP27	24488	0.383208
chr12	15094949	15114562	ARHGDIB	19613	0.411054
chr12	15125955	15134799	PDE6H	8844	0.396766
chr12	15260715	15374411	RERG	113696	0.365870
chr12	15475190	15751265	PTPRO	276075	0.375427
chr12	15773074	15942510	EPS8	169436	0.362467
chr12	16035287	16056410	STRAP	21123	0.365147
chr12	16064185	16190315	DERA	126130	0.391279
chr12	16341418	16430619	SLC15A5	89201	0.362193
chr12	16500576	16517344	MGST1	16768	0.408695
chr12	16701305	16758904	LMO3	57599	0.349589
chr12	17141680	17143562	SKP1P2	1882	0.410733
chr12	17224331	17224439	U6	108	0.361111
chr12	17826232	17826328	MIR3974	96	0.385417
chr12	18233802	18243114	RERGL	9312	0.339991
chr12	18414473	18801352	PIK3C2G	386879	0.357352
chr12	18836109	18890993	PLCZ1	54884	0.357773
chr12	18891044	18892122	CAPZA3	1078	0.412801
chr12	19282625	19529333	PLEKHA5	246708	0.381042
chr12	19592607	19675173	AEBP2	82566	0.395066
chr12	20167618	20251802	LOC100506393	84184	0.375202
chr12	20522178	20837041	PDE3A	314863	0.359490
chr12	20848288	20906320	SLCO1C1	58032	0.349049
chr12	20963637	21069843	SLCO1B3	106206	0.358972
chr12	21284127	21392730	SLCO1B1	108603	0.351850
chr12	21417533	21487832	SLCO1A2	70299	0.369678
chr12	21525801	21532914	IAPP	7113	0.327850
chr12	21590537	21624182	PYROXD1	33645	0.363263
chr12	21621843	21654603	RECQL	32760	0.375672
chr12	21654698	21671337	GOLT1B	16639	0.360118
chr12	21679255	21684210	C12orf39	4955	0.415338
chr12	21689122	21757781	GYS2	68659	0.371007
chr12	21788274	21810789	LDHB	22515	0.369665
chr12	21917888	21927755	KCNJ8	9867	0.397284
chr12	21950323	22089628	ABCC9	139305	0.359599
chr12	22199109	22218606	CMAS	19497	0.375032
chr12	22346324	22487648	ST8SIA1	141324	0.386049
chr12	22601517	22697452	C2CD5	95935	0.349414
chr12	22778075	22843608	ETNK1	65533	0.343613
chr12	23117505	23327057	AK094733	209552	0.375878
chr12	23685230	24102637	SOX5	417407	0.344788
chr12	24365354	24365429	MIR920	75	0.506667
chr12	24719897	24737102	LINC00477	17205	0.395001
chr12	24962957	25056009	BCAT1	93052	0.389277
chr12	25146364	25150373	C12orf77	4009	0.432527
chr12	25205180	25261269	LRMP	56089	0.378791
chr12	25261222	25348094	CASC1	86872	0.381803
chr12	25348149	25357949	LYRM5	9800	0.397449
chr12	25358179	25403854	KRAS	45675	0.364182
chr12	25398274	25398297	DD157417	23	0.608696
chr12	25629015	25706217	IFLTD1	77202	0.372050
chr12	26026952	26027012	MIR4302	60	0.516667
chr12	26097789	26110985	RASSF8-AS1	13196	0.416035
chr12	26111963	26225807	RASSF8	113844	0.379440
chr12	26272958	26278003	BHLHE41	5045	0.487413
chr12	26287896	26334217	BC041929	46321	0.400078
chr12	26348505	26387708	SSPN	39203	0.391424
chr12	26488284	26986131	ITPR2	497847	0.382599
chr12	27058111	27091254	ASUN	33143	0.363727
chr12	27091304	27119581	FGFR1OP2	28277	0.359798
chr12	27124505	27167339	TM7SF3	42834	0.402881
chr12	27175454	27183606	MED21	8152	0.375613
chr12	27233989	27235455	C12orf71	1466	0.468622
chr12	27397077	27478890	STK38L	81813	0.377141
chr12	27485786	27578746	ARNTL2	92960	0.392836
chr12	27542721	27599558	BC043511	56837	0.386333
chr12	27619742	27655118	SMCO2	35376	0.390265
chr12	27677044	27848497	PPFIBP1	171453	0.397718
chr12	27849427	27850566	REP15	1139	0.407375
chr12	27863705	27909237	MRPS35	45532	0.386410
chr12	27915598	27924209	MANSC4	8611	0.427360
chr12	27933186	27955973	KLHL42	22787	0.426515
chr12	28111016	28124916	PTHLH	13900	0.407266
chr12	28410134	28703099	CCDC91	292965	0.346946
chr12	29301935	29488549	FAR2	186614	0.390555
chr12	29433350	29470781	AX746523	37431	0.372205
chr12	29493578	29534143	ERGIC2	40565	0.340318
chr12	29542226	29617863	OVCH1-AS1	75637	0.377024
chr12	29580488	29650619	OVCH1	70131	0.373957
chr12	29653745	29936743	TMTC1	282998	0.391738
chr12	30781914	30848929	IPO8	67015	0.359293
chr12	30862485	30907448	CAPRIN2	44963	0.371884
chr12	30948614	30955645	LINC00941	7031	0.471910
chr12	31079837	31149537	TSPAN11	69700	0.511736
chr12	31173696	31226781	DDX11-AS1	53085	0.448187
chr12	31226778	31257725	DDX11	30947	0.522797
chr12	31229800	31229950	SNORA75	150	0.406667
chr12	31267684	31359088	OVOS2	91404	0.383495
chr12	31379257	31379277	hsa-miR-3194-3p	20	0.600000
chr12	31433519	31479159	FAM60A	45640	0.412840
chr12	31477249	31478879	FLJ13224	1630	0.644172
chr12	31516414	31522235	BC039477	5821	0.474661
chr12	31535156	31743952	DENND5B	208796	0.409309
chr12	31742856	31768285	DENND5B-AS1	25429	0.437099
chr12	31747026	31747140	U5	114	0.350877
chr12	31812608	31822016	METTL20	9408	0.427402
chr12	31824070	31882108	AMN1	58038	0.405493
chr12	31944118	31945175	H3F3C	1057	0.446547
chr12	32112352	32146043	KIAA1551	33691	0.415660
chr12	32146772	32146802	RNU6-78P	30	0.433333
chr12	32260184	32531141	BICD1	270957	0.405518
chr12	32655040	32798984	FGD4	143944	0.403018
chr12	32832136	32898584	DNM1L	66448	0.382088
chr12	32899477	32908887	YARS2	9410	0.430606
chr12	32943679	33049780	PKP2	106101	0.407989
chr12	33528347	33592754	SYT10	64407	0.365473
chr12	34175215	34181236	ALG10	6021	0.376682
chr12	38710556	38723528	ALG10B	12972	0.337188
chr12	38937978	38983614	BC040886	45636	0.365260
chr12	39046001	39299420	CPNE8	253419	0.359081
chr12	39687029	39837192	KIF21A	150163	0.362173
chr12	39945021	40013843	ABCD2	68822	0.350992
chr12	40019971	40115720	C12orf40	95749	0.357309
chr12	40148822	40499661	SLC2A13	350839	0.370175
chr12	40618812	40763086	LRRK2	144274	0.350153
chr12	40787195	40813035	MUC19	25840	0.357624
chr12	40815007	40898247	MUC19	83240	0.373751
chr12	40938851	40957362	MUC19	18511	0.377937
chr12	40959313	40964560	MUC19	5247	0.328950
chr12	41302158	41466213	CNTN1	164055	0.350090
chr12	41289751	41289889	contactin 1	138	0.565217
chr12	41582249	41968392	PDZRN4	386143	0.363684
chr12	42475647	42538673	GXYLT1	63026	0.376067
chr12	42550906	42632154	YAF2	81248	0.390213
chr12	42705887	42719932	ZCRB1	14045	0.373300
chr12	42719946	42842422	PPHLN1	122476	0.380091
chr12	42852139	42877416	PRICKLE1	25277	0.430035
chr12	43748011	43945724	ADAMTS20	197713	0.353290
chr12	44122409	44152576	PUS7L	30167	0.365035
chr12	44152746	44183346	IRAK4	30600	0.375784
chr12	44187525	44200178	TWF1	12653	0.341579
chr12	44229961	44783541	TMEM117	553580	0.373397
chr12	44902057	45270633	NELL2	368576	0.362286
chr12	45408538	45444882	DBX2	36344	0.372689
chr12	45456400	45459194	RACGAP1P	2794	0.450608
chr12	45566816	45609789	PLEKHA8P1	42973	0.413143
chr12	45580873	45581252	RNY5	379	0.488127
chr12	45609769	45826134	ANO6	216365	0.393622
chr12	46051607	46053435	BC053951	1828	0.373085
chr12	46119502	46121704	LINC00938	2202	0.476385
chr12	46123619	46301819	ARID2	178200	0.360634
chr12	46288602	46290522	AX748322	1920	0.429167
chr12	46312913	46384401	SCAF11	71488	0.360592
chr12	46576840	46663208	SLC38A1	86368	0.397821
chr12	46751970	46766645	SLC38A2	14675	0.385349
chr12	47158543	47219780	SLC38A4	61237	0.358394
chr12	47469489	47473734	AMIGO2	4245	0.445936
chr12	47610004	47630443	PCED1B	20439	0.440922
chr12	47581594	47581674	MIR4698	80	0.537500
chr12	47599681	47601754	AX747844	2073	0.440907
chr12	47602202	47610226	PCED1B-AS1	8024	0.421610
chr12	48055714	48099844	RPAP3	44130	0.365874
chr12	48103517	48119355	ENDOU	15838	0.489329
chr12	48113033	48136077	AL831948	23044	0.520830
chr12	48128452	48152889	RAPGEF3	24437	0.563326
chr12	48166966	48176536	SLC48A1	9570	0.557994
chr12	48176506	48213763	HDAC7	37257	0.563760
chr12	48235319	48298814	VDR	63495	0.493787
chr12	48357329	48362661	TMEM106C	5332	0.468117
chr12	48366747	48398285	COL2A1	31538	0.553586
chr12	48436680	48500091	SENP1	63411	0.386195
chr12	48499655	48540187	PFKM	40532	0.447202
chr12	48541571	48551377	ASB8	9806	0.435652
chr12	48577365	48579709	C12orf68	2344	0.602816
chr12	48596121	48597075	OR10AD1	954	0.511530
chr12	48722762	48724062	H1FNT	1300	0.606923
chr12	48733792	48744674	ZNF641	10882	0.450928
chr12	48866447	48866843	ANP32D	396	0.411616
chr12	48876285	48890297	C12orf54	14012	0.438267
chr12	48919414	48921886	OR8S1	2472	0.450647
chr12	48961466	48963829	LALBA	2363	0.456200
chr12	49046994	49076008	KANSL2	29014	0.419418
chr12	49048164	49048313	SNORA34	149	0.496644
chr12	49050430	49050565	SNORA2A	135	0.437037
chr12	49061239	49061376	SNORA2B	137	0.401460
chr12	49082240	49110781	CCNT1	28541	0.409481
chr12	49121217	49159569	LINC00935	38352	0.454448
chr12	49159974	49177877	ADCY6	17903	0.546054
chr12	49165757	49165820	MIR4701	63	0.587302
chr12	49208214	49222726	CACNB3	14512	0.575386
chr12	49223538	49245957	DDX23	22419	0.495740
chr12	49250915	49259653	RND1	8738	0.520714
chr12	49297892	49315359	CCDC65	17467	0.475754
chr12	49315741	49319330	FKBP11	3589	0.524380
chr12	49329991	49351252	ARF3	21261	0.476177
chr12	49359122	49365641	WNT10B	6519	0.561282
chr12	49372235	49376396	WNT1	4161	0.624609
chr12	49388932	49393088	DDN	4156	0.616458
chr12	49396054	49412629	PRKAG1	16575	0.452368
chr12	49412757	49449107	KMT2D	36350	0.544402
chr12	49458467	49463775	RHEBL1	5308	0.495290
chr12	49469480	49469506	DQ589802	26	0.461538
chr12	49483205	49488602	DHH	5397	0.582916
chr12	49490922	49504680	LMBR1L	13758	0.518535
chr12	49500205	49504680	LMBR1L	4475	0.531173
chr12	49521566	49525304	TUBA1B	3738	0.541466
chr12	49521741	49522719	TUBA1A	978	0.529652
chr12	49578577	49583107	TUBA1A	4530	0.486093
chr12	49658864	49667113	TUBA1C	8249	0.484422
chr12	49666045	49667009	TUBA1C	964	0.533195
chr12	49688908	49692481	PRPH	3573	0.635880
chr12	49716970	49725514	TROAP	8544	0.532069
chr12	49726199	49730971	C1QL4	4772	0.594719
chr12	49741040	49745685	DNAJC22	4645	0.520560
chr12	49760687	49921207	SPATS2	160520	0.416347
chr12	49782956	49786116	LOC100335030	3160	0.376582
chr12	49932939	49952077	KCNH3	19138	0.576340
chr12	49952085	49960222	MCRS1	8137	0.542092
chr12	49981287	49999433	FAM186B	18146	0.467431
chr12	50017196	50038452	PRPF40B	21256	0.507151
chr12	50031723	50101197	FMNL3	69474	0.480957
chr12	50135591	50158717	TMBIM6	23126	0.430338
chr12	50184928	50222208	NCKAP5L	37280	0.527790
chr12	50222325	50234937	BCDIN3D-AS1	12612	0.436489
chr12	50229825	50236912	BCDIN3D	7087	0.451531
chr12	50260678	50297760	FAIM2	37082	0.538428
chr12	50302665	50305646	LOC283332	2981	0.541094
chr12	50305735	50320122	BC034605	14387	0.497532
chr12	50344523	50352664	AQP2	8141	0.548827
chr12	50355278	50359465	AQP5	4187	0.625508
chr12	50366263	50370922	AQP6	4659	0.581885
chr12	50382944	50419307	RACGAP1	36363	0.417677
chr12	50451419	50477405	ASIC1	25986	0.540791
chr12	50478982	50494494	SMARCD1	15512	0.484850
chr12	50497601	50505103	GPD1	7502	0.557451
chr12	50505763	50514240	COX14	8477	0.494750
chr12	50523580	50561097	CERS5	37517	0.437428
chr12	50538139	50538175	HV533924	36	0.388889
chr12	50569562	50677353	LIMA1	107791	0.423282
chr12	50627924	50627995	MIR1293	71	0.478873
chr12	50721094	50790405	FAM186A	69311	0.437420
chr12	50794591	50873788	LARP4	79197	0.410180
chr12	50898767	51142450	DIP2B	243683	0.418429
chr12	51157788	51214943	ATF1	57155	0.417881
chr12	51236700	51281663	TMPRSS12	44963	0.390566
chr12	51318533	51326300	METTL7A	7767	0.429123
chr12	51347781	51364289	HIGD1C	16508	0.429670
chr12	51379774	51422058	SLC11A2	42284	0.439173
chr12	51404781	51404843	U7	62	0.419355
chr12	51442081	51454207	LETMD1	12126	0.449035
chr12	51454987	51477454	CSRNP2	22467	0.466417
chr12	51487538	51566926	TFCP2	79388	0.419623
chr12	51517733	51519265	LOC494150	1532	0.488251
chr12	51580718	51591950	POU6F1	11232	0.517094
chr12	51632507	51637717	DAZAP2	5210	0.469290
chr12	51639132	51664202	SMAGP	25070	0.466733
chr12	51674821	51717938	BIN2	43117	0.443584
chr12	51722226	51740463	CELA1	18237	0.469046
chr12	51745832	51785200	GALNT6	39368	0.494869
chr12	51818593	51909547	SLC4A8	90954	0.421972
chr12	51895611	51909547	SLC4A8	13936	0.435060
chr12	51985019	52206648	SCN8A	221629	0.409003
chr12	52211675	52225701	FIGNL2	14026	0.550692
chr12	52281792	52285505	ANKRD33	3713	0.580932
chr12	52306112	52317145	ACVRL1	11033	0.549715
chr12	52345450	52390863	ACVR1B	45413	0.448396
chr12	52400728	52409673	GRASP	8945	0.586361
chr12	52445185	52453291	NR4A1	8106	0.578337
chr12	52450277	52453291	NR4A1	3014	0.540146
chr12	52463757	52471279	C12orf44	7522	0.505982
chr12	52473479	52502034	bpl 41-16	28555	0.493224
chr12	52562779	52585784	KRT80	23005	0.556966
chr12	52599364	52604639	LOC283403	5275	0.529858
chr12	52604713	52617597	LINC00592	12884	0.490764
chr12	52626953	52642709	KRT7	15756	0.540366
chr12	52695648	52702947	KRT86	7299	0.569256
chr12	52644327	52652171	KRT121P	7844	0.518868
chr12	52679696	52685299	KRT81	5603	0.582010
chr12	52708084	52715182	KRT83	7098	0.538743
chr12	52753789	52761309	KRT85	7520	0.545080
chr12	52771595	52779417	KRT84	7822	0.509588
chr12	52787734	52800176	KRT82	12442	0.526041
chr12	52817853	52828110	KRT75	10257	0.492152
chr12	52840434	52845910	KRT6B	5476	0.508583
chr12	52862299	52867569	KRT6C	5270	0.508729
chr12	52880957	52887181	KRT6A	6224	0.500964
chr12	52908358	52914243	KRT5	5885	0.506882
chr12	52937692	52946931	KRT71	9239	0.536746
chr12	52959602	52967609	KRT74	8007	0.529162
chr12	52979372	52995322	KRT72	15950	0.466019
chr12	53001353	53012343	KRT73	10990	0.521201
chr12	53038341	53045959	KRT2	7618	0.499081
chr12	53068519	53074191	KRT1	5672	0.471262
chr12	53083410	53097247	KRT77	13837	0.510515
chr12	53161938	53171129	KRT76	9191	0.490371
chr12	53183468	53189892	KRT3	6424	0.536115
chr12	53200326	53207900	KRT4	7574	0.485477
chr12	53215230	53228077	KRT79	12847	0.509769
chr12	53232745	53242778	KRT78	10033	0.526064
chr12	53290970	53320253	KRT8	29283	0.514975
chr12	53342842	53346685	KRT18	3843	0.551652
chr12	53400061	53435993	EIF4B	35932	0.427224
chr12	53436972	53448222	LOC283335	11250	0.594578
chr12	53443834	53458162	TENC1	14328	0.591848
chr12	53458099	53473204	SPRYD3	15105	0.539821
chr12	53491435	53496128	IGFBP6	4693	0.540379
chr12	53497273	53518323	SOAT2	21050	0.477197
chr12	53548176	53548197	DD413682	21	0.428571
chr12	53551446	53574693	CSAD	23247	0.474427
chr12	53574534	53584654	ZNF740	10120	0.491403
chr12	53585106	53601000	ITGB7	15894	0.510633
chr12	53604349	53626040	RARG	21691	0.560693
chr12	53645369	53648190	MFSD5	2821	0.590216
chr12	53662082	53687427	ESPL1	25345	0.516946
chr12	53689234	53693234	PFDN5	4000	0.473750
chr12	53693469	53700965	C12orf10	7496	0.512273
chr12	53701239	53715412	AAAS	14173	0.492980
chr12	53720359	53729537	SP7	9178	0.540750
chr12	53773978	53810226	SP1	36248	0.456384
chr12	53817638	53825318	AMHR2	7680	0.527474
chr12	53818865	53825048	AMHR2	6183	0.517710
chr12	53845885	53874946	PCBP2	29061	0.437906
chr12	53835432	53840427	PRR13	4995	0.485686
chr12	53874275	53893444	MAP3K12	19169	0.529553
chr12	53895376	53900215	TARBP2	4839	0.562306
chr12	53900473	53901422	NPFF	949	0.566913
chr12	53905842	54020199	ATF7	114357	0.427031
chr12	53907767	53911392	LOC100652999	3625	0.468414
chr12	54058943	54070109	ATP5G2	11166	0.463640
chr12	54104901	54121307	CALCOCO1	16406	0.492076
chr12	54185088	54185131	SNORD81	43	0.325581
chr12	54329111	54333427	HOXC-AS5	4316	0.563948
chr12	54332575	54340328	HOXC13	7753	0.490262
chr12	54348713	54350350	HOXC12	1637	0.609041
chr12	54356091	54368740	HOTAIR	12649	0.516167
chr12	54366909	54370203	HOXC11	3294	0.594414
chr12	54378945	54384062	HOXC10	5117	0.530193
chr12	54385521	54385631	MIR196A2	110	0.481818
chr12	54393876	54397120	HOXC9	3244	0.554871
chr12	54402889	54406545	HOXC8	3656	0.509573
chr12	54447660	54449814	HOXC4	2154	0.498607
chr12	54422193	54424607	HOXC6	2414	0.541011
chr12	54426831	54429144	HOXC5	2313	0.598789
chr12	54427733	54427829	MIR615	96	0.708333
chr12	54452037	54516018	FLJ12825	63981	0.480393
chr12	54472622	54475607	LOC100240735	2985	0.496482
chr12	54495992	54496483	LOC100240734	491	0.464358
chr12	54519854	54526626	LOC400043	6772	0.532930
chr12	54574141	54582778	SMUG1	8637	0.497048
chr12	54624730	54653370	CBX5	28640	0.430691
chr12	54674487	54679030	HNRNPA1	4543	0.420867
chr12	54685890	54694821	NFE2	8931	0.517859
chr12	54718873	54745635	COPZ1	26762	0.463755
chr12	54730999	54731098	MIR148B	99	0.434343
chr12	54756228	54758270	GPR84	2042	0.507346
chr12	54762919	54785083	ZNF385A	22164	0.540471
chr12	54789044	54813050	ITGA5	24006	0.524411
chr12	54849735	54867386	GTSF1	17651	0.396351
chr12	54891494	54936899	NCKAP1L	45405	0.423610
chr12	54943176	54973023	PDE1B	29847	0.494321
chr12	54973023	54982443	PPP1R1A	9420	0.528450
chr12	55001970	55004246	GLYCAM1	2276	0.470123
chr12	55024622	55028663	LACRT	4041	0.508785
chr12	55038374	55042149	DCD	3775	0.489801
chr12	55213640	55213669	DQ573663	29	0.551724
chr12	55248298	55252174	MUCL1	3876	0.392157
chr12	55342086	55375622	TESPA1	33536	0.397811
chr12	55413728	55423801	NEUROD4	10073	0.376551
chr12	55523552	55524560	OR9K2	1008	0.420635
chr12	55614808	55615759	OR10A7	951	0.442692
chr12	55641071	55642010	OR6C74	939	0.402556
chr12	55688071	55689016	OR6C6	945	0.390476
chr12	55714383	55715322	OR6C1	939	0.395101
chr12	55725484	55726420	OR6C3	936	0.402778
chr12	55758894	55759833	OR6C75	939	0.418530
chr12	55794312	55795251	OR6C65	939	0.374867
chr12	55820037	55820976	OR6C76	939	0.401491
chr12	55845997	55846936	OR6C2	939	0.412141
chr12	55862983	55863922	OR6C70	939	0.368477
chr12	55886161	55887100	OR6C68	939	0.365282
chr12	55945010	55945940	OR6C4	930	0.426882
chr12	55968198	55969128	OR2AP1	930	0.443011
chr12	56030675	56031617	OR10P1	942	0.583864
chr12	56075329	56078394	METTL7B	3065	0.525612
chr12	56078353	56101686	ITGA7	23333	0.530622
chr12	56114150	56118526	RDH5	4376	0.523309
chr12	56109817	56113491	BLOC1S1	3674	0.550626
chr12	56119226	56122434	CD63	3208	0.566397
chr12	56137063	56146665	GDF11	9602	0.518330
chr12	56151053	56222498	DNAJC14	71445	0.431479
chr12	56211805	56214959	ORMDL2	3154	0.463221
chr12	56225624	56227719	AX747140	2095	0.527924
chr12	56229213	56236767	MMP19	7554	0.509929
chr12	56295196	56321697	WIBG	26501	0.443870
chr12	56325811	56347807	DGKA	21996	0.480724
chr12	56347888	56359846	PMEL	11958	0.491554
chr12	56360555	56366568	CDK2	6013	0.477465
chr12	56367794	56390467	RAB5B	22673	0.459666
chr12	56391042	56399309	SUOX	8267	0.524495
chr12	56414688	56432219	IKZF4	17531	0.486909
chr12	56435685	56438007	RPS26	2322	0.470284
chr12	56473808	56497291	ERBB3	23483	0.498318
chr12	56498102	56507694	PA2G4	9592	0.465909
chr12	56510373	56511616	RPL41	1243	0.462591
chr12	56512029	56516278	ZC3H10	4249	0.535891
chr12	56521985	56538460	ESYT1	16475	0.515266
chr12	56546203	56551771	MYL6B	5568	0.536638
chr12	56552044	56555366	MYL6	3322	0.532812
chr12	56555635	56583351	SMARCC2	27716	0.490294
chr12	56584147	56584229	TRNA	82	0.573171
chr12	56596287	56615753	RNF41	19466	0.480016
chr12	56618124	56623638	NABP2	5514	0.510156
chr12	56623819	56631629	SLC39A5	7810	0.548784
chr12	56631590	56652143	ANKRD52	20553	0.534812
chr12	56660641	56664750	COQ10A	4109	0.509856
chr12	56665482	56694175	CS	28693	0.461541
chr12	56704212	56710128	CNPY2	5916	0.501014
chr12	56710006	56727533	PAN2	17527	0.475038
chr12	56732662	56734194	IL23A	1532	0.511097
chr12	56735381	56754037	STAT2	18656	0.478827
chr12	56754354	56756583	APOF	2229	0.493943
chr12	56810156	56843200	TIMELESS	33044	0.466378
chr12	56843285	56848435	MIP	5150	0.465825
chr12	56846422	56862950	MIP	16528	0.473500
chr12	56862300	56864767	SPRYD4	2467	0.505067
chr12	56864735	56882181	GLS2	17446	0.470366
chr12	56915608	56989980	RBMS2	74372	0.440448
chr12	56989379	57030163	BAZ2A	40784	0.485877
chr12	57031958	57039852	ATP5B	7894	0.454269
chr12	57037463	57037538	SNORD59B	75	0.426667
chr12	57038810	57038885	SNORD59A	75	0.373333
chr12	57057124	57082078	PTGES3	24954	0.440290
chr12	57106210	57119326	NACA	13116	0.485971
chr12	57125363	57146146	PRIM1	20783	0.427898
chr12	57157018	57157045	DQ590166	27	0.518519
chr12	57157107	57181574	HSD17B6	24467	0.449544
chr12	57316937	57328189	SDR9C7	11252	0.477604
chr12	57345215	57351418	RDH16	6203	0.497824
chr12	57388354	57390469	GPR182	2115	0.564066
chr12	57392616	57400297	ZBTB39	7681	0.500846
chr12	57403780	57410344	TAC3	6564	0.492687
chr12	57422300	57443901	MYO1A	21601	0.487246
chr12	57449425	57472574	TMEM194A	23149	0.429867
chr12	57482676	57489259	NAB2	6583	0.602157
chr12	57489186	57505196	STAT6	16010	0.527545
chr12	57522281	57607125	LRP1	84844	0.562562
chr12	57588286	57588359	MIR1228	73	0.753425
chr12	57610577	57620232	NXPH4	9655	0.602071
chr12	57610577	57620232	NXPH4	9655	0.602071
chr12	57623355	57628718	SHMT2	5363	0.571136
chr12	57628685	57634475	NDUFA4L2	5790	0.620380
chr12	57637241	57644976	STAC3	7735	0.510795
chr12	57637241	57644976	STAC3	7735	0.510795
chr12	57647547	57704246	R3HDM2	56699	0.438773
chr12	57828542	57844609	INHBC	16067	0.468102
chr12	57849095	57851791	INHBE	2696	0.542285
chr12	57853917	57866047	GLI1	12130	0.549547
chr12	57866037	57873633	ARHGAP9	7596	0.555819
chr12	57881719	57910438	MARS	28719	0.481528
chr12	57910370	57914300	DDIT3	3930	0.494402
chr12	57916658	57923931	MBD6	7273	0.574178
chr12	57923832	57941114	DCTN2	17282	0.480731
chr12	57943846	57978554	KIF5A	34708	0.476979
chr12	57978688	57980411	BC033961	1723	0.467208
chr12	57984941	57997211	PIP4K2C	12270	0.468052
chr12	57998603	58003583	DTX3	4980	0.555020
chr12	58003962	58011028	ARHGEF25	7066	0.577130
chr12	58006121	58011828	BC073932	5707	0.547223
chr12	58013692	58019934	SLC26A10	6242	0.560077
chr12	58019677	58027022	B4GALNT1	7345	0.576038
chr12	58034965	58034984	JA611266	19	0.578947
chr12	58087737	58115340	OS9	27603	0.439880
chr12	58118075	58132029	AGAP2	13954	0.578615
chr12	58120022	58122139	AGAP2-AS1	2117	0.661313
chr12	58138783	58142026	TSPAN31	3243	0.476719
chr12	58141509	58146230	CDK4	4721	0.505613
chr12	58145424	58145484	DM110804	60	0.550000
chr12	58148880	58154193	MARCH9	5313	0.555054
chr12	58156116	58160976	CYP27B1	4860	0.553498
chr12	58158160	58159468	CYP27B1	1308	0.632263
chr12	58159068	58159468	CYP27B1	400	0.665000
chr12	58162350	58165914	METTL1	3564	0.523288
chr12	58166382	58176324	METTL21B	9942	0.471837
chr12	58176527	58191370	TSFM	14843	0.432325
chr12	58191159	58209852	AVIL	18693	0.477237
chr12	58204934	58204957	JA611266	23	0.521739
chr12	58213709	58240747	CTDSP2	27038	0.513537
chr12	58218391	58218475	MIR26A2	84	0.476190
chr12	58230875	58236325	AK130110	5450	0.477064
chr12	58325231	58329947	LOC100506844	4716	0.400551
chr12	58335444	58351052	XRCC6BP1	15608	0.406522
chr12	58959742	59175498	AK093124	215756	0.372342
chr12	59265936	59314319	LRIG3	48383	0.391294
chr12	59762831	59762932	U6	101	0.356436
chr12	59989820	60183635	SLC16A7	193815	0.357888
chr12	62102028	62586620	FAM19A2	484592	0.367119
chr12	62654120	62803501	USP15	149381	0.347882
chr12	62860596	62991363	MON2	130767	0.362630
chr12	62995530	62997214	C12orf61	1684	0.556413
chr12	62997465	62997549	MIRLET7I	84	0.535714
chr12	63037762	63328665	PPM1H	290903	0.426616
chr12	63536538	63546590	AVPR1A	10052	0.403900
chr12	63952692	64062354	DPY19L2	109662	0.361930
chr12	64173582	64203338	TMEM5	29756	0.384964
chr12	64238540	64541613	SRGAP1	303073	0.393757
chr12	64586418	64616076	C12orf66	29658	0.399589
chr12	64616116	64790841	BC042855	174725	0.414737
chr12	64660762	64784345	C12orf56	123583	0.415729
chr12	64798152	64842463	XPOT	44311	0.398953
chr12	64845839	64895899	TBK1	50060	0.377767
chr12	65004292	65091347	RASSF3	87055	0.434806
chr12	65016288	65016385	MIR548Z	97	0.340206
chr12	65016288	65016385	MIR548C	97	0.340206
chr12	65107221	65153226	GNS	46005	0.421954
chr12	65218351	65274798	TBC1D30	56447	0.415381
chr12	65277553	65371302	FLJ41278	93749	0.407567
chr12	65332802	65332897	U6atac	95	0.400000
chr12	65444403	65515346	WIF1	70943	0.383153
chr12	65563350	65642141	LEMD3	78791	0.355332
chr12	65672766	65860687	MSRB3	187921	0.368650
chr12	65938017	65951091	BC043551	13074	0.428943
chr12	66151799	66220754	RPSAP52	68955	0.410036
chr12	66218239	66360071	HMGA2	141832	0.391858
chr12	66249726	66275821	AK128707	26095	0.390496
chr12	66516848	66524533	LLPH	7685	0.415875
chr12	66530716	66563807	TMBIM4	33091	0.380496
chr12	66582977	66648394	IRAK3	65417	0.399850
chr12	66696334	66737423	HELB	41089	0.391613
chr12	66741210	67072925	GRIP1	331715	0.391601
chr12	67663060	67708388	CAND1	45328	0.366109
chr12	67913861	67960906	AK055974	47045	0.408481
chr12	68042511	68056444	DYRK2	13933	0.444269
chr12	68102826	68123221	BC035381	20395	0.420152
chr12	68383224	68415107	AK124066	31883	0.388263
chr12	68548549	68553521	IFNG	4972	0.360217
chr12	68595128	68619571	IL26	24443	0.362762
chr12	68642024	68647281	IL22	5257	0.399658
chr12	68688345	68726161	MDM1	37816	0.378015
chr12	69004618	69054385	RAP1B	49767	0.392429
chr12	69021013	69021155	SNORA70G	142	0.528169
chr12	69068150	69080639	LOC100507250	12489	0.417808
chr12	69080730	69136473	NUP107	55743	0.392659
chr12	69139935	69159853	SLC35E3	19918	0.427302
chr12	69198216	69199274	LOC100130075	1058	0.519849
chr12	69201970	69239320	MDM2	37350	0.390228
chr12	69244955	69326979	CPM	82024	0.414940
chr12	69633316	69668138	CPSF6	34822	0.357820
chr12	69666936	69666998	MIR1279	62	0.290323
chr12	69742133	69748013	LYZ	5880	0.366497
chr12	69753531	69784576	YEATS4	31045	0.393042
chr12	69864128	69973562	FRS2	109434	0.379060
chr12	69978501	69978603	MIR3913-1	102	0.333333
chr12	69978502	69978602	MIR3913-2	100	0.330000
chr12	69979207	69995357	CCT2	16150	0.393746
chr12	70002344	70004942	LRRC10	2598	0.496921
chr12	70047388	70093196	BEST3	45808	0.404711
chr12	70107414	70132348	BC042465	24934	0.369335
chr12	70132630	70216984	RAB3IP	84354	0.382365
chr12	70320436	70352503	C12orf28	32067	0.404777
chr12	70636773	70748773	CNOT2	112000	0.351473
chr12	70760061	70828072	KCNMB4	68011	0.396833
chr12	70861864	70932592	BC031864	70728	0.403461
chr12	70910631	71031220	PTPRB	120589	0.398071
chr12	71031852	71314584	PTPRR	282732	0.376424
chr12	71518876	71551779	TSPAN8	32903	0.367900
chr12	71833549	71980088	LGR5	146539	0.385713
chr12	71869656	71869910	7SK	254	0.409449
chr12	72003378	72057749	ZFC3H1	54371	0.357396
chr12	72057676	72074428	THAP2	16752	0.360494
chr12	72079877	72097839	TMEM19	17962	0.394165
chr12	72148657	72181150	RAB21	32493	0.376050
chr12	72233486	72320629	TBC1D15	87143	0.370173
chr12	72242073	72244763	MRS2P2	2690	0.404461
chr12	72332625	72426221	TPH2	93596	0.398874
chr12	72656326	72667289	TRHDE-AS1	10963	0.390587
chr12	72666528	73059422	TRHDE	392894	0.355597
chr12	74526955	74686411	LOC100507377	159456	0.357898
chr12	74851181	74851255	TRNA	74	0.527027
chr12	74931550	74935232	ATXN7L3B	3682	0.479087
chr12	75433857	75603528	KCNC2	169671	0.342127
chr12	75628519	75645645	AK093193	17126	0.332944
chr12	75669758	75723836	CAPS2	54078	0.345353
chr12	75728462	75764169	GLIPR1L1	35707	0.338589
chr12	75784849	75826177	GLIPR1L2	41328	0.349787
chr12	75874512	75895716	GLIPR1	21204	0.377240
chr12	75891418	75905418	KRR1	14000	0.349643
chr12	76082922	76083049	SNORA70	127	0.480315
chr12	76419226	76425556	PHLDA1	6330	0.441074
chr12	76438671	76478738	NAP1L1	40067	0.367410
chr12	76738265	76742222	BBS10	3957	0.373263
chr12	76745577	76953589	OSBPL8	208012	0.364791
chr12	77157853	77247474	ZDHHC17	89621	0.359425
chr12	77252495	77272799	CSRP2	20304	0.423463
chr12	77415025	77459360	E2F7	44335	0.401827
chr12	78225068	78606790	NAV3	381722	0.349645
chr12	78720459	78753526	BC045810	33067	0.354765
chr12	78883658	78885294	BC047615	1636	0.359413
chr12	79439432	79845788	SYT1	406356	0.362303
chr12	79813036	79813101	MIR1252	65	0.261538
chr12	79850650	79850672	MIR5692B	22	0.500000
chr12	79985744	80084790	PAWR	99046	0.369939
chr12	80167342	80328978	PPP1R12A	161636	0.360167
chr12	80462470	80462537	U7	67	0.402985
chr12	80603232	80772870	OTOGL	169638	0.360297
chr12	80838125	81073968	PTPRQ	235843	0.349126
chr12	81101407	81103256	MYF6	1849	0.519200
chr12	81110707	81113447	MYF5	2740	0.446715
chr12	81156932	81164494	BC037383	7562	0.360090
chr12	81186299	81189685	AK022997	3386	0.341110
chr12	81191170	81331694	LIN7A	140524	0.368421
chr12	81226311	81226408	MIR617	97	0.453608
chr12	81329514	81329612	MIR618	98	0.459184
chr12	81471808	81649582	ACSS3	177774	0.354371
chr12	81552166	81552240	MIR4699	74	0.364865
chr12	81652044	82153109	PPFIA2	501065	0.344833
chr12	82746082	82752199	CCDC59	6117	0.350826
chr12	82752275	82873016	METTL25	120741	0.352962
chr12	83080933	83528067	TMTC2	447134	0.374076
chr12	83415668	83415771	U6	103	0.407767
chr12	85253266	85306608	SLC6A15	53342	0.342282
chr12	85258115	85259169	BC045559	1054	0.387097
chr12	85408093	85430055	TSPAN19	21962	0.341772
chr12	85430098	85638883	LRRIQ1	208785	0.336562
chr12	85674035	85695561	ALX1	21526	0.316222
chr12	86198330	86230318	RASSF9	31988	0.343754
chr12	86268072	86276770	NTS	8698	0.293861
chr12	86373036	87232681	MGAT4C	859645	0.346755
chr12	86946651	86946729	MIR548AL	78	0.256410
chr12	88176662	88178488	MKRN9P	1826	0.514239
chr12	88373815	88423176	C12orf50	49361	0.354916
chr12	88429267	88443937	C12orf29	14670	0.357873
chr12	88442789	88535993	CEP290	93204	0.339041
chr12	88448974	88452835	BC033323	3861	0.369075
chr12	88536072	88593664	TMTC3	57592	0.345951
chr12	88886569	88974250	KITLG	87681	0.367058
chr12	88975415	88975573	U1	158	0.436709
chr12	89404902	89413469	LOC728084	8567	0.365472
chr12	89741836	89746296	DUSP6	4460	0.478475
chr12	89913189	89918583	GALNT4	5394	0.395254
chr12	89981825	90049844	ATP2B1	68019	0.359650
chr12	90102731	90105729	LINC00936	2998	0.502001
chr12	91311799	91342446	LINC00615	30647	0.367801
chr12	91345991	91348953	CCER1	2962	0.486833
chr12	91357455	91398803	EPYC	41348	0.348602
chr12	91444270	91452131	KERA	7861	0.346394
chr12	91497231	91505542	LUM	8311	0.359163
chr12	91539034	91573359	DCN	34325	0.347968
chr12	92378751	92536447	LOC256021	157696	0.384055
chr12	92534053	92539673	BTG1	5620	0.424555
chr12	92539860	92561336	BC044741	21476	0.402263
chr12	92813869	92821924	CLLU1OS	8055	0.387585
chr12	92860454	92877456	CLLU1	17002	0.390189
chr12	92817734	92824778	CLLU1	7044	0.392533
chr12	93096618	93102325	C12orf74	5707	0.427896
chr12	93130264	93165868	PLEKHG7	35604	0.397455
chr12	93166284	93323107	EEA1	156823	0.370354
chr12	93397533	93771512	LOC643339	373979	0.416916
chr12	93771700	93797024	NUDT4	25324	0.422682
chr12	93802087	93836026	UBE2N	33939	0.401190
chr12	93861265	93897548	MRPL42	36283	0.393821
chr12	93936238	93965544	SOCS2-AS1	29306	0.429229
chr12	93959403	93965174	SOCS2-AS1	5771	0.525386
chr12	93966301	93970521	SOCS2	4220	0.450237
chr12	93965456	93969979	SOCS2	4523	0.500774
chr12	94071150	94244531	CRADD	173381	0.401832
chr12	94101566	94131599	AK130911	30033	0.388573
chr12	94402514	94402823	7SK	309	0.433657
chr12	94542498	94701451	PLXNC1	158953	0.437482
chr12	94702055	94853764	CCDC41	151709	0.377064
chr12	94853778	94856344	CCDC41-AS1	2566	0.437646
chr12	94955564	94955635	MIR5700	71	0.338028
chr12	94960899	95044324	TMCC3	83425	0.431082
chr12	95228173	95228804	KRT19P2	631	0.545166
chr12	95365103	95397489	NDUFA12	32386	0.409189
chr12	95414004	95467404	NR2C1	53400	0.395206
chr12	95470524	95611240	FGD6	140716	0.410039
chr12	95611521	95696566	VEZT	85045	0.386019
chr12	95702195	95702289	MIR331	94	0.510638
chr12	95703698	95703760	MIR3685	62	0.451613
chr12	95867821	95909613	METAP2	41792	0.390721
chr12	95910887	95942620	USP44	31733	0.416664
chr12	96043030	96067770	PGAM1P5	24740	0.410469
chr12	96051582	96184536	NTN4	132954	0.400011
chr12	96252708	96260238	SNRPF	7530	0.380744
chr12	96260825	96336428	CCDC38	75603	0.398582
chr12	96337070	96362370	AMDHD1	25300	0.438696
chr12	96366439	96390143	HAL	23704	0.433640
chr12	96394530	96429439	LTA4H	34909	0.381735
chr12	96588206	96661606	ELK3	73400	0.453351
chr12	96672038	96794366	CDK17	122328	0.378262
chr12	96697152	96697291	U4	139	0.388489
chr12	96820977	96821264	7SK	287	0.550523
chr12	96883352	96934765	C12orf55	51413	0.398751
chr12	96933914	97024429	AX747187	90515	0.376037
chr12	97041752	97159032	C12orf63	117280	0.385513
chr12	97301000	97347469	NEDD1	46469	0.350277
chr12	97858798	97927544	RMST	68746	0.364472
chr12	97866326	97868402	AK129935	2076	0.350193
chr12	97885686	97885756	MIR1251	70	0.557143
chr12	97957589	97957689	MIR135A2	100	0.320000
chr12	98123825	98150295	LOC643711	26470	0.390480
chr12	98389160	98389226	MIR4303	66	0.439394
chr12	98847618	98850923	SLC9A7P1	3305	0.491982
chr12	98879321	98897633	LOC643770	18312	0.443152
chr12	98906750	98910004	TMPO-AS1	3254	0.481254
chr12	98909350	98929412	TMPO	20062	0.418403
chr12	98987402	98995778	SLC25A3	8376	0.418577
chr12	98993412	98993662	SNORA53	250	0.392000
chr12	99018029	99038829	IKBIP	20800	0.420577
chr12	99039077	99129211	APAF1	90134	0.394257
chr12	99128568	100378432	ANKS1B	1249864	0.378340
chr12	100041527	100043892	FAM71C	2365	0.480338
chr12	100420028	100421318	BC062763	1290	0.418605
chr12	100430862	100536642	UHRF1BP1L	105780	0.387077
chr12	100550174	100552981	GOLGA2P5	2807	0.574279
chr12	100551200	100551229	DQ583972	29	0.551724
chr12	100551624	100551660	DQ579681	36	0.555556
chr12	100558827	100567121	GOLGA2P5	8294	0.497589
chr12	100559874	100559906	DQ571064	32	0.593750
chr12	100583661	100583727	MIR1827	66	0.484848
chr12	100593864	100618202	ACTR6	24338	0.392103
chr12	100597446	100615569	AX746635	18123	0.376097
chr12	100646041	100660857	DEPDC4	14816	0.395113
chr12	100661548	100733914	SCYL2	72366	0.379115
chr12	100750856	100815837	SLC17A8	64981	0.422508
chr12	100897137	100957645	NR1H4	60508	0.398162
chr12	100967488	101018685	GAS2L3	51197	0.368029
chr12	101188373	101522419	ANO4	334046	0.388776
chr12	101549993	101604016	SLC5A8	54023	0.383466
chr12	101673904	101780397	UTP20	106493	0.393059
chr12	101786902	101801572	ARL1	14670	0.394479
chr12	101871335	101880775	SPIC	9440	0.422987
chr12	101988708	102079658	MYBPC1	90950	0.383375
chr12	102091416	102122846	CHPT1	31430	0.378587
chr12	102122425	102133250	SYCP3	10825	0.367113
chr12	102139274	102224645	GNPTAB	85371	0.409038
chr12	102159183	102159287	U6	104	0.413462
chr12	102271104	102317401	DRAM1	46297	0.432555
chr12	102406716	102455899	CCDC53	49183	0.363357
chr12	102467972	102512361	NUP37	44389	0.362725
chr12	102513955	102591298	PARPBP	77343	0.364506
chr12	102590236	102591614	PMCH	1378	0.330189
chr12	102591362	102796374	JX088243	205012	0.378061
chr12	102811453	102874378	IGF1	62925	0.399237
chr12	103203060	103218177	LINC00485	15117	0.398426
chr12	103232103	103311381	PAH	79278	0.417632
chr12	103351451	103354294	ASCL1	2843	0.512839
chr12	103695732	103889746	C12orf42	194014	0.384003
chr12	103941571	103953593	BC041342	12022	0.401597
chr12	103981068	104160502	STAB2	179434	0.431707
chr12	104166080	104234975	NT5DC3	68895	0.430351
chr12	104237526	104260329	GNN	22803	0.430470
chr12	104307804	104323989	GNN	16185	0.411369
chr12	104324111	104341708	HSP90B1	17597	0.395181
chr12	104343980	104350993	C12orf73	7013	0.431057
chr12	104359592	104382656	TDG	23064	0.406391
chr12	104382764	104444066	GLT8D2	61302	0.417931
chr12	104424968	104425046	DL490275	78	0.512821
chr12	104458235	104500304	HCFC2	42069	0.372887
chr12	104510857	104532040	NFYB	21183	0.391399
chr12	104609556	104744085	TXNRD1	134529	0.423700
chr12	104697509	104698982	EID3	1473	0.448744
chr12	104850691	105155792	CHST11	305101	0.460087
chr12	104985410	104985494	MIR3922	84	0.559524
chr12	105197274	105322472	SLC41A2	125198	0.368512
chr12	105380097	105388505	C12orf45	8408	0.416508
chr12	105413561	105478341	ALDH1L2	64780	0.396712
chr12	105501491	105562906	KIAA1033	61415	0.350973
chr12	105567074	105630008	APPL2	62934	0.436473
chr12	105724413	105765296	C12orf75	40883	0.418218
chr12	106457124	106533811	NUAK1	76687	0.459687
chr12	106631658	106641713	CKAP4	10055	0.497862
chr12	106696580	106740792	TCP11L2	44212	0.418122
chr12	106751435	106903976	POLR3B	152541	0.397473
chr12	106890187	107168609	LOC100287944	278422	0.423354
chr12	106994914	107156582	RFX4	161668	0.422984
chr12	107074535	107078478	LOC100505978	3943	0.446361
chr12	107168398	107283094	RIC8B	114696	0.384748
chr12	107347806	107349275	AK055712	1469	0.457454
chr12	107349543	107367813	C12orf23	18270	0.380733
chr12	107371068	107380944	MTERFD3	9876	0.416869
chr12	107385142	107487635	CRY1	102493	0.376328
chr12	107712196	108053419	BTBD11	341223	0.461168
chr12	108079589	108106257	PWP1	26668	0.406255
chr12	108126642	108154914	PRDM4	28272	0.410229
chr12	108168161	108170421	ASCL4	2260	0.512832
chr12	108296926	108297548	LOC728739	622	0.482315
chr12	108523510	108644313	WSCD2	120803	0.469351
chr12	108681820	108714439	CMKLR1	32619	0.500138
chr12	108909050	108913380	FICD	4330	0.566513
chr12	108915990	108955165	SART3	39175	0.425680
chr12	108956293	108963160	ISCU	6867	0.460172
chr12	108983621	108991894	TMEM119	8273	0.559531
chr12	109015679	109025854	SELPLG	10175	0.521474
chr12	109038884	109096774	CORO1C	57890	0.411435
chr12	109176465	109251359	SSH1	74894	0.485259
chr12	109273338	109294710	DAO	21372	0.484279
chr12	109252707	109277547	DAO	24840	0.466304
chr12	109304657	109458845	SVOP	154188	0.305244
chr12	109490379	109525831	USP30	35452	0.425674
chr12	109489845	109491770	USP30-AS1	1925	0.553766
chr12	109525992	109531293	ALKBH2	5301	0.506131
chr12	109535398	109548798	UNG	13400	0.472687
chr12	109577201	109706030	ACACB	128829	0.469428
chr12	109715782	109747025	FOXN4	31243	0.519700
chr12	109826523	109886176	MYO1H	59653	0.445812
chr12	109886459	109915155	KCTD10	28696	0.475815
chr12	109915427	109974510	UBE3B	59083	0.462722
chr12	109991520	110011358	MMAB	19838	0.520718
chr12	110011499	110035071	MVK	23572	0.520066
chr12	110152186	110208312	FAM222A	56126	0.526922
chr12	110172013	110211292	FAM222A-AS1	39279	0.510527
chr12	110220891	110271212	TRPV4	50321	0.520459
chr12	110271152	110271241	MIR4497	89	0.831461
chr12	110288747	110318293	GLTP	29546	0.490591
chr12	110338078	110355874	TCHP	17796	0.501798
chr12	110367606	110434194	GIT2	66588	0.434373
chr12	110437234	110477235	ANKRD13A	40001	0.438514
chr12	110478982	110511439	C12orf76	32457	0.467234
chr12	110478982	110505500	C12orf76	26518	0.471340
chr12	110487164	110511439	C12orf76	24275	0.465705
chr12	110562139	110656600	IFT81	94461	0.399054
chr12	110719031	110788897	ATP2A2	69866	0.431970
chr12	110719702	110719761	JA611269	59	0.796610
chr12	110810704	110841535	ANAPC7	30831	0.458662
chr12	110872705	110888158	ARPC3	15453	0.458293
chr12	110890290	110906526	GPN3	16236	0.441365
chr12	110906231	110928192	FAM216A	21961	0.437230
chr12	110929329	110939916	VPS29	10587	0.405214
chr12	110934156	110934226	SNORD50	70	0.371429
chr12	110940004	110969891	RAD9B	29887	0.422123
chr12	110972236	111021064	PPTC7	48828	0.429221
chr12	111051831	111086935	TCTN1	35104	0.443596
chr12	111086490	111126962	HVCN1	40472	0.488288
chr12	111157612	111180783	PPP1CC	23171	0.416167
chr12	111284810	111345338	CCDC63	60528	0.477680
chr12	111348623	111358404	MYL2	9781	0.470811
chr12	111374405	111375250	LOC100131138	845	0.502959
chr12	111471827	111788358	CUX2	316531	0.492827
chr12	111798454	111806925	FAM109A	8471	0.579388
chr12	111843751	111889427	SH2B3	45676	0.540218
chr12	111890017	112037480	ATXN2	147463	0.419875
chr12	112079949	112123790	BRAP	43841	0.444082
chr12	112123856	112194911	ACAD10	71055	0.471170
chr12	112204690	112247789	ALDH2	43099	0.493237
chr12	112277572	112280706	MAPKAPK5-AS1	3134	0.536056
chr12	112277572	112279710	MAPKAPK5-AS1	2138	0.449018
chr12	112280031	112331228	MAPKAPK5	51197	0.437233
chr12	112336866	112339706	ADAM1A	2840	0.452465
chr12	112369086	112451023	TMEM116	81937	0.402846
chr12	112451151	112461024	ERP29	9873	0.475641
chr12	112464492	112546635	NAA25	82143	0.413851
chr12	112563348	112591408	TRAFD1	28060	0.448468
chr12	112597991	112819896	HECTD4	221905	0.432392
chr12	112842993	112847443	RPL6	4450	0.426742
chr12	112856535	112947717	PTPN11	91182	0.431138
chr12	113229548	113336684	RPH3A	107136	0.451688
chr12	113344738	113357712	OAS1	12974	0.427779
chr12	113376248	113411054	OAS3	34806	0.468741
chr12	113416273	113449528	OAS2	33255	0.438009
chr12	113495661	113535833	DTX1	40172	0.533655
chr12	113536623	113573559	RASAL1	36936	0.514945
chr12	113587662	113597081	CCDC42B	9419	0.553243
chr12	113594977	113623284	DDX54	28307	0.540750
chr12	113623554	113630119	C12orf52	6565	0.510891
chr12	113633245	113658880	IQCD	25635	0.476887
chr12	113659259	113736389	TPCN1	77130	0.505316
chr12	113736570	113772925	SLC24A6	36355	0.508678
chr12	113796370	113827458	PLBD2	31088	0.513960
chr12	113830250	113841692	SDS	11442	0.527093
chr12	113860215	113876081	SDSL	15866	0.508257
chr12	113900693	113909877	LHX5	9184	0.619882
chr12	114182381	114211488	AK096932	29107	0.491119
chr12	114254542	114404176	RBM19	149634	0.504304
chr12	114791734	114843968	TBX5	52234	0.455738
chr12	114845999	114850637	TBX5-AS1	4638	0.499138
chr12	114846558	114850637	TBX5-AS1	4079	0.495219
chr12	114942680	114942992	7SK	312	0.512821
chr12	114943424	114943691	7SK	267	0.404494
chr12	115108058	115121969	TBX3	13911	0.472719
chr12	116396380	116714991	MED13L	318611	0.372771
chr12	116586364	116586459	MIR620	95	0.210526
chr12	116866056	116866123	MIR4472-2	67	0.582090
chr12	116971226	116973326	LINC00173	2100	0.527619
chr12	116997185	117014425	MAP1LC3B2	17240	0.430974
chr12	117153595	117175843	C12orf49	22248	0.435050
chr12	117176095	117291436	RNFT2	115341	0.471324
chr12	117298224	117319232	HRK	21008	0.494098
chr12	117348760	117468953	FBXW8	120193	0.432629
chr12	117476727	117537251	TESC	60524	0.513862
chr12	117581584	117628300	FBXO21	46716	0.443617
chr12	117645946	117799607	NOS1	153661	0.473868
chr12	117890816	118406028	KSR2	515212	0.446482
chr12	118454505	118470042	RFC5	15537	0.460900
chr12	118470491	118498951	WSB2	28460	0.457625
chr12	118501397	118541810	VSIG10	40413	0.477025
chr12	118573869	118583390	PEBP1	9521	0.488709
chr12	118587605	118810750	TAOK3	223145	0.397136
chr12	118814357	118855840	SUDS3	41483	0.443748
chr12	119419299	119600856	SRRM4	181557	0.441448
chr12	119616594	119632551	HSPB8	15957	0.465752
chr12	119722061	119722923	BC118554	862	0.459397
chr12	119772516	119978852	CCDC60	206336	0.437781
chr12	119825795	120032306	AF086288	206511	0.432427
chr12	120031263	120079363	TMEM233	48100	0.438441
chr12	120068894	120069191	7SK	297	0.468013
chr12	120105760	120119429	PRKAB1	13669	0.474870
chr12	120123594	120315095	CIT	191501	0.437376
chr12	120151438	120151529	MIR1178	91	0.571429
chr12	120427647	120532299	CCDC64	104652	0.438253
chr12	120532898	120554643	RAB35	21745	0.552357
chr12	120532898	120554643	RAB35	21745	0.552357
chr12	120554710	120556800	AK130486	2090	0.525359
chr12	120565013	120632513	GCN1L1	67500	0.496711
chr12	120593237	120593303	MIR4498	66	0.606061
chr12	120634502	120639014	RPLP0	4512	0.489583
chr12	120639093	120650631	PXN-AS1	11538	0.493066
chr12	120648241	120703574	PXN	55333	0.530063
chr12	120655864	120657920	PXN	2056	0.558852
chr12	120740123	120751045	SIRT4	10922	0.488189
chr12	120759913	120765592	PLA2G1B	5679	0.451312
chr12	120779132	120806983	MSI1	27851	0.540088
chr12	120875892	120878545	COX6A1	2653	0.482473
chr12	120881763	120884215	TRIAP1	2452	0.445351
chr12	120884240	120901556	GATC	17316	0.466851
chr12	120899470	120907558	SRSF9	8088	0.464886
chr12	120933858	120936298	DYNLL1	2440	0.507377
chr12	120928140	120933749	DYNLL1-AS1	5609	0.463006
chr12	120941081	120966964	COQ5	25883	0.460573
chr12	120972131	121015397	RNF10	43266	0.452388
chr12	121016847	121019201	POP5	2354	0.487256
chr12	121078421	121105127	CABP1	26706	0.519059
chr12	121124948	121139667	MLEC	14719	0.472722
chr12	121148237	121161443	UNC119B	13206	0.481826
chr12	121163570	121177811	ACADS	14241	0.554245
chr12	121200312	121342155	SPPL3	141843	0.408769
chr12	121407640	121410095	HNF1A-AS1	2455	0.468839
chr12	121416548	121440314	HNF1A	23766	0.520702
chr12	121440847	121454300	C12orf43	13453	0.481380
chr12	121458094	121477045	OASL	18951	0.486940
chr12	121530173	121530205	DQ570466	32	0.468750
chr12	121570621	121624354	P2RX7	53733	0.464668
chr12	121647663	121671909	P2RX4	24246	0.503877
chr12	121675494	121734556	CAMKK2	59062	0.505486
chr12	121746047	121790265	ANAPC5	44218	0.428626
chr12	121837885	121862155	RNF34	24270	0.434405
chr12	121866899	122018920	KDM2B	152021	0.507009
chr12	122064454	122079946	ORAI1	15492	0.537310
chr12	122089292	122107560	MORN3	18268	0.510729
chr12	122150657	122219974	TMEM120B	69317	0.519281
chr12	122215659	122231594	RHOF	15935	0.555570
chr12	122233174	122235736	AK095700	2562	0.596799
chr12	122237077	122240852	LOC338799	3775	0.576689
chr12	122242637	122270562	SETD1B	27925	0.563474
chr12	122277432	122296769	HPD	19337	0.515178
chr12	122326636	122355771	PSMD9	29135	0.474378
chr12	122356462	122441832	WDR66	85370	0.464730
chr12	122454125	122454146	JB023063	21	0.523810
chr12	122459860	122499950	BCL7A	40090	0.529434
chr12	122516651	122628967	MLXIP	112316	0.278785
chr12	122667666	122688018	LRRC43	20352	0.515379
chr12	122656576	122658746	IL31	2170	0.490783
chr12	122688227	122692084	B3GNT4	3857	0.621208
chr12	122692208	122712068	DIABLO	19860	0.470342
chr12	122716093	122751068	VPS33A	34975	0.445976
chr12	122755980	122907116	CLIP1	151136	0.438678
chr12	122880088	122884491	LOC100507066	4403	0.431524
chr12	122956145	122985543	ZCCHC8	29398	0.426219
chr12	122976659	122976788	SNORA9	129	0.465116
chr12	122989189	123011560	RSRC2	22371	0.396540
chr12	123011808	123110947	KNTC1	99139	0.412360
chr12	123185839	123187904	HCAR2	2065	0.515254
chr12	123199302	123201439	HCAR3	2137	0.508189
chr12	123212152	123215129	HCAR1	2977	0.503527
chr12	123237370	123255953	DENR	18583	0.421676
chr12	123259055	123311927	CCDC62	52872	0.447193
chr12	123320038	123347507	HIP1R	27469	0.590739
chr12	123349874	123380712	VPS37B	30838	0.471723
chr12	123413538	123451056	ABCB9	37518	0.524362
chr12	123459353	123464588	OGFOD2	5235	0.595224
chr12	123464879	123467460	ARL6IP4	2581	0.664084
chr12	123468026	123595035	PITPNM2	127009	0.524482
chr12	123495213	123495275	MIR4304	62	0.596774
chr12	123565930	123569291	LOC100507091	3361	0.532580
chr12	123640945	123706442	MPHOSPH9	65497	0.427348
chr12	123717843	123742506	C12orf65	24663	0.470746
chr12	123745516	123756687	CDK2AP1	11171	0.592069
chr12	123773655	123834988	SBNO1	61333	0.426328
chr12	123868703	123893900	SETD8	25197	0.515101
chr12	123899935	123921264	RILPL2	21329	0.488068
chr12	123942650	123950941	SNRNP35	8291	0.491738
chr12	123955908	124018265	RILPL1	62357	0.505589
chr12	124020955	124021081	MIR3908	126	0.317460
chr12	124069075	124082688	TMED2	13613	0.424815
chr12	124086671	124105482	DDX55	18811	0.457658
chr12	124105569	124118323	EIF2B1	12754	0.458915
chr12	124118285	124147151	GTF2H3	28866	0.428463
chr12	124155659	124192950	TCTN2	37291	0.457027
chr12	124196864	124246301	ATP6V0A2	49437	0.444121
chr12	124247041	124420267	DNAH10	173226	0.462586
chr12	124420954	124457163	CCDC92	36209	0.466238
chr12	124773709	124800570	FAM101A	26861	0.565206
chr12	124457761	124499986	ZNF664	42225	0.430409
chr12	124808956	125052010	NCOR2	243054	0.573593
chr12	124968242	124972421	BC017209	4179	0.592486
chr12	125262173	125348519	SCARB1	86346	0.516943
chr12	125282308	125282328	JB074994	20	0.900000
chr12	125396191	125399587	UBC	3396	0.550353
chr12	125400092	125400205	MIR5188	113	0.398230
chr12	125420000	125420441	AX721264	441	0.455782
chr12	125431369	125473667	DHX37	42298	0.540215
chr12	125478193	125510349	BRI3BP	32156	0.492754
chr12	125510477	125511627	DL490908	1150	0.464348
chr12	125549924	125627871	AACS	77947	0.512233
chr12	125811161	126143589	TMEM132B	332428	0.426309
chr12	126443233	126464994	LINC00939	21761	0.404669
chr12	126927026	126957331	LOC100128554	30305	0.410559
chr12	127215246	127256808	LINC00944	41562	0.409388
chr12	127221552	127230800	LINC00943	9248	0.411981
chr12	127354039	127359236	LOC440117	5197	0.415240
chr12	127399773	127544942	BC032874	145169	0.396841
chr12	128366161	128383184	FLJ37505	17023	0.400811
chr12	128399954	128436097	LINC00507	36143	0.403481
chr12	128751947	129192460	TMEM132C	440513	0.450416
chr12	128778636	128778723	MIR3612	87	0.540230
chr12	129277738	129308541	SLC15A4	30803	0.458754
chr12	129297748	129299068	AK001057	1320	0.470455
chr12	129338080	129469509	GLT1D1	131429	0.458225
chr12	129556270	130388212	TMEM132D	831942	0.426697
chr12	129594241	129597843	BC073948	3602	0.491671
chr12	130518356	130526887	LOC100190940	8531	0.459266
chr12	130636137	130646223	FZD10-AS1	10086	0.486615
chr12	130647003	130650285	FZD10	3282	0.583790
chr12	130822432	130856877	PIWIL1	34445	0.427696
chr12	130880680	131002462	RIMBP2	121782	0.503810
chr12	131274144	131323819	STX2	49675	0.458702
chr12	131356616	131360826	RAN	4210	0.476485
chr12	131438451	131626008	GPR133	187557	0.518760
chr12	131510105	131512357	AX748157	2252	0.517762
chr12	131649555	131697476	LOC116437	47921	0.460863
chr12	131780655	131782517	BC042649	1862	0.607948
chr12	131832014	131852100	LOC338797	20086	0.479787
chr12	132195631	132284283	SFSWAP	88652	0.464502
chr12	132312940	132336316	MMP17	23376	0.619225
chr12	132379278	132407707	ULK1	28429	0.623624
chr12	132413812	132428406	PUS1	14594	0.513636
chr12	132434464	132565011	EP400	130547	0.474565
chr12	132515768	132515905	SNORA49	137	0.481752
chr12	132560245	132565011	EP400	4766	0.453210
chr12	132568827	132593444	EP400NL	24617	0.460698
chr12	132602690	132613429	EP400NL	10739	0.481237
chr12	132621139	132628880	DDX51	7741	0.605219
chr12	132628992	132636986	NOC4L	7994	0.638979
chr12	132680916	132905905	GALNT9	224989	0.325136
chr12	132849278	132851810	AX747752	2532	0.586493
chr12	132851976	132857486	LOC100130238	5510	0.587477
chr12	133067156	133161773	FBRSL1	94617	0.625363
chr12	133127853	133131533	AK096230	3680	0.629348
chr12	133179735	133187037	LRCOL1	7302	0.570255
chr12	133195402	133198972	P2RX2	3570	0.670028
chr12	133200347	133263945	POLE	63598	0.508428
chr12	133264191	133281577	PXMP2	17386	0.523870
chr12	133287392	133299323	PGAM5	11931	0.550918
chr12	133302253	133338451	ANKLE2	36198	0.510222
chr12	133345494	133405288	GOLGA3	59794	0.534903
chr12	133416937	133464204	CHFR	47267	0.502169
chr12	133485300	133487790	AK055957	2490	0.497992
chr12	133498018	133532892	ZNF605	34874	0.464730
chr12	133562933	133589154	ZNF26	26221	0.437931
chr12	133609244	133613808	BC033344	4564	0.420465
chr12	133613979	133639885	ZNF84	25906	0.390682
chr12	133657036	133684258	ZNF140	27222	0.407501
chr12	133696554	133707059	ZNF891	10505	0.407139
chr12	133757994	133783697	ZNF268	25703	0.414699
chr12	133707213	133736049	ZNF10	28836	0.399674
chr12	133794897	133812422	ANHX	17525	0.536491
chr13	19312239	19314239	LINC00417	2000	0.511500
chr13	19319691	19319719	DQ586768	28	0.500000
chr13	19381509	19381539	DQ579288	30	0.433333
chr13	19382526	19382564	DQ587539	38	0.578947
chr13	19408542	19446109	ANKRD20A9P	37567	0.375303
chr13	19479578	19500881	BC035261	21303	0.363235
chr13	19536750	19536777	DQ572285	27	0.518519
chr13	19582398	19586774	LINC00442	4376	0.459781
chr13	19717121	19717217	RNU6-52P	96	0.375000
chr13	19747909	19755992	TUBA3C	8083	0.510578
chr13	19836939	19919113	ANKRD26P3	82174	0.373561
chr13	19919188	19920889	LINC00421	1701	0.579071
chr13	19997018	20110903	TPTE2	113885	0.384519
chr13	20207787	20247599	MPHOSPH8	39812	0.433186
chr13	20277008	20357159	PSPC1	80151	0.414780
chr13	20397623	20437776	ZMYM5	40153	0.426095
chr13	20532809	20665968	ZMYM2	133159	0.376167
chr13	20553662	20554894	BC044596	1232	0.387987
chr13	20712394	20735183	GJA3	22789	0.456097
chr13	20761603	20767114	GJB2	5511	0.495191
chr13	20796100	20806534	GJB6	10434	0.463293
chr13	20977805	21100012	CRYL1	122207	0.445212
chr13	21007916	21007985	MIR4499	69	0.420290
chr13	21141207	21265576	IFT88	124369	0.387388
chr13	21277481	21297237	IL17D	19756	0.531332
chr13	21296542	21302523	AK055408	5981	0.458786
chr13	21303072	21348057	N6AMT2	44985	0.414716
chr13	21351467	21476913	XPO4	125446	0.384030
chr13	21547175	21635722	LATS2	88547	0.456763
chr13	21714652	21723224	SAP18	8572	0.427322
chr13	21727733	21750741	SKA3	23008	0.398427
chr13	21750371	21753220	MRP63	2849	0.531766
chr13	21872263	21967061	MIPEPP3	94798	0.446771
chr13	21872263	21906210	MIPEPP3	33947	0.449436
chr13	21946709	22033508	ZDHHC20	86799	0.396456
chr13	22066827	22178355	MICU2	111528	0.382989
chr13	22245214	22278640	FGF9	33426	0.429157
chr13	22446934	22452299	LINC00424	5365	0.424977
chr13	22615113	22850659	AK054845	235546	0.410536
chr13	23394480	23395172	BC048997	692	0.414740
chr13	23471168	23472320	BASP1P1	1152	0.581597
chr13	23755059	23899304	SGCG	144245	0.392360
chr13	23902961	24007867	SACS	104906	0.412617
chr13	23993109	24003008	SACS-AS1	9899	0.464390
chr13	24043650	24061603	LINC00327	17953	0.373809
chr13	24153498	24243412	TNFRSF19	89914	0.401706
chr13	24304327	24463587	MIPEP	159260	0.397689
chr13	24463591	24466242	C1QTNF9B-AS1	2651	0.453791
chr13	24465237	24471194	C1QTNF9B	5957	0.475743
chr13	24465427	24471145	C1QTNF9B	5718	0.480937
chr13	24481422	24523454	ANKRD20A19P	42032	0.384636
chr13	24734860	24881212	SPATA13	146352	0.438634
chr13	24736554	24736643	MIR2276	89	0.573034
chr13	24826886	24828577	SPATA13-AS1	1691	0.490834
chr13	24883715	24896669	C1QTNF9	12954	0.452602
chr13	24905587	24911258	BC038727	5671	0.372245
chr13	24995068	25086948	PARP4	91880	0.428820
chr13	25154345	25171812	TPTE2P6	17467	0.405737
chr13	25254548	25285923	ATP12A	31375	0.493227
chr13	25338300	25454058	RNF17	115758	0.379758
chr13	25456411	25497027	CENPJ	40616	0.413605
chr13	25498811	25501871	AK054988	3060	0.455882
chr13	25502892	25542607	TPTE2P1	39715	0.411633
chr13	25670275	25672704	PABPC3	2429	0.434335
chr13	25742671	25745857	AMER2	3186	0.578468
chr13	25749013	25754139	BC022569	5126	0.486539
chr13	25820340	25861704	MTMR6	41364	0.377526
chr13	25875665	25916561	NUPL1	40896	0.361942
chr13	25946208	26595420	ATP8A2	649212	0.417437
chr13	26618734	26625198	SHISA2	6464	0.470606
chr13	26786904	26796508	RNF6	9604	0.377030
chr13	26828755	26978569	CDK8	149814	0.369011
chr13	26963891	26967370	BC047364	3479	0.368497
chr13	27131839	27263082	WASF3	131243	0.397774
chr13	27329338	27334922	GPR12	5584	0.446812
chr13	27640286	27746033	USP12	105747	0.388578
chr13	27825691	27830702	RPL21	5011	0.413490
chr13	27829200	27829272	SNORD102	72	0.361111
chr13	27829537	27829663	SNORA27	126	0.404762
chr13	27844463	27847827	RASL11A	3364	0.538347
chr13	27998680	28009846	GTF3A	11166	0.449758
chr13	28009775	28024334	MTIF3	14559	0.420015
chr13	28120049	28194720	LNX2	74671	0.376210
chr13	28195915	28241559	POLR1D	45644	0.386031
chr13	28366779	28368089	GSX1	1310	0.665649
chr13	28494167	28500451	PDX1	6284	0.580999
chr13	28519342	28519710	ATP5EP2	368	0.421196
chr13	28536204	28543505	CDX2	7301	0.566772
chr13	28552242	28562774	PRHOXNB	10532	0.497246
chr13	28577410	28674729	FLT3	97319	0.432197
chr13	28710979	28713311	PAN3-AS1	2332	0.548885
chr13	28712642	28869475	PAN3	156833	0.374915
chr13	28874482	29069265	FLT1	194783	0.416073
chr13	28901613	28901644	HV303147	31	0.451613
chr13	29001986	29002011	HV303168	25	0.400000
chr13	29174090	29174112	DD413682	22	0.409091
chr13	29233140	29253093	POMP	19953	0.393926
chr13	29274217	29293150	SLC46A3	18933	0.402789
chr13	29598747	30080084	MTUS2	481337	0.410797
chr13	30050651	30061887	MTUS2-AS1	11236	0.470363
chr13	30083550	30169825	SLC7A1	86275	0.474378
chr13	30338544	30424820	UBL3	86276	0.364389
chr13	30446749	30462542	LINC00297	15793	0.414487
chr13	30510667	30524625	LINC00544	13958	0.463462
chr13	30776766	30881191	KATNAL1	104425	0.382734
chr13	30914406	30948036	LINC00426	33630	0.446655
chr13	31032878	31040081	HMGB1	7203	0.434680
chr13	31191829	31233686	USPL1	41857	0.386196
chr13	31287614	31338565	ALOX5AP	50951	0.456576
chr13	31377342	31384782	LINC00398	7440	0.483065
chr13	31456971	31506745	TEX26-AS1	49774	0.435267
chr13	31480311	31499709	MEDAG	19398	0.456233
chr13	31506833	31549153	TEX26	42320	0.407703
chr13	31710762	31736117	HSPH1	25355	0.365766
chr13	31774111	31906411	B3GALTL	132300	0.410695
chr13	31928478	31928508	DQ590719	30	0.433333
chr13	31937447	31937477	DQ581687	30	0.566667
chr13	31942215	31942243	DQ585583	28	0.535714
chr13	31942816	31942853	DQ585215	37	0.486486
chr13	31942973	31943035	DQ599653	62	0.500000
chr13	31947639	31947668	DQ594776	29	0.482759
chr13	31947842	31947871	DQ594776	29	0.482759
chr13	32313678	32377009	RXFP2	63331	0.392067
chr13	32420919	32527609	EEF1DP3	106690	0.394929
chr13	32598195	32605776	BC035084	7581	0.418678
chr13	32605436	32870776	FRY	265340	0.388694
chr13	32877907	32886091	ZAR1L	8184	0.423754
chr13	32889616	32973809	BRCA2	84193	0.380911
chr13	32974859	33002315	N4BP2L1	27456	0.429706
chr13	32994526	32994653	SNORA16	127	0.425197
chr13	33006929	33112936	N4BP2L2	106007	0.390295
chr13	33070350	33072629	MINOS1P1	2279	0.416411
chr13	33078642	33083532	N4BP2L2-IT2	4890	0.380982
chr13	33160563	33352158	PDS5B	191595	0.366179
chr13	33383327	33485790	LINC00423	102463	0.424085
chr13	33590570	33640282	KL	49712	0.404269
chr13	33677271	33859901	STARD13	182630	0.410327
chr13	33851690	33855471	STARD13-AS	3781	0.379000
chr13	34392205	34411644	RFC3	19439	0.358918
chr13	34403675	34403786	U5	111	0.369369
chr13	35009590	35214822	LINC00457	205232	0.399538
chr13	35516423	36246874	NBEA	730451	0.350076
chr13	36047925	36515382	MIR548F5	467457	0.395514
chr13	36342788	36705514	DCLK1	362726	0.401692
chr13	36742344	36871992	CCDC169-SOHLH2	129648	0.381171
chr13	36841304	36841411	U6	107	0.327103
chr13	36875774	36920646	SPG20	44872	0.385519
chr13	36920567	36943872	SPG20OS	23305	0.400601
chr13	37006408	37017019	CCNA1	10611	0.408161
chr13	37248048	37271975	SERTM1	23927	0.395829
chr13	37393338	37403740	RFXAP	10402	0.382811
chr13	37418967	37494409	SMAD9	75442	0.408592
chr13	37523907	37573504	ALG5	49597	0.390830
chr13	37574677	37583751	EXOSC8	9074	0.377893
chr13	37583450	37633850	SUPT20H	50400	0.356905
chr13	37677396	37679801	CSNK1A1L	2405	0.446570
chr13	38109076	38125673	LINC00547	16597	0.391818
chr13	38136718	38172981	POSTN	36263	0.329399
chr13	38210772	38443939	TRPC4	233167	0.351400
chr13	38624953	38717369	LINC00571	92416	0.362535
chr13	38923941	38937143	UFM1	13202	0.339267
chr13	39141860	39153653	LINC00366	11793	0.354024
chr13	39261172	39461267	FREM2	200095	0.376461
chr13	39540061	39564996	STOML3	24935	0.382635
chr13	39584001	39612213	PROSER1	28212	0.373281
chr13	39612447	39624244	NHLRC3	11797	0.377045
chr13	39917028	40177356	LHFP	260328	0.393911
chr13	40100011	40107556	AK021977	7545	0.387011
chr13	40229763	40326765	COG6	97002	0.342663
chr13	40238170	40238272	MIR4305	102	0.441176
chr13	40755945	40763167	LINC00332	7222	0.438383
chr13	40768645	40794639	LINC00548	25994	0.424059
chr13	40981258	40981577	7SK	319	0.438871
chr13	41129800	41240734	FOXO1	110934	0.419871
chr13	41301963	41302011	MIR320D1	48	0.479167
chr13	41303431	41345347	MRPS31	41916	0.392642
chr13	41363546	41386596	SLC25A15	23050	0.462473
chr13	41371120	41382169	TPTE2P5	11049	0.444384
chr13	41486024	41495910	SUGT1P3	9886	0.407344
chr13	41506054	41593508	ELF1	87454	0.378668
chr13	41635696	41658139	WBP4	22443	0.386223
chr13	41701708	41706936	KBTBD6	5228	0.431523
chr13	41707074	41810822	AK056182	103748	0.396750
chr13	41765710	41768702	KBTBD7	2992	0.484291
chr13	41790515	41837713	MTRF1	47198	0.396754
chr13	41792721	41793250	BC051736	529	0.347826
chr13	41793281	41794136	BC051736	855	0.446784
chr13	41885340	41951166	NAA16	65826	0.373378
chr13	41928692	41928795	U6	103	0.427184
chr13	42016699	42017902	OR7E37P	1203	0.471322
chr13	42031541	42045013	RGCC	13472	0.460362
chr13	42140960	42535221	VWA8	394261	0.371538
chr13	42535304	42555701	VWA8-AS1	20397	0.409178
chr13	42622842	42803891	DGKH	181049	0.378329
chr13	42813345	42817026	AK054970	3681	0.350992
chr13	42846288	42897403	AKAP11	51115	0.364531
chr13	43148290	43182149	TNFSF11	33859	0.415842
chr13	43355685	43365685	FAM216B	10000	0.374500
chr13	43460523	43566407	EPSTI1	105884	0.395697
chr13	43597361	43683306	DNAJC15	85945	0.381500
chr13	43787665	44203613	ENOX1	415948	0.391184
chr13	44410488	44453826	CCDC122	43338	0.366630
chr13	44453419	44468068	LACC1	14649	0.368694
chr13	44596470	44604599	LINC00284	8129	0.401771
chr13	44717286	44735393	MGC5590	18107	0.446678
chr13	44720605	44732358	SMIM2-IT1	11753	0.448141
chr13	44835105	44837066	AX748251	1961	0.457930
chr13	44947977	44971850	SERP2	23873	0.442802
chr13	44974385	44980021	BC025370	5636	0.496806
chr13	45006278	45150701	TSC22D1	144423	0.379261
chr13	45150031	45154568	TSC22D1-AS1	4537	0.547058
chr13	45373639	45383766	LINC00330	10127	0.455811
chr13	45492061	45492133	TRNA	72	0.611111
chr13	45513383	45563613	NUFIP1	50230	0.387139
chr13	45563686	45602404	KIAA1704	38718	0.388217
chr13	45694630	45858239	GTF2F2	163609	0.391549
chr13	45766987	45775175	KCTD4	8188	0.376893
chr13	45911303	45915297	TPT1	3994	0.436154
chr13	45911614	45911744	SNORA31	130	0.430769
chr13	45961719	45965618	TPT1-AS1	3899	0.453963
chr13	45967453	45992516	SLC25A30	25063	0.428281
chr13	46039029	46110833	COG3	71804	0.391399
chr13	46115431	46189874	FAM194B	74443	0.448209
chr13	46276445	46288693	SPERT	12248	0.454442
chr13	46354415	46425846	SIAH3	71431	0.447831
chr13	46536313	46626894	ZC3H13	90581	0.349853
chr13	46626982	46675482	CPB2-AS1	48500	0.391216
chr13	46627321	46679211	CPB2	51890	0.389998
chr13	46700057	46756459	LCP1	56402	0.402521
chr13	46786082	46841076	LRRC63	54994	0.368549
chr13	46858131	46858328	AY395526	197	0.426396
chr13	46870579	46871979	LINC00563	1400	0.429286
chr13	46916136	46961635	KIAA0226L	45499	0.425460
chr13	47127295	47319036	LRCH1	191741	0.399429
chr13	47345390	47371367	ESD	25977	0.346345
chr13	47405676	47471211	HTR2A	65535	0.392706
chr13	48516790	48575462	SUCLA2	58672	0.377113
chr13	48611702	48621282	NUDT15	9580	0.417745
chr13	48649863	48669277	MED4	19414	0.386886
chr13	48651272	48654129	MED4-AS1	2857	0.393770
chr13	48807273	48836232	ITM2B	28959	0.368901
chr13	48870648	48877797	LINC00441	7149	0.398797
chr13	48877882	49056026	RB1	178144	0.369145
chr13	48985181	48987653	LPAR6	2472	0.347896
chr13	49063098	49107316	RCBTB2	44218	0.402076
chr13	49151109	49155037	LINC00462	3928	0.432026
chr13	49280952	49283498	CYSLTR2	2546	0.430479
chr13	49550047	49783915	FNDC3A	233868	0.370778
chr13	49794473	49796513	MLNR	2040	0.602941
chr13	49822046	49867622	CDADC1	45576	0.384435
chr13	49882785	49975735	CAB39L	92950	0.387660
chr13	50025688	50069139	SETDB2	43451	0.375918
chr13	50069800	50103117	PHF11	33317	0.416934
chr13	50106081	50159719	RCBTB1	53638	0.422424
chr13	50202434	50208008	ARL11	5574	0.473089
chr13	50234809	50265623	EBPL	30814	0.455410
chr13	50273442	50367057	KPNA3	93615	0.387096
chr13	50464544	50467516	CTAGE10P	2972	0.419246
chr13	50486841	50510625	SPRYD7	23784	0.403338
chr13	50556687	50699677	DLEU2	142990	0.384139
chr13	50570550	50570637	MIR3613	87	0.356322
chr13	50571142	50592603	TRIM13	21461	0.403662
chr13	50589389	50595058	KCNRG	5669	0.375728
chr13	50618047	50656139	DLEU2	38092	0.349338
chr13	50623162	50623184	DM119508	22	0.454545
chr13	50975361	51205735	BCMS	230374	0.390022
chr13	50746153	50747751	ST13P4	1598	0.444305
chr13	50760015	50964427	BCMS	204412	0.396596
chr13	50892230	50892281	SNORD112	51	0.372549
chr13	51286758	51417885	DLEU7	131127	0.400352
chr13	51381990	51424041	DLEU7-AS1	42051	0.401180
chr13	51456514	51484848	RNASEH2B-AS1	28334	0.390944
chr13	51483813	51530901	RNASEH2B	47088	0.388634
chr13	51590243	51654998	GUCY1B2	64755	0.434592
chr13	51658150	51746524	LINC00371	88374	0.429730
chr13	51796469	51858377	FAM124A	61908	0.442738
chr13	51915167	51936239	SERPINE3	21072	0.408504
chr13	51922702	51922775	MIR5693	73	0.465753
chr13	51935700	52027275	INTS6	91575	0.356484
chr13	52027479	52028851	BC045725	1372	0.524781
chr13	52033095	52035515	D28359	2420	0.408678
chr13	52126724	52126803	MIR4703	79	0.303797
chr13	52158483	52336171	WDFY2	177688	0.395390
chr13	52342128	52378298	DHRS12	36170	0.472491
chr13	52387482	52419286	LINC00282	31804	0.463684
chr13	52436116	52440372	CCDC70	4256	0.472979
chr13	52439513	52440219	CCDC70	706	0.528329
chr13	52506805	52585630	ATP7B	78825	0.445544
chr13	52602940	52605241	UTP14C	2301	0.478488
chr13	52586522	52607736	UTP14C	21214	0.415056
chr13	52638899	52703214	NEK5	64315	0.409267
chr13	52706778	52733996	NEK3	27218	0.397164
chr13	52741844	52865680	MRPS31P5	123836	0.403178
chr13	52951302	52980629	THSD1	29327	0.437208
chr13	52986736	53024763	VPS36	38027	0.393457
chr13	53029494	53050763	CKAP2	21269	0.389346
chr13	53063127	53161225	TPTE2P3	98098	0.391292
chr13	53191604	53217919	HNRNPA1L2	26315	0.390348
chr13	53226830	53262433	SUGT1	35603	0.369042
chr13	53277399	53313947	LECT1	36548	0.419065
chr13	53384184	53384275	MIR759	91	0.296703
chr13	53418108	53422775	PCDH8	4667	0.614528
chr13	53602875	53626196	OLFM4	23321	0.400969
chr13	54389553	54450254	LINC00558	60701	0.351922
chr13	54698458	54707001	BC020935	8543	0.423973
chr13	54817927	54819371	BC044614	1444	0.328947
chr13	54886106	54886183	MIR1297	77	0.324675
chr13	55748588	55748683	MIR5007	95	0.347368
chr13	57459417	57459736	7SK	319	0.467085
chr13	57715051	57718073	PRR20D	3022	0.497684
chr13	57721621	57724643	PRR20D	3022	0.497684
chr13	57728194	57731216	PRR20D	3022	0.497684
chr13	57734765	57737787	PRR20B	3022	0.497684
chr13	57741330	57744352	PRR20E	3022	0.497684
chr13	58205788	58303065	PCDH17	97277	0.333265
chr13	60239720	60738119	DIAPH3	498399	0.359106
chr13	60586884	60618490	DIAPH3-AS1	31606	0.368031
chr13	60587436	60599286	DIAPH3-AS1	11850	0.365570
chr13	60718831	60727639	DIAPH3-AS2	8808	0.386921
chr13	60971426	61148013	TDRD3	176587	0.363051
chr13	61211096	61211118	DD413682	22	0.409091
chr13	61491134	61515902	AK097816	24768	0.370922
chr13	61773931	61774014	MIR3169	83	0.409639
chr13	61983818	61989655	PCDH20	5837	0.443036
chr13	64311567	64316701	OR7E156P	5134	0.590183
chr13	64320959	64321366	LOC647264	407	0.535627
chr13	64402979	64418258	AK127969	15279	0.483016
chr13	64560503	64650144	AK057471	89641	0.336766
chr13	66876965	67804468	PCDH9	927503	0.346558
chr13	66982199	66983303	BC042366	1104	0.386775
chr13	67204846	67204908	U7	62	0.241935
chr13	67399300	67489163	PCDH9-AS2	89863	0.343990
chr13	67551520	67559908	PCDH9-AS3	8388	0.329995
chr13	69435416	69459457	LINC00550	24041	0.335801
chr13	70274724	70682625	KLHL1	407901	0.340612
chr13	70681344	70713885	ATXN8OS	32541	0.349098
chr13	71589272	71742549	LINC00348	153277	0.353634
chr13	72012097	72441330	DACH1	429233	0.339356
chr13	73028039	73028105	SNORD37	66	0.333333
chr13	73160817	73160948	SNORA9	131	0.480916
chr13	73282494	73301938	MZT1	19444	0.390660
chr13	73302041	73330328	BORA	28287	0.366564
chr13	73329539	73356344	DIS3	26805	0.363328
chr13	73356229	73590591	PIBF1	234362	0.369906
chr13	73633141	73651676	KLF5	18535	0.393580
chr13	74260148	74708066	KLF12	447918	0.374729
chr13	74611059	74613076	AX748190	2017	0.399108
chr13	74805593	74832291	AK056689	26698	0.393250
chr13	74987093	74993252	AX747962	6159	0.424907
chr13	74993309	75009296	LINC00381	15987	0.386877
chr13	75126979	75131257	LINC00347	4278	0.385460
chr13	75811888	75814517	CTAGE11P	2629	0.405858
chr13	75858808	76056250	TBC1D4	197442	0.380775
chr13	76099349	76111991	COMMD6	12642	0.387518
chr13	76123885	76180156	UCHL3	56271	0.356880
chr13	76210458	76434006	LMO7	223548	0.384302
chr13	76445173	76457948	C13orf45	12775	0.382779
chr13	77454303	77460540	KCTD12	6237	0.436267
chr13	77502584	77503224	BTF3P11	640	0.389062
chr13	77526623	77532776	IRG1	6153	0.432960
chr13	77566058	77576652	CLN5	10594	0.405890
chr13	77579388	77601331	FBXL3	21943	0.383585
chr13	77618791	77901177	MYCBP2	282386	0.357203
chr13	77649648	77661911	MYCBP2-AS1	12263	0.354889
chr13	78109808	78219398	SCEL	109590	0.378894
chr13	78234118	78234146	DQ588544	28	0.678571
chr13	78271988	78338377	SLAIN1	66389	0.367772
chr13	78272146	78272251	MIR3665	105	0.771429
chr13	78393076	78482178	BC031243	89102	0.365233
chr13	78469615	78493903	EDNRB	24288	0.379035
chr13	78493823	79158297	RNF219-AS1	664474	0.368014
chr13	78553900	78568908	AK090854	15008	0.359408
chr13	78587017	78627730	LINC00446	40713	0.362513
chr13	79173229	79177695	POU4F1	4466	0.550381
chr13	79188420	79233314	RNF219	44894	0.385196
chr13	79361453	79414185	LINC00331	52732	0.362095
chr13	79442248	79442273	HH834010	25	0.240000
chr13	79845266	79845318	HH834010	52	0.307692
chr13	79894099	79979923	RBM26	85824	0.342550
chr13	79980443	79998468	RBM26-AS1	18025	0.385908
chr13	80051498	80055366	NDFIP2-AS1	3868	0.422182
chr13	80055258	80130212	NDFIP2	74954	0.354644
chr13	80446720	80492171	BC036310	45451	0.389496
chr13	80910111	80915086	SPRY2	4975	0.479598
chr13	84451342	84456528	SLITRK1	5186	0.473197
chr13	84714736	85180903	LINC00333	466167	0.348004
chr13	85937737	86118797	LINC00351	181060	0.351083
chr13	86366921	86373483	SLITRK6	6562	0.346998
chr13	88096241	88323218	MIR4500HG	226977	0.335426
chr13	88270919	88270995	MIR4500	76	0.421053
chr13	88324869	88331870	SLITRK5	7001	0.495786
chr13	89193083	89197764	LINC00433	4681	0.330699
chr13	90201047	90216667	LINC00353	15620	0.338732
chr13	90712500	90771971	LINC00559	59471	0.347009
chr13	90883435	90883531	MIR622	96	0.520833
chr13	91145541	91187595	BC038529	42054	0.353569
chr13	91434019	91434123	U6	104	0.413462
chr13	91543207	91578851	LINC00410	35644	0.355207
chr13	91779866	91863952	LINC00379	84086	0.375722
chr13	92000073	92006829	MIR17HG	6756	0.445086
chr13	92003498	92003521	DM119510	23	0.391304
chr13	92050934	93519487	GPC5	1468553	0.358402
chr13	93353641	93372227	GPC5-AS1	18586	0.348650
chr13	93879077	95060273	GPC6	1181196	0.371424
chr13	94470676	94510726	GPC6-AS2	40050	0.362297
chr13	95091840	95131936	DCT	40096	0.401885
chr13	95201903	95201976	TRNA	73	0.534247
chr13	95226307	95248511	TGDS	22204	0.369888
chr13	95254103	95286899	GPR180	32796	0.365654
chr13	95361878	95364389	SOX21	2511	0.534050
chr13	95364969	95368197	AK055459	3228	0.472119
chr13	95413194	95587664	BC045767	174470	0.396171
chr13	95672082	95953687	ABCC4	281605	0.423313
chr13	96204946	96232010	CLDN10	27064	0.407109
chr13	96131697	96186164	CLDN10-AS1	54467	0.412580
chr13	96230455	96296960	DZIP1	66505	0.414209
chr13	96325091	96329179	BC035106	4088	0.391145
chr13	96329392	96447243	DNAJC3	117851	0.397858
chr13	96453835	96705736	UGGT2	251901	0.370074
chr13	96743092	97491816	HS6ST3	748724	0.379901
chr13	97593534	97636426	LINC00359	42892	0.386179
chr13	97600471	97600508	DQ583891	37	0.621622
chr13	97618194	97618268	SNORD112	74	0.324324
chr13	97637972	97646604	OXGR1	8632	0.418791
chr13	97874549	98046374	MBNL2	171825	0.402229
chr13	98086474	98120252	RAP2A	33778	0.362040
chr13	98605928	98676550	IPO5	70622	0.402736
chr13	98795433	99102023	FARP1	306590	0.444506
chr13	98828038	98829521	RNF113B	1483	0.548887
chr13	98856088	98856446	7SK	358	0.497207
chr13	98860777	98860854	MIR3170	77	0.493506
chr13	98929726	98930183	AF339801	457	0.483589
chr13	98930183	98930408	AF339801	225	0.337778
chr13	99053669	99059751	AF339817	6082	0.422065
chr13	99102454	99229396	STK24	126942	0.470294
chr13	99336054	99404929	SLC15A1	68875	0.445169
chr13	99445740	99738660	DOCK9	292920	0.417496
chr13	99848627	99853011	UBAC2-AS1	4384	0.451870
chr13	99852678	100038753	UBAC2	186075	0.417971
chr13	99857961	99858260	7SK	299	0.545151
chr13	99868261	100058554	MIR548AN	190293	0.421976
chr13	99906966	99910840	GPR18	3874	0.355963
chr13	99946788	99959749	GPR183	12961	0.380912
chr13	100003673	100004281	FKSG29	608	0.424342
chr13	100008384	100008482	MIR623	98	0.520408
chr13	100143728	100148992	AK123584	5264	0.446809
chr13	100153627	100216302	TM9SF2	62675	0.389485
chr13	100258918	100549388	CLYBL	290470	0.432069
chr13	100295312	100295403	MIR4306	91	0.494505
chr13	100615274	100624178	ZIC5	8904	0.519429
chr13	100634025	100639019	ZIC2	4994	0.566480
chr13	100741268	101182691	PCCA	441423	0.398373
chr13	101116690	101133269	PCCA-AS1	16579	0.434887
chr13	101182417	101186056	GGACT	3639	0.508931
chr13	101256089	101327103	TMTC4	71014	0.445673
chr13	101360578	101711638	NALCN-AS1	351060	0.413397
chr13	101706129	102068813	NALCN	362684	0.379846
chr13	102104943	102368796	ITGBL1	263853	0.364779
chr13	102373204	103054124	FGF14	680920	0.372843
chr13	102619991	102620096	MIR2681	105	0.457143
chr13	102698283	102698354	MIR4705	71	0.380282
chr13	102944669	103019749	FGF14-IT1	75080	0.380980
chr13	103046927	103048055	FGF14-AS2	1128	0.522163
chr13	103249285	103331523	TPP2	82238	0.377478
chr13	103338096	103346871	METTL21C	8775	0.439772
chr13	103350088	103356650	AX747578	6562	0.433557
chr13	103381716	103411422	CCDC168	29706	0.385814
chr13	103418462	103426149	TEX30	7687	0.411474
chr13	103436630	103451404	KDELC1	14774	0.410248
chr13	103459495	103528351	BIVM-ERCC5	68856	0.390699
chr13	103532448	103548383	METTL21EP	15935	0.371007
chr13	103696347	103719196	SLC10A2	22849	0.393103
chr13	103934828	103934848	MIR548AS	20	0.300000
chr13	106111405	106158030	DAOA-AS1	46625	0.355346
chr13	106118564	106143383	DAOA	24819	0.361820
chr13	106359217	106414143	LINC00343	54926	0.363180
chr13	107028910	107030142	LINC00460	1232	0.468344
chr13	107142078	107187388	EFNB2	45310	0.407460
chr13	107195661	107220514	ARGLU1	24853	0.382489
chr13	107270157	107284006	LINC00551	13849	0.431945
chr13	107306227	107324528	LINC00443	18301	0.387629
chr13	107820878	108519460	FAM155A	698582	0.374261
chr13	107973242	107973311	SNORD31	69	0.449275
chr13	108439708	108487799	BC043519	48091	0.359256
chr13	108859791	108867882	LIG4	8091	0.385366
chr13	108870762	108886603	ABHD13	15841	0.353513
chr13	108921976	108960832	TNFSF13B	38856	0.341852
chr13	109248499	109860355	MYO16	611856	0.384760
chr13	109816252	109819651	MYO16-AS1	3399	0.389526
chr13	110406183	110438914	IRS2	32731	0.469005
chr13	110801309	110959496	COL4A1	158187	0.449013
chr13	110959630	111165373	COL4A2	205743	0.477503
chr13	111154922	111160526	COL4A2-AS1	5604	0.563348
chr13	111175412	111214071	RAB20	38659	0.497323
chr13	111267930	111292342	CARKD	24412	0.500492
chr13	111293756	111358480	CARS2	64724	0.479745
chr13	111363575	111365814	DJ031140	2239	0.559625
chr13	111367358	111373421	ING1	6063	0.463632
chr13	111516333	111522655	LINC00346	6322	0.494147
chr13	111530886	111567416	ANKRD10	36530	0.400000
chr13	111767623	111947542	ARHGEF7	179919	0.444178
chr13	111936127	111938268	AX748212	2141	0.463802
chr13	111973014	111996594	TEX29	23580	0.495844
chr13	112721912	112726020	SOX1	4108	0.544304
chr13	112762363	112764886	AK055145	2523	0.449465
chr13	112851663	112855316	CR627049	3653	0.501506
chr13	113030650	113089009	SPACA7	58359	0.414606
chr13	113139327	113242481	TUBGCP3	103154	0.428699
chr13	113301357	113338811	C13orf35	37454	0.472099
chr13	113344642	113541482	ATP11A	196840	0.503297
chr13	113399762	113409007	BC041346	9245	0.495187
chr13	113556508	113612478	BC035340	55970	0.482473
chr13	113621797	113622952	MCF2L-AS1	1155	0.543723
chr13	113623534	113754053	MCF2L	130519	0.565266
chr13	113760101	113774995	F7	14894	0.613603
chr13	113777112	113803843	F10	26731	0.485429
chr13	113812967	113826698	PROZ	13731	0.508193
chr13	113831852	113863029	PCID2	31177	0.434038
chr13	113863930	113919392	CUL4A	55462	0.454275
chr13	113951468	113977741	LAMP1	26273	0.507365
chr13	113978504	114018463	GRTP1	39959	0.520283
chr13	114076259	114107839	ADPRHL1	31580	0.538284
chr13	114110133	114145023	DCUN1D2	34890	0.446374
chr13	114145307	114204544	TMCO3	59237	0.482908
chr13	114239055	114295788	TFDP1	56733	0.533235
chr13	114303121	114312513	ATP4B	9392	0.563565
chr13	114321596	114438637	GRK1	117041	0.089097
chr13	114451483	114454062	LINC00552	2579	0.571927
chr13	114462215	114514899	TMEM255B	52684	0.530882
chr13	114523521	114567046	GAS6	43525	0.575968
chr13	114545292	114548541	FLJ41484	3249	0.576177
chr13	114567149	114569805	LOC100506394	2656	0.449548
chr13	114591273	114626485	AK126042	35212	0.456066
chr13	114629486	114631964	LINC00565	2478	0.556901
chr13	114747193	114898095	RASA3	150902	0.568747
chr13	115000361	115038150	CDC16	37789	0.413480
chr13	115047058	115071291	UPF3A	24233	0.475797
chr13	115051776	115071291	UPF3A	19515	0.478350
chr13	115079964	115092803	CHAMP1	12839	0.430018
chr14	19377593	19378574	OR11H12	981	0.434251
chr14	19407014	19410111	LOC642426	3097	0.371327
chr14	19553364	19584942	POTEG	31578	0.369814
chr14	19562690	19566731	P712P	4041	0.382331
chr14	19595543	19595584	DQ595091	41	0.439024
chr14	19596015	19596045	DQ590589	30	0.566667
chr14	19596078	19596110	DQ591735	32	0.468750
chr14	19596711	19596739	DQ599717	28	0.464286
chr14	19597269	19597306	DQ582260	37	0.594595
chr14	19598183	19598223	DQ595048	40	0.575000
chr14	19598413	19598450	DQ582260	37	0.540541
chr14	19598480	19598521	DQ595091	41	0.439024
chr14	19598951	19598981	DQ590589	30	0.566667
chr14	19599014	19599046	DQ591735	32	0.468750
chr14	19599647	19599675	DQ599717	28	0.464286
chr14	19600275	19600303	DQ599717	28	0.464286
chr14	19601026	19601066	DQ590589	40	0.575000
chr14	19601929	19601969	DQ595048	40	0.575000
chr14	19602778	19602810	DQ591735	32	0.468750
chr14	19603728	19603768	DQ595048	40	0.575000
chr14	19605327	19639485	P775P	34158	0.408133
chr14	19650031	19692916	AK022914	42885	0.420380
chr14	19662047	19663434	DQ786293	1387	0.330930
chr14	19670791	19681016	LOC101101776	10225	0.376430
chr14	19880208	19925333	AK022914	45125	0.418482
chr14	19894368	19904572	LINC00516	10204	0.377205
chr14	19911927	19913315	BC017398	1388	0.329971
chr14	19935900	19970058	P775P	34158	0.408308
chr14	19972600	19972632	DQ573684	32	0.468750
chr14	19972655	19972695	DQ595048	40	0.575000
chr14	19974345	19974385	DQ595048	40	0.575000
chr14	19975737	19975769	DQ573684	32	0.468750
chr14	19976262	19976303	DQ582484	41	0.439024
chr14	19976879	19976907	DQ573684	28	0.464286
chr14	19977508	19977540	DQ573684	32	0.468750
chr14	19978033	19978074	DQ582484	41	0.439024
chr14	19983953	20020272	POTEM	36319	0.385693
chr14	20006912	20010956	P712P	4044	0.382295
chr14	20181062	20182491	OR11H2	1429	0.448565
chr14	20215586	20216528	OR4Q3	942	0.452229
chr14	20248481	20249423	OR4M1	942	0.445860
chr14	20295607	20296531	OR4N2	924	0.483766
chr14	20344426	20345371	OR4K2	945	0.410582
chr14	20388765	20389737	OR4K5	972	0.412551
chr14	20403766	20404842	OR4K1	1076	0.415428
chr14	20443677	20444724	OR4K15	1047	0.427889
chr14	20482419	20483352	OR4K14	933	0.464094
chr14	20502002	20502917	OR4K13	915	0.436066
chr14	20528203	20529142	OR4L1	939	0.412141
chr14	20585565	20586597	OR4K17	1032	0.413760
chr14	20611894	20612821	OR4N5	927	0.469256
chr14	20665494	20666532	OR11G2	1038	0.470135
chr14	20691868	20692861	OR11H6	993	0.452165
chr14	20710950	20711925	OR11H4	975	0.433846
chr14	20757300	20774153	TTC5	16853	0.400344
chr14	20779526	20801471	CCNB1IP1	21945	0.395215
chr14	20791337	20791485	SNORA79	148	0.459459
chr14	20794599	20794698	SNORD126	99	0.424242
chr14	20811229	20811570	RPPH1	341	0.636364
chr14	20811772	20826063	PARP2	14291	0.423063
chr14	20833825	20881579	TEP1	47754	0.474034
chr14	20896969	20903801	KLHL33	6832	0.497219
chr14	20915206	20923267	OSGEP	8061	0.451185
chr14	20923289	20925931	APEX1	2642	0.473505
chr14	20926011	20929637	TMEM55B	3626	0.513789
chr14	20937537	20946165	PNP	8628	0.464534
chr14	20978630	20979281	RNASE10	651	0.482335
chr14	21024251	21029090	RNASE9	4839	0.375284
chr14	21051051	21058417	RNASE11	7366	0.409992
chr14	21058239	21058982	RNASE12	743	0.445491
chr14	21058560	21075296	AX747992	16736	0.464089
chr14	21108854	21109850	OR6S1	996	0.503012
chr14	21152335	21168758	RNASE4	16423	0.434269
chr14	21152335	21162345	ANG	10010	0.451848
chr14	21214098	21216539	EDDM3A	2441	0.434248
chr14	21236585	21239107	EDDM3B	2522	0.429818
chr14	21249209	21250626	RNASE6	1417	0.421313
chr14	21269514	21271036	RNASE1	1522	0.521025
chr14	21359561	21360507	RNASE3	946	0.490486
chr14	21423629	21424594	RNASE2	965	0.476684
chr14	21387499	21388335	ECRP	836	0.483254
chr14	21457964	21465194	METTL17	7230	0.449516
chr14	21467413	21470034	SLC39A2	2621	0.490652
chr14	21484921	21493264	NDRG2	8343	0.532662
chr14	21498344	21500332	TPPP2	1988	0.507545
chr14	21500978	21502944	RNASE13	1966	0.516277
chr14	21510384	21512392	RNASE7	2008	0.505478
chr14	21526051	21526516	RNASE8	465	0.548387
chr14	21538526	21558036	ARHGEF40	19510	0.537929
chr14	21558204	21567173	ZNF219	8969	0.579440
chr14	21567095	21571883	TMEM253	4788	0.489348
chr14	21623095	21624184	OR5AU1	1089	0.505969
chr14	21668237	21673662	LINC00641	5425	0.415668
chr14	21677295	21737638	HNRNPC	60343	0.397826
chr14	21756135	21819460	RPGRIP1	63325	0.443948
chr14	21819630	21852425	SUPT16H	32795	0.404086
chr14	21853352	21899867	CHD8	46515	0.421713
chr14	21860309	21860412	SNORD9	103	0.466019
chr14	21865451	21865560	SNORD8	109	0.495413
chr14	21927178	21945132	RAB2B	17954	0.411942
chr14	21945334	21967319	TOX4	21985	0.433750
chr14	21966281	21979457	METTL3	13176	0.424332
chr14	21989231	22005337	SALL2	16106	0.485844
chr14	22037933	22038875	OR10G3	942	0.523355
chr14	22090010	22090721	D21847	711	0.430380
chr14	22102065	22102998	OR10G2	933	0.526259
chr14	22111108	22111806	TRA@	698	0.436963
chr14	22133296	22134238	OR4E2	942	0.462845
chr14	22180545	22181065	TRA	520	0.455769
chr14	22192007	22447356	TRA	255349	0.381599
chr14	22217394	22217986	TCRVA15	592	0.437500
chr14	22236728	22237313	TCRAV5.1a	585	0.473504
chr14	22265458	22266052	TCRA	594	0.457912
chr14	22280026	22280143	V alpha 18/J alpha F/C alpha	117	0.444444
chr14	22293662	23019608	TCRA	725946	0.392256
chr14	22309320	22309955	TRAV12-1	635	0.426772
chr14	22314718	22315399	TCRA	681	0.513950
chr14	22320535	22321182	AV1S4A1N1T	647	0.459042
chr14	22336979	22733726	TCR-alpha	396747	0.377520
chr14	22356036	22745911	AV2S1A1	389875	0.378909
chr14	22362569	22534581	TRA@	172012	0.374142
chr14	22386351	22386929	AV8S2	578	0.411765
chr14	22392238	22392826	hADV14S1	588	0.433673
chr14	22409325	22947923	T-Cell Receptor V-alpha region	538598	0.390514
chr14	22433697	22434291	TCR-alpha	594	0.449495
chr14	22446726	22534581	TCRA	87855	0.380730
chr14	22471344	22476413	TCRA	5069	0.400868
chr14	22508842	22509396	TRAV20	554	0.447653
chr14	22538905	22539467	TCRA	562	0.480427
chr14	22564301	22564896	TRD	595	0.416807
chr14	22573582	22574957	TCR-alpha	1375	0.415273
chr14	22580299	22580985	TCRAVN1	686	0.435860
chr14	22600965	22600989	TCRA	24	0.541667
chr14	22636292	22636879	TCRA	587	0.459966
chr14	22670486	22981890	AV4S1	311404	0.406947
chr14	22675417	22676029	V alpha immunoglobulin	612	0.452614
chr14	22739820	22740442	TCR	622	0.480707
chr14	22748987	22962976	hADV38S2	213989	0.408385
chr14	22771875	22772438	av27s1	563	0.474245
chr14	22782884	22783343	TCR- alpha V 33.1	459	0.416122
chr14	22788567	22789122	TCR-alpha	555	0.445045
chr14	22849082	22951948	AK093552	102866	0.428460
chr14	22886527	22901726	AK125397	15199	0.438713
chr14	22928088	22934912	TCRDV2	6824	0.412222
chr14	22938034	22938658	hDV103S1	624	0.439103
chr14	22948513	22948571	TCRA	58	0.413793
chr14	22971217	22971276	ADV21S1A1N	59	0.508475
chr14	22972735	22972797	TCRA	62	0.467742
chr14	22974098	22974153	TCRA	55	0.509091
chr14	22991013	22991078	TCRA	65	0.446154
chr14	23033806	23058143	DAD1	24337	0.419197
chr14	23067146	23081265	ABHD4	14119	0.484029
chr14	23235730	23240998	OXA1L	5268	0.464882
chr14	23242431	23285107	SLC7A7	42676	0.468647
chr14	23299091	23304246	MRPL52	5155	0.471193
chr14	23305792	23316803	MMP14	11011	0.573063
chr14	23340959	23347291	LRP10	6332	0.577859
chr14	23352431	23356889	REM2	4458	0.561238
chr14	23369853	23388396	RBM23	18543	0.460983
chr14	23389732	23398661	PRMT5	8929	0.475529
chr14	23398909	23398982	TRNA	73	0.589041
chr14	23415436	23426351	HAUS4	10915	0.455428
chr14	23440409	23451848	AJUBA	11439	0.529417
chr14	23456109	23479360	C14orf93	23251	0.456798
chr14	23495059	23504354	PSMB5	9295	0.476278
chr14	23511375	23513269	PSMB11	1894	0.579725
chr14	23516269	23526747	CDH24	10478	0.572533
chr14	23527773	23564823	ACIN1	37050	0.453630
chr14	23564682	23569665	C14orf119	4983	0.449328
chr14	23569630	23574177	BC153822	4547	0.504508
chr14	23586514	23588820	CEBPE	2306	0.610147
chr14	23594503	23652869	SLC7A8	58366	0.471268
chr14	23625517	23625623	U6	106	0.396226
chr14	23742843	23755309	HOMEZ	12466	0.456762
chr14	23765129	23772057	PPP1R3E	6928	0.524971
chr14	23775970	23795394	BCL2L2-PABPN1	19424	0.468544
chr14	23815526	23821660	SLC22A17	6134	0.570101
chr14	23825608	23834842	EFS	9234	0.540178
chr14	23842017	23845612	IL25	3595	0.490403
chr14	23846016	23848981	CMTM5	2965	0.582462
chr14	23851198	23877486	MYH6	26288	0.533513
chr14	23857804	23857875	MIR208A	71	0.507042
chr14	23881946	23904870	MYH7	22924	0.530536
chr14	23887195	23887272	MIR208B	77	0.428571
chr14	23938897	23947402	NGDN	8505	0.420459
chr14	24025197	24028790	THTPA	3593	0.538547
chr14	23990063	24020858	ZFHX2	30795	0.527521
chr14	24028776	24037279	AP1G2	8503	0.552040
chr14	24030305	24037282	AX747770	6977	0.559839
chr14	24037243	24048009	JPH4	10766	0.566877
chr14	24105572	24114848	DHRS2	9276	0.508085
chr14	24391455	24403145	BX161431	11690	0.426604
chr14	24407939	24423392	DHRS4-AS1	15453	0.436808
chr14	24422964	24438488	DHRS4	15524	0.449691
chr14	24439082	24453532	DHRS4L2	14450	0.417855
chr14	24521205	24538937	LRRC16B	17732	0.578277
chr14	24540735	24547296	CPNE6	6561	0.585886
chr14	24549315	24551155	NRL	1840	0.608152
chr14	24549315	24553832	NRL	4517	0.557671
chr14	24563482	24573339	PCK2	9857	0.534645
chr14	24583905	24594451	DCAF11	10546	0.508344
chr14	24600674	24602058	FITM1	1384	0.606214
chr14	24605377	24608176	PSME1	2799	0.574134
chr14	24608173	24610797	EMC9	2624	0.535061
chr14	24612573	24615855	PSME2	3282	0.488726
chr14	24616658	24630547	RNF31	13889	0.525956
chr14	24629728	24635774	IRF9	6046	0.542838
chr14	24641233	24649463	REC8	8230	0.550911
chr14	24649424	24659014	IPO4	9590	0.572054
chr14	24657924	24683357	TM9SF1	25433	0.497149
chr14	24674925	24677454	TSSK4	2529	0.508106
chr14	24682614	24701576	NEDD8-MDP1	18962	0.448001
chr14	24702102	24708447	GMPR2	6345	0.457998
chr14	24708850	24711880	TINF2	3030	0.533333
chr14	24718319	24732416	TGM1	14097	0.544939
chr14	24734743	24740833	RABGGTA	6090	0.577011
chr14	24740431	24768057	HP08474	27626	0.494027
chr14	24759803	24769039	DHRS1	9236	0.480403
chr14	24769097	24774374	NOP9	5277	0.501421
chr14	24774392	24780576	CIDEB	6184	0.547219
chr14	24779356	24781259	LTB4R2	1903	0.640568
chr14	24780704	24787242	LTB4R	6538	0.534873
chr14	24787554	24804277	ADCY4	16723	0.544041
chr14	24805226	24809242	RIPK3	4016	0.558765
chr14	24836144	24848810	NFATC4	12666	0.565056
chr14	24867991	24888494	NYNRIN	20503	0.529532
chr14	24895739	24898731	CBLN3	2992	0.575869
chr14	24899140	24910547	KHNYN	11407	0.517226
chr14	24908971	24912007	SDR39U1	3036	0.533926
chr14	24912177	24971403	AK056368	59226	0.422483
chr14	24974711	24977471	CMA1	2760	0.515580
chr14	25042723	25045466	CTSG	2743	0.537732
chr14	25075685	25078926	GZMH	3241	0.520827
chr14	25100160	25103432	GZMB	3272	0.529034
chr14	25281305	25519095	STXBP6	237790	0.392039
chr14	26915088	27066960	NOVA1	151872	0.330660
chr14	27377847	27377931	MIR4307	84	0.321429
chr14	27791205	28142425	BC148262	351220	0.339363
chr14	28081793	28108842	LINC00645	27049	0.333728
chr14	29063026	29063048	DD413682	22	0.409091
chr14	29236277	29239483	FOXG1	3206	0.509046
chr14	29241909	29264000	C14orf23	22091	0.395727
chr14	29252696	29254990	BC034423	2294	0.466870
chr14	29896116	30174608	MIR548AI	278492	0.364585
chr14	30045686	30396899	PRKD1	351213	0.368685
chr14	30083718	30084062	BC062469	344	0.340116
chr14	30084073	30085037	BC062469	964	0.369295
chr14	30281121	30281224	U6	103	0.330097
chr14	31028328	31089046	G2E3	60718	0.354936
chr14	31091459	31205033	SCFD1	113574	0.361421
chr14	31343740	31359822	COCH	16082	0.410894
chr14	31345384	31359014	LOC100506071	13630	0.392663
chr14	31363004	31495607	STRN3	132603	0.385059
chr14	31483851	31483948	MIR624	97	0.402062
chr14	31494675	31555008	AP4S1	60333	0.433345
chr14	31569323	31676689	HECTD1	107366	0.392396
chr14	31760993	31889788	HEATR5A	128795	0.393455
chr14	31889963	31922089	BC041327	32126	0.392673
chr14	31915242	31926680	DTD2	11438	0.384071
chr14	31952149	31957151	GPR33	5002	0.415434
chr14	32030590	32330429	NUBPL	299839	0.381778
chr14	32544624	32545905	ARHGAP5-AS1	1281	0.473849
chr14	32546494	32628934	ARHGAP5	82440	0.365393
chr14	32798478	33302268	AKAP6	503790	0.379358
chr14	32954301	32954322	JA429831	21	0.523810
chr14	33245371	33246852	BC039319	1481	0.378123
chr14	33408458	34273382	NPAS3	864924	0.381698
chr14	34393420	34420284	EGLN3	26864	0.417920
chr14	34902143	34931468	SPTSSA	29325	0.418517
chr14	34985134	35008943	EAPP	23809	0.441178
chr14	35030617	35099366	SNX6	68749	0.443425
chr14	35179587	35184029	CFL2	4442	0.397344
chr14	35221936	35344853	BAZ1A	122917	0.397528
chr14	35409127	35409702	IGBP1P1	575	0.466087
chr14	35452103	35498773	SRP54	46670	0.387679
chr14	35515609	35552589	FAM177A1	36980	0.412953
chr14	35554677	35591519	PPP2R3C	36842	0.421448
chr14	35568881	35579932	AK128559	11051	0.402317
chr14	35591526	35743497	KIAA0391	151971	0.402261
chr14	35761573	35786682	PSMA6	25109	0.408499
chr14	35870715	35873960	NFKBIA	3245	0.565485
chr14	36003247	36006260	INSM2	3013	0.582144
chr14	36007557	36278432	RALGAPA1	270875	0.362636
chr14	36295596	36341169	BRMS1L	45573	0.390143
chr14	36539632	36634494	LINC00609	94862	0.380226
chr14	36604915	36645857	PTCSC3	40942	0.377729
chr14	36767763	36789882	MBIP	22119	0.352728
chr14	36840369	36841576	DPPA3	1207	0.407622
chr14	36942493	36982990	SFTA3	40497	0.408722
chr14	36985603	36989430	NKX2-1	3827	0.614842
chr14	36988520	36991722	BX161496	3202	0.583385
chr14	37049215	37051786	NKX2-8	2571	0.643718
chr14	37126772	37147011	PAX9	20239	0.444340
chr14	37147125	37641865	SLC25A21	494740	0.384006
chr14	37421513	37421596	MIR4503	83	0.240964
chr14	37641230	37642998	SLC25A21-AS1	1768	0.463801
chr14	37667117	38020464	MIPOL1	353347	0.358362
chr14	38058756	38064325	FOXA1	5569	0.485545
chr14	38080455	38510647	C14orf25	430192	0.376269
chr14	38264474	38311660	TTC6	47186	0.357564
chr14	38365264	38371329	AK125955	6065	0.383017
chr14	38677203	38682268	SSTR1	5065	0.542744
chr14	38723204	38725575	CLEC14A	2371	0.583720
chr14	39218542	39417475	LINC00639	198933	0.381872
chr14	39501122	39572437	SEC23A	71315	0.382262
chr14	39583487	39606177	GEMIN2	22690	0.396078
chr14	39617014	39639634	TRAPPC6B	22620	0.406808
chr14	39644386	39652422	PNN	8036	0.406546
chr14	39703124	39722575	MIA2	19451	0.388977
chr14	39736327	39820397	CTAGE5	84070	0.378673
chr14	39734906	39736265	LOC100288846	1359	0.498896
chr14	39865576	39901704	FBXO33	36128	0.387594
chr14	41423915	41445070	BX248273	21155	0.345498
chr14	42063665	42063794	SNORA31	129	0.403101
chr14	42076763	42373752	LRFN5	296989	0.346124
chr14	44973353	44976499	FSCB	3146	0.452956
chr14	45366506	45376460	C14orf28	9954	0.366184
chr14	45393526	45431179	KLHL28	37653	0.357900
chr14	45407754	45409773	AX748292	2019	0.445270
chr14	45431415	45543634	FAM179B	112219	0.378519
chr14	45552351	45553180	BC038722	829	0.442702
chr14	45553301	45584804	PRPF39	31503	0.363838
chr14	45580077	45580176	SNORD127	99	0.343434
chr14	45584801	45604009	FKBP3	19208	0.407382
chr14	45605135	45670093	FANCM	64958	0.375073
chr14	45672392	45722605	MIS18BP1	50213	0.375799
chr14	46533361	46971104	LINC00871	437743	0.343953
chr14	47120219	47121028	RPL10L	809	0.522868
chr14	47308827	48144157	MDGA2	835330	0.351389
chr14	47429625	47429749	SNORA25	124	0.370968
chr14	48230197	48230307	MIR548Y	110	0.427273
chr14	48234155	48264217	LINC00648	30062	0.352638
chr14	49410649	49410717	SNORD112	68	0.352941
chr14	50250531	50319539	NEMF	69008	0.404605
chr14	50043389	50053134	RPS29	9745	0.441047
chr14	50065414	50081390	LRR1	15976	0.450551
chr14	50085405	50087403	RPL36AL	1998	0.470470
chr14	50087488	50090199	MGAT2	2711	0.479528
chr14	50091891	50101948	DNAAF2	10057	0.461370
chr14	50110269	50155098	POLE2	44829	0.413170
chr14	50159822	50219870	KLHDC1	60048	0.397682
chr14	50234786	50249856	KLHDC2	15070	0.418248
chr14	50359735	50363772	ARF6	4037	0.436958
chr14	50410254	50428678	AK092589	18424	0.435248
chr14	50448429	50474238	C14orf182	25809	0.460150
chr14	50467795	50469007	BC068095	1212	0.545380
chr14	50504310	50507947	LOC100506499	3637	0.512510
chr14	50550368	50559361	C14orf183	8993	0.451351
chr14	50575349	50583297	METTL21D	7948	0.396955
chr14	50583845	50698099	SOS2	114254	0.382052
chr14	50709151	50778947	L2HGDH	69796	0.403662
chr14	50779046	50792946	ATP5S	13900	0.413309
chr14	50802710	50883179	CDKL1	80469	0.432688
chr14	50885210	50999376	MAP4K5	114166	0.361193
chr14	50999799	51099784	ATL1	99985	0.377257
chr14	51100297	51135071	SAV1	34774	0.382786
chr14	51186480	51297839	NIN	111359	0.411462
chr14	51311342	51311430	SnoU83B	88	0.363636
chr14	51338877	51371688	ABHD12B	32811	0.428058
chr14	51371934	51411248	PYGL	39314	0.417485
chr14	51441980	51562422	TRIM9	120442	0.404402
chr14	51706885	51724372	TMX1	17487	0.368845
chr14	51800110	51832275	LINC00640	32165	0.422633
chr14	52013346	52066670	FRMD6-AS2	53324	0.401020
chr14	52118575	52197444	FRMD6	78869	0.377233
chr14	51989581	51989685	U6	104	0.413462
chr14	52116235	52118462	FRMD6-AS1	2227	0.527167
chr14	52190820	52190927	U6	107	0.448598
chr14	52327021	52436518	GNG2	109497	0.393061
chr14	52456227	52471420	C14orf166	15193	0.357599
chr14	52471519	52535946	NID2	64427	0.432458
chr14	52734430	52743442	PTGDR	9012	0.438970
chr14	52781015	52795322	PTGER2	14307	0.422101
chr14	52897307	53019301	TXNDC16	121994	0.368453
chr14	53019865	53104431	GPR137C	84566	0.373141
chr14	53108604	53162419	ERO1L	53815	0.373669
chr14	53173895	53194716	PSMC6	20821	0.380193
chr14	53196882	53241705	STYX	44823	0.382839
chr14	53241910	53258386	GNPNAT1	16476	0.378733
chr14	53323988	53417815	FERMT2	93827	0.390399
chr14	53503457	53620046	DDHD1	116589	0.382695
chr14	54415144	54415202	MIR5580	58	0.431034
chr14	54416454	54421270	BMP4	4816	0.541321
chr14	54863672	54886934	CDKN3	23262	0.402674
chr14	54893646	54908148	CNIH	14502	0.388084
chr14	54941208	54955744	GMFB	14536	0.366332
chr14	54976586	55005334	CGRRF1	28748	0.375783
chr14	55034329	55260033	SAMD4A	225704	0.430449
chr14	55152078	55154289	AK096898	2211	0.433288
chr14	55308723	55369542	GCH1	60819	0.422039
chr14	55325932	55326048	U6atac	116	0.517241
chr14	55344830	55344911	MIR4308	81	0.407407
chr14	55405655	55493819	WDHD1	88164	0.394322
chr14	55493843	55516206	SOCS4	22363	0.379734
chr14	55518361	55536912	MAPK1IP1L	18551	0.401488
chr14	55595934	55612148	LGALS3	16214	0.439867
chr14	55614833	55658396	DLGAP5	43563	0.391112
chr14	55738871	55820329	FBXO34	81458	0.400390
chr14	55833108	55878576	ATG14	45468	0.417854
chr14	55880929	55907263	TBPL2	26334	0.411559
chr14	56024689	56046810	KTN1-AS1	22121	0.402423
chr14	56046924	56151302	KTN1	104378	0.359961
chr14	56232962	56234435	RPL13AP3	1473	0.475900
chr14	56247852	56263392	LINC00520	15540	0.412870
chr14	56585092	56768031	PELI2	182939	0.398422
chr14	56981068	57018027	BC037850	36959	0.407289
chr14	57046510	57116232	TMEM260	69722	0.368062
chr14	57267424	57272381	OTX2	4957	0.462578
chr14	57279900	57397550	OTX2-AS1	117650	0.402201
chr14	57669193	57735617	EXOC5	66424	0.359087
chr14	57735605	57756797	AP5M1	21192	0.358296
chr14	57857270	57879466	NAA30	22196	0.373085
chr14	57936594	57960576	C14orf105	23982	0.400467
chr14	58030639	58332592	SLC35F4	301953	0.392541
chr14	58470807	58618847	C14orf37	148040	0.402168
chr14	58666832	58702353	ACTR10	35521	0.386110
chr14	58711522	58738727	PSMA3	27205	0.402977
chr14	58765221	58840451	ARID4A	75230	0.374837
chr14	58862643	58875419	TOMM20L	12776	0.422981
chr14	58875369	58894232	TIMM9	18863	0.408896
chr14	58894102	59015549	KIAA0586	121447	0.369494
chr14	59104756	59115038	DACT1	10282	0.455553
chr14	59730158	59838123	DAAM1	107965	0.391757
chr14	59930239	59932059	GPR135	1820	0.668132
chr14	59939405	59951073	L3HYPDH	11668	0.401526
chr14	59951160	59972081	JKAMP	20921	0.367812
chr14	59971784	60043549	CCDC175	71765	0.392503
chr14	60062693	60337557	RTN1	274864	0.391852
chr14	60180372	60182545	BC047625	2173	0.448228
chr14	60386430	60530277	LRRC9	143847	0.364992
chr14	60558628	60601532	PCNXL4	42904	0.373974
chr14	60611499	60632211	DHRS7	20712	0.396195
chr14	60706844	60712368	BC035195	5524	0.411658
chr14	60712469	60765805	PPM1A	53336	0.360807
chr14	60793599	60793619	JB175233	20	0.300000
chr14	60902673	60952764	C14orf39	50091	0.344952
chr14	60975937	60978525	SIX6	2588	0.581144
chr14	61111416	61116155	SIX1	4739	0.496518
chr14	61176255	61190852	SIX4	14597	0.438994
chr14	61201458	61435398	MNAT1	233940	0.366466
chr14	61438166	61447782	TRMT5	9616	0.371880
chr14	61447831	61550451	SLC38A6	102620	0.376242
chr14	61788514	62017698	PRKCH	229184	0.427220
chr14	61729678	61729750	SNORD112	72	0.375000
chr14	61744088	61748530	TMEM30B	4442	0.485592
chr14	61769738	61789536	BC050301	19798	0.440398
chr14	62027779	62037371	BX648502	9592	0.484570
chr14	62037257	62121431	FLJ22447	84174	0.407228
chr14	62162118	62214977	HIF1A	52859	0.373465
chr14	62213756	62215807	HIF1A-AS2	2051	0.299854
chr14	62229074	62263146	SNAPC1	34072	0.396073
chr14	62462540	62568427	SYT16	105887	0.388027
chr14	62584074	62600903	LINC00643	16829	0.368828
chr14	63173944	63511955	KCNH5	338011	0.365515
chr14	63671101	63760230	RHOJ	89129	0.403000
chr14	63779548	63785593	GPHB5	6045	0.441356
chr14	63841354	64010079	PPP2R5E	168725	0.402768
chr14	63945989	63946131	SCARNA20	142	0.563380
chr14	64063756	64108641	WDR89	44885	0.412142
chr14	64086261	64086281	JA429503	20	0.550000
chr14	64150934	64194756	SGPP1	43822	0.396604
chr14	64319682	64693167	SYNE2	373485	0.407591
chr14	64699746	64761128	ESR2	61382	0.414437
chr14	64812190	64814329	TEX21P	2139	0.371201
chr14	64854758	64926725	MTHFD1	71967	0.436714
chr14	64953554	64970554	ZBTB25	17000	0.421941
chr14	64932216	64941221	AKAP5	9005	0.375458
chr14	64971291	64991669	ZBTB1	20378	0.397389
chr14	65007185	65009954	HSPA2	2769	0.560491
chr14	65016619	65056096	PPP1R36	39477	0.427489
chr14	65194310	65211060	PLEKHG3	16750	0.556478
chr14	65213000	65289863	SPTB	76863	0.508684
chr14	65381078	65529373	CHURC1-FNTB	148295	0.450029
chr14	65405869	65409623	GPX2	3754	0.479755
chr14	65412531	65438875	RAB15	26344	0.517044
chr14	65453947	65455992	BC052775	2045	0.443521
chr14	65541841	65569262	MAX	27421	0.432406
chr14	65511405	65511487	MIR4706	82	0.646341
chr14	65556635	65561029	LOC100506321	4394	0.410105
chr14	65679610	65689065	BX161428	9455	0.458805
chr14	65801835	65801901	MIR4708	66	0.515152
chr14	65877309	66210839	FUT8	333530	0.374122
chr14	65877310	65879335	FUT8-AS1	2025	0.495802
chr14	66953108	66965271	LINC00238	12163	0.378032
chr14	66961379	66974504	DJ031130	13125	0.383238
chr14	66974124	67648525	GPHN	674401	0.364314
chr14	67656109	67695267	FAM71D	39158	0.411691
chr14	67708011	67802778	MPP5	94767	0.375658
chr14	67804580	67826720	ATP6V1D	22140	0.416396
chr14	67827033	67853233	EIF2S1	26200	0.375496
chr14	67853699	67878828	PLEK2	25129	0.473238
chr14	67913800	67914649	AX746582	849	0.432273
chr14	67936982	67982021	TMEM229B	45039	0.493417
chr14	68000007	68056255	PLEKHH1	56248	0.480390
chr14	68056022	68067017	PIGH	10995	0.430014
chr14	68086578	68118436	ARG2	31858	0.421338
chr14	68117866	68141602	VTI1B	23736	0.436805
chr14	68143518	68162510	RDH11	18992	0.426232
chr14	68168602	68201168	RDH12	32566	0.410643
chr14	68213236	68283306	ZFYVE26	70070	0.433980
chr14	68286495	69062738	RAD51B	776243	0.399944
chr14	69254371	69262960	ZFP36L1	8589	0.532658
chr14	69262512	69263011	ZFP36L1	499	0.695391
chr14	69340839	69446083	ACTN1	105244	0.507981
chr14	69446398	69454180	ACTN1-AS1	7782	0.473143
chr14	69517636	69619914	DCAF5	102278	0.406774
chr14	69658193	69710737	EXD2	52544	0.413787
chr14	69726680	69821190	GALNT16	94510	0.483748
chr14	69846839	69865021	ERH	18182	0.402156
chr14	69865384	69929107	SLC39A9	63723	0.400295
chr14	69951470	69995215	PLEKHD1	43745	0.483049
chr14	70036530	70041600	CCDC177	5070	0.623274
chr14	70078309	70181861	KIAA0247	103552	0.448161
chr14	70233833	70238722	SRSF5	4889	0.434445
chr14	70232999	70234430	LOC100289511	1431	0.554857
chr14	70242551	70264006	SLC10A1	21455	0.432487
chr14	70346113	70499083	SMOC1	152970	0.455939
chr14	70510933	70655787	SLC8A3	144854	0.435466
chr14	70712469	70714518	ADAM21P1	2049	0.451440
chr14	70791797	70883807	SYNJ2BP-COX16	92010	0.395337
chr14	70827608	70827805	U2	197	0.380711
chr14	70918873	70926622	ADAM21	7749	0.397342
chr14	70935595	70950473	ADAM20P1	14878	0.417462
chr14	70989077	71001732	ADAM20	12655	0.372185
chr14	71050956	71067384	MED6	16428	0.396396
chr14	71075514	71108015	AK093892	32501	0.392357
chr14	71108503	71142077	TTC9	33574	0.454399
chr14	71194853	71275888	MAP3K9	81035	0.446708
chr14	71374121	71582099	PCNX	207978	0.368755
chr14	71865053	71865124	SNORD56B	71	0.380282
chr14	71933901	72041803	SIPA1L1	107902	0.388667
chr14	71954577	71956420	LOC145474	1843	0.379273
chr14	71996028	72206120	SIPA1L1	210092	0.396036
chr14	72207057	72207946	DKFZp686G1344	889	0.393701
chr14	72399155	73033238	RGS6	634083	0.419101
chr14	73075741	73079803	AK024141	4062	0.519941
chr14	73136659	73360809	DPF3	224150	0.462976
chr14	73393039	73426357	DCAF4	33318	0.489405
chr14	73436158	73493920	ZFYVE1	57762	0.457567
chr14	73525220	73588076	RBM25	62856	0.409078
chr14	73603142	73690399	PSEN1	87257	0.427221
chr14	73650022	73650578	BC016143	556	0.500000
chr14	73704204	73741347	PAPLN	37143	0.552298
chr14	73710725	73712687	BC044305	1962	0.585627
chr14	73741917	73925286	NUMB	183369	0.404741
chr14	73929128	73946036	AK055876	16908	0.449196
chr14	73945188	74025651	HEATR4	80463	0.461902
chr14	73957643	73960105	C14orf169	2462	0.585703
chr14	74035762	74042362	ACOT2	6600	0.494394
chr14	74058409	74062470	ACOT4	4061	0.490520
chr14	74083547	74086592	ACOT6	3045	0.436453
chr14	74111577	74170431	DNAL1	58854	0.405342
chr14	74126266	74126363	U6	97	0.453608
chr14	74178485	74181128	PNMA1	2643	0.541430
chr14	74181824	74253896	ELMSAN1	72072	0.513764
chr14	74225449	74225522	MIR4505	73	0.684932
chr14	74289261	74296838	BC038204	7577	0.422595
chr14	74318533	74352168	PTGR2	33635	0.417987
chr14	74353317	74398991	ZNF410	45674	0.417940
chr14	74399694	74417117	FAM161B	17423	0.472020
chr14	74416954	74429813	COQ6	12859	0.456256
chr14	74433180	74486026	ENTPD5	52846	0.445729
chr14	74486058	74532796	CCDC176	46738	0.426313
chr14	74526871	74551196	ALDH6A1	24325	0.439013
chr14	74551655	74667117	LIN52	115462	0.402115
chr14	74706174	74729441	VSX2	23267	0.537800
chr14	74751979	74769767	ABCD4	17788	0.514054
chr14	74815165	74826711	VRTN	11546	0.503551
chr14	74872595	74892805	SYNDIG1L	20210	0.498516
chr14	74946642	74960084	NPC2	13442	0.422705
chr14	74960422	74962271	ISCA2	1849	0.505138
chr14	74964885	75079034	LTBP2	114149	0.516702
chr14	75127954	75179807	AREL1	51853	0.420439
chr14	75178653	75178748	SNORA7	95	0.410526
chr14	75179849	75203390	FCF1	23541	0.409796
chr14	75230068	75304013	YLPM1	73945	0.394104
chr14	75292223	75295550	AK096592	3327	0.345056
chr14	75319735	75330537	PROX2	10802	0.462877
chr14	75348593	75370450	DLST	21857	0.449238
chr14	75370656	75389188	RPS6KL1	18532	0.547593
chr14	75408532	75422467	PGF	13935	0.561392
chr14	75469611	75476294	EIF2B2	6683	0.447105
chr14	75480466	75518235	MLH3	37769	0.413726
chr14	75519927	75530736	ACYP1	10809	0.398372
chr14	75536298	75544799	ZC2HC1C	8501	0.443948
chr14	75548817	75593778	NEK9	44961	0.418896
chr14	75598170	75643349	TMED10	45179	0.422121
chr14	75737402	75737483	U2	81	0.432099
chr14	75745480	75748937	FOS	3457	0.539196
chr14	75761106	75763111	LOC731223	2005	0.525187
chr14	75898836	75939404	JDP2	40568	0.493320
chr14	75988783	76013334	BATF	24551	0.445114
chr14	76044939	76114512	FLVCR2	69573	0.456671
chr14	76117232	76127538	C14orf1	10306	0.440617
chr14	76127550	76421425	TTLL5	293875	0.395049
chr14	76424441	76448092	TGFB3	23651	0.482813
chr14	76452095	76550092	IFT43	97997	0.430319
chr14	76618258	76669134	GPATCH2L	50876	0.389869
chr14	76662780	76665886	AK025117	3106	0.371861
chr14	76737449	76737476	RNU6-31P	27	0.407407
chr14	76837689	76968180	ESRRB	130491	0.491497
chr14	77228234	77249363	VASH1	21129	0.551375
chr14	77248082	77253067	AK125727	4985	0.509729
chr14	77253585	77279283	ANGEL1	25698	0.437894
chr14	77292724	77336645	C14orf166B	43921	0.472052
chr14	77490885	77495042	IRF2BPL	4157	0.628097
chr14	77514514	77547598	BC038792	33084	0.493411
chr14	77535522	77542534	AK124327	7012	0.481460
chr14	77547704	77552788	BC038792	5084	0.446892
chr14	77564577	77583630	KIAA1737	19053	0.428489
chr14	77597612	77608134	ZDHHC22	10522	0.547710
chr14	77648101	77725838	TMEM63C	77737	0.516781
chr14	77731833	77737655	NGB	5822	0.575404
chr14	77732560	77732633	MIR1260A	73	0.534247
chr14	77741298	77787225	POMT2	45927	0.470791
chr14	77787229	77797940	GSTZ1	10711	0.545234
chr14	77807294	77843396	TMED8	36102	0.413246
chr14	77843761	77857587	SAMD15	13826	0.432880
chr14	77860364	77889399	NOXRED1	29035	0.414086
chr14	77893017	77923983	VIPAS39	30966	0.415004
chr14	77924372	77935815	AHSA1	11443	0.459145
chr14	77940737	77965210	ISM2	24473	0.527684
chr14	77972339	78083110	SPTLC2	110771	0.413475
chr14	78138748	78174356	ALKBH1	35608	0.423557
chr14	78174413	78183941	SLIRP	9528	0.422544
chr14	78183943	78227497	SNW1	43554	0.411053
chr14	78227172	78236085	C14orf178	8913	0.424436
chr14	78266425	78400297	ADCK1	133872	0.476306
chr14	78870073	80334633	NRXN3	1464560	0.389135
chr14	79210931	79220227	BX248745	9296	0.418567
chr14	80663867	80677970	DIO2	14103	0.383748
chr14	80677761	80921810	DIO2-AS1	244049	0.377219
chr14	80962820	81405884	CEP128	443064	0.363715
chr14	81421868	81612646	TSHR	190778	0.387833
chr14	81641795	81687296	GTF2A1	45501	0.374827
chr14	81669038	81669178	SNORA79	140	0.342857
chr14	81687561	81688800	BC040628	1239	0.468927
chr14	81726993	81893748	STON2	166755	0.407112
chr14	81937890	82000205	SEL1L	62315	0.384835
chr14	82071690	82089405	BC029835	17715	0.411346
chr14	85655239	85655563	7SK	324	0.462963
chr14	85860222	85886418	LINC00911	26196	0.371698
chr14	85991476	85996332	BX248253	4856	0.404654
chr14	85996487	86094270	FLRT2	97783	0.401563
chr14	87372121	87389099	LOC283585	16978	0.350218
chr14	88399357	88459615	GALC	60258	0.363620
chr14	88462688	88462792	U6	104	0.403846
chr14	88471467	88481155	GPR65	9688	0.360033
chr14	88490893	88553688	LOC283587	62795	0.391799
chr14	88599105	88599134	DQ584943	29	0.482759
chr14	88601613	88601641	DQ577706	28	0.464286
chr14	88601785	88601816	DQ580323	31	0.419355
chr14	88601884	88601954	DQ599251	70	0.485714
chr14	88604268	88604302	DQ580013	34	0.352941
chr14	88604786	88604831	DQ577171	45	0.444444
chr14	88605277	88605305	DQ576585	28	0.571429
chr14	88605605	88605645	DQ597500	40	0.450000
chr14	88605708	88605738	DQ577854	30	0.533333
chr14	88605865	88605910	DQ587872	45	0.422222
chr14	88606431	88606462	DQ577137	31	0.516129
chr14	88606781	88606811	DQ597272	30	0.466667
chr14	88608307	88608359	DQ594032	52	0.423077
chr14	88608394	88608433	DQ594666	39	0.435897
chr14	88614311	88614341	DQ574255	30	0.433333
chr14	88614390	88614421	DQ575342	31	0.548387
chr14	88614563	88614609	DQ578127	46	0.456522
chr14	88614676	88614713	DQ574961	37	0.378378
chr14	88614800	88614834	DQ576104	34	0.500000
chr14	88616208	88616238	DQ577052	30	0.466667
chr14	88618967	88618998	DQ592332	31	0.419355
chr14	88619015	88619045	DQ596214	30	0.366667
chr14	88619744	88619778	DQ578350	34	0.441176
chr14	88620402	88620432	DQ601219	30	0.466667
chr14	88620908	88620938	DQ591177	30	0.433333
chr14	88621024	88621054	DQ584348	30	0.600000
chr14	88621290	88621325	DQ573937	35	0.371429
chr14	88621356	88621392	DQ583414	36	0.472222
chr14	88621564	88621595	DQ598830	31	0.354839
chr14	88623048	88623079	DQ572059	31	0.451613
chr14	88623086	88623116	DQ583616	30	0.500000
chr14	88624032	88624064	DQ582474	32	0.437500
chr14	88624279	88624311	DQ579186	32	0.500000
chr14	88624518	88624553	DQ594380	35	0.457143
chr14	88625098	88626334	DQ596147	1236	0.496764
chr14	88629137	88629172	DQ579618	35	0.457143
chr14	88629372	88629431	DQ588689	59	0.474576
chr14	88630116	88630172	DQ587983	56	0.500000
chr14	88630756	88630811	DQ574857	55	0.527273
chr14	88631268	88631298	DQ577549	30	0.533333
chr14	88631480	88631511	DQ597164	31	0.483871
chr14	88633028	88633057	DQ576490	29	0.620690
chr14	88634281	88634314	DQ599616	33	0.454545
chr14	88646451	88789593	KCNK10	143142	0.436175
chr14	88699494	88701679	AX747031	2185	0.423799
chr14	88851741	88904804	SPATA7	53063	0.364359
chr14	88932121	89021123	PTPN21	89002	0.413036
chr14	89029252	89079853	ZC3H14	50601	0.405486
chr14	89081173	89259096	EML5	177923	0.374533
chr14	89290917	89344335	TTC8	53418	0.365326
chr14	89622515	90085494	FOXN3	462979	0.443767
chr14	89802560	89804712	AK098481	2152	0.451208
chr14	89883697	89886137	FOXN3-AS1	2440	0.546721
chr14	90042559	90043820	FOXN3-AS2	1261	0.420301
chr14	90088261	90088551	7SK	290	0.534483
chr14	90263468	90421089	EFCAB11	157621	0.399363
chr14	90296175	90303007	BX247991	6832	0.408226
chr14	90422245	90511108	TDP1	88863	0.420715
chr14	90528107	90652195	KCNK13	124088	0.439414
chr14	90722893	90738966	PSMC1	16073	0.438624
chr14	90744397	90798481	NRDE2	54084	0.436081
chr14	90863326	90874619	CALM1	11293	0.460108
chr14	90921573	90925249	LINC00642	3676	0.478781
chr14	91006931	91282761	TTC7B	275830	0.461212
chr14	91108983	91115232	BC028746	6249	0.448712
chr14	91163676	91165718	BC039357	2042	0.452498
chr14	91337166	91526993	RPS6KA5	189827	0.389133
chr14	91580978	91691703	C14orf159	110725	0.475286
chr14	91592769	91592896	SNORA11B	127	0.527559
chr14	91698875	91710852	GPR68	11977	0.507306
chr14	91737666	91884188	CCDC88C	146522	0.512531
chr14	91923955	91976644	SMEK1	52689	0.398698
chr14	92039284	92041615	pp8961	2331	0.521236
chr14	92047117	92198413	CATSPERB	151296	0.390162
chr14	92246266	92302849	TC2N	56583	0.348815
chr14	92335754	92414046	FBLN5	78292	0.471300
chr14	92434242	92506403	TRIP11	72161	0.379000
chr14	92493739	92493765	JB175279	26	0.346154
chr14	92511118	92516880	BC039675	5762	0.466505
chr14	92524895	92572965	ATXN3	48070	0.415020
chr14	92582467	92588153	NDUFB1	5686	0.442139
chr14	92588297	92630543	CPSF2	42246	0.398334
chr14	92790151	92967825	SLC24A4	177674	0.477886
chr14	92914812	92915625	AX747894	813	0.531365
chr14	92915635	92916506	AX747894	871	0.586682
chr14	92980124	93155334	RIN3	175210	0.493419
chr14	93170151	93215047	LGMN	44896	0.472848
chr14	93260649	93306304	GOLGA5	45655	0.395751
chr14	93357768	93359851	AK093301	2083	0.458953
chr14	93389444	93401638	CHGA	12194	0.563228
chr14	93406067	93582263	ITPK1	176196	0.537680
chr14	93533796	93538478	ITPK1-AS1	4682	0.497651
chr14	93648540	93651249	MOAP1	2709	0.514212
chr14	93651374	93653431	TMEM251	2057	0.469616
chr14	93669236	93673459	C14orf142	4223	0.435472
chr14	93673400	93695561	UBR7	22161	0.432968
chr14	93703895	93799385	BTBD7	95490	0.400545
chr14	93799564	94173689	UNC79	374125	0.393315
chr14	93813536	93814700	COX8C	1164	0.536942
chr14	94184643	94254766	PRIMA1	70123	0.519944
chr14	94371075	94392718	FAM181A-AS1	21643	0.496512
chr14	94393687	94395954	FAM181A	2267	0.628584
chr14	94400498	94443076	ASB2	42578	0.524449
chr14	94463641	94475209	LINC00521	11568	0.511843
chr14	94492723	94505757	OTUB2	13034	0.518567
chr14	94492723	94515276	OTUB2	22553	0.527557
chr14	94517267	94547558	DDX24	30291	0.428015
chr14	94547638	94569060	IFI27L1	21422	0.446690
chr14	94577078	94583033	IFI27	5955	0.536020
chr14	94594117	94595957	IFI27L2	1840	0.571196
chr14	94640648	94746072	PPP4R4	105424	0.353117
chr14	94749649	94759361	SERPINA10	9712	0.466124
chr14	94770584	94789688	SERPINA6	19104	0.452732
chr14	94843083	94857029	SERPINA1	13946	0.517926
chr14	94908800	94919122	SERPINA11	10322	0.461054
chr14	94929057	94942670	SERPINA9	13613	0.475648
chr14	94953619	94984181	SERPINA12	30562	0.479092
chr14	95027782	95036243	SERPINA4	8461	0.474648
chr14	95047705	95059457	SERPINA5	11752	0.501106
chr14	95078633	95090390	SERPINA3	11757	0.508888
chr14	95107061	95113331	SERPINA13P	6270	0.500319
chr14	95234559	95236499	GSC	1940	0.650515
chr14	95552564	95608085	DICER1	55521	0.371355
chr14	95604255	95604323	MIR3173	68	0.485294
chr14	95643819	95646270	AK127179	2451	0.454916
chr14	95648275	95786245	CLMN	137970	0.468928
chr14	95873603	95876427	LINC00341	2824	0.497521
chr14	95883830	95942173	SYNE3	58343	0.506025
chr14	95999248	96001209	SNHG10	1961	0.500765
chr14	96001322	96011055	GLRX5	9733	0.434090
chr14	96039941	96045018	BC038791	5077	0.450857
chr14	96129592	96146169	TCL6	16577	0.477710
chr14	96152753	96158980	TCL1B	6227	0.497671
chr14	96176303	96180533	TCL1A	4230	0.503073
chr14	96181819	96223116	BX247990	41297	0.425576
chr14	96343108	96391908	LINC00617	48800	0.471271
chr14	96505660	96560226	C14orf132	54566	0.477642
chr14	96671134	96710666	BDKRB2	39532	0.501518
chr14	96671134	96710503	BDKRB2	39369	0.501562
chr14	96722546	96731100	BDKRB1	8554	0.447159
chr14	96747594	96829678	ATG2B	82084	0.368501
chr14	96829788	96853627	GSKIP	23839	0.389404
chr14	96858447	96955764	AK7	97317	0.441814
chr14	96968712	97033453	PAPOLA	64741	0.362336
chr14	97059069	97062079	BC035096	3010	0.516944
chr14	97263683	97347951	VRK1	84268	0.360920
chr14	97925206	97930496	BC038465	5290	0.419282
chr14	98098983	98152995	LOC100129345	54012	0.423924
chr14	98424266	98444461	C14orf64	20195	0.433969
chr14	98602323	98606215	JX073282	3892	0.451953
chr14	99177949	99184103	C14orf177	6154	0.460513
chr14	99635624	99737822	BCL11B	102198	0.507750
chr14	99864082	99947226	SETD3	83144	0.426669
chr14	99947738	99977852	CCNK	30114	0.429866
chr14	99977602	100070727	CCDC85C	93125	0.571168
chr14	100111479	100143011	HHIPL1	31532	0.551154
chr14	100140218	100140241	MIR5698	23	0.652174
chr14	100150754	100193638	CYP46A1	42884	0.471854
chr14	100259744	100408395	EML1	148651	0.431783
chr14	100531750	100610573	EVL	78823	0.500945
chr14	100612752	100626012	DEGS2	13260	0.596078
chr14	100705101	100745371	YY1	40270	0.450733
chr14	100746748	100749124	BC014138	2376	0.482744
chr14	100757452	100772860	SLC25A29	15408	0.570093
chr14	100757452	100772860	SLC25A29	15408	0.570093
chr14	100774195	100774293	MIR345	98	0.602041
chr14	100789678	100796715	SLC25A47	7037	0.609635
chr14	100800124	100842680	WARS	42556	0.467337
chr14	100842832	100996640	WDR25	153808	0.460587
chr14	100953880	100954124	7SK	244	0.426230
chr14	101003483	101034407	BEGAIN	30924	0.616867
chr14	101123604	101139081	LINC00523	15477	0.540996
chr14	101193201	101201467	DLK1	8266	0.567142
chr14	101280827	101280911	MIR2392	84	0.630952
chr14	101282377	101282581	Mico1	204	0.514706
chr14	101297757	101327360	MEG3	29603	0.518393
chr14	101318726	101318824	MIR770	98	0.653061
chr14	101320997	101323960	AK123878	2963	0.524131
chr14	101335396	101335485	MIR493	89	0.539326
chr14	101340829	101340922	MIR337	93	0.483871
chr14	101341369	101341441	MIR665	72	0.638889
chr14	101346991	101351184	RTL1	4193	0.580491
chr14	101347343	101347457	MIR431	114	0.587719
chr14	101348222	101348315	MIR433	93	0.537634
chr14	101349315	101349412	MIR127	97	0.525773
chr14	101350819	101350913	MIR432	94	0.521277
chr14	101351038	101351120	MIR136	82	0.451219
chr14	101361106	101373305	MEG8	12199	0.525617
chr14	101364256	101364333	SNORD112	77	0.376623
chr14	101382172	101382230	SNORD112	58	0.310345
chr14	101391157	101391227	SNORD113-1	70	0.328571
chr14	101393678	101393749	SNORD113-2	71	0.323944
chr14	101396255	101396327	SNORD113	72	0.388889
chr14	101402827	101402901	SNORD113-4	74	0.405405
chr14	101404523	101404600	SNORD113-5	77	0.415584
chr14	101405892	101405966	SNORD113-6	74	0.405405
chr14	101407462	101407538	SNORD113-7	76	0.421053
chr14	101411985	101412056	SNORD113-9	71	0.422535
chr14	101416169	101416240	SNORD114-1	71	0.492958
chr14	101418192	101418269	SNORD114-2	77	0.428571
chr14	101419685	101419759	SNORD114-3	74	0.486486
chr14	101420680	101420784	SNORD114-4	104	0.413462
chr14	101421706	101421775	SNORD114-5	69	0.449275
chr14	101422576	101422649	SNORD113	73	0.356164
chr14	101423502	101423573	SNORD114-6	71	0.408451
chr14	101429390	101429466	SNORD114-7	76	0.407895
chr14	101431117	101431188	SNORD114-8	71	0.408451
chr14	101432365	101432436	SNORD114-9	71	0.478873
chr14	101433388	101433459	SNORD114-10	71	0.366197
chr14	101434447	101434521	SNORD114-11	74	0.500000
chr14	101435284	101435358	SNORD114-12	74	0.445946
chr14	101436215	101436288	SNORD114-13	73	0.465753
chr14	101438439	101438513	SNORD114-14	74	0.472973
chr14	101439006	101439077	SNORD114-15	71	0.464789
chr14	101439931	101440000	SNORD114-16	69	0.478261
chr14	101441142	101441216	SNORD114-17	74	0.432432
chr14	101442161	101442232	SNORD114-18	71	0.380282
chr14	101442813	101442887	SNORD114-19	74	0.405405
chr14	101443725	101443803	SNORD113	78	0.397436
chr14	101447340	101447411	SNORD114-20	71	0.478873
chr14	101448311	101448382	SNORD114-21	71	0.464789
chr14	101449262	101449333	SNORD114-22	71	0.464789
chr14	101450212	101450283	SNORD114-23	71	0.464789
chr14	101451113	101451184	SNORD114-24	71	0.450704
chr14	101452393	101452464	SNORD114-25	71	0.478873
chr14	101453382	101453453	SNORD114-26	71	0.478873
chr14	101454497	101454566	SNORD114-27	69	0.463768
chr14	101455466	101455537	SNORD114-28	71	0.478873
chr14	101456427	101456496	SNORD114-29	69	0.434783
chr14	101458255	101458326	SNORD114-30	71	0.464789
chr14	101459572	101459646	SNORD114-31	74	0.513514
chr14	101464803	101464878	SNORD113	75	0.360000
chr14	101488402	101488469	MIR379	67	0.417910
chr14	101489661	101489757	MIR411	96	0.468750
chr14	101490130	101490193	MIR299	63	0.380952
chr14	101491353	101491414	MIR380	61	0.409836
chr14	101491900	101491988	MIR1197	88	0.420455
chr14	101492068	101492154	MIR323A	86	0.500000
chr14	101492356	101492444	MIR758	88	0.488636
chr14	101493121	101493201	MIR329-1	80	0.425000
chr14	101493436	101493520	MIR329-2	84	0.416667
chr14	101495970	101496051	MIR494	81	0.382716
chr14	101496388	101496466	MIR1193	78	0.551282
chr14	101498323	101498401	MIR543	78	0.384615
chr14	101500091	101500173	MIR495	82	0.378049
chr14	101506026	101506092	MIR376C	66	0.287879
chr14	101506068	101506089	JA715142	21	0.380952
chr14	101506405	101506485	MIR376A2	80	0.337500
chr14	101506555	101506636	MIR654	81	0.530864
chr14	101506772	101506872	MIR376B	100	0.350000
chr14	101507118	101507186	MIR376A1	68	0.294118
chr14	101507699	101507781	MIR300	82	0.439024
chr14	101509313	101509398	MIR1185-1	85	0.388235
chr14	101510534	101510619	MIR1185-2	85	0.388235
chr14	101512256	101512331	MIR381	75	0.400000
chr14	101512791	101512875	MIR487B	84	0.440476
chr14	101513657	101513735	MIR539	78	0.307692
chr14	101514237	101514316	MIR889	79	0.354430
chr14	101515886	101515983	MIR655	97	0.350515
chr14	101518782	101518862	MIR487A	80	0.412500
chr14	101520642	101520718	MIR382	76	0.381579
chr14	101521023	101521096	MIR134	73	0.602740
chr14	101521594	101521660	MIR668	66	0.590909
chr14	101521755	101521828	MIR485	73	0.479452
chr14	101522555	101522637	MIR323B	82	0.487805
chr14	101526091	101526175	MIR154	84	0.404762
chr14	101526909	101527011	MIR496	102	0.421569
chr14	101528386	101528455	MIR377	69	0.391304
chr14	101530831	101530915	MIR541	84	0.535714
chr14	101531636	101531715	MIR409	79	0.531646
chr14	101531783	101531874	MIR412	91	0.527473
chr14	101531934	101532004	MIR369	70	0.371429
chr14	101532248	101532328	MIR410	80	0.412500
chr14	101533060	101533138	MIR656	78	0.371795
chr14	101536247	101539273	MEG9	3026	0.556841
chr14	101540363	101540920	BC148240	557	0.583483
chr14	102018559	102026740	DIO3AS	8181	0.585992
chr14	102023635	102026740	DIO3OS	3105	0.623833
chr14	102023640	102026740	DIO3AS	3100	0.624516
chr14	102027687	102029789	DIO3	2102	0.607992
chr14	102196773	102198862	LINC00239	2089	0.507899
chr14	102228134	102394328	PPP2R5C	166194	0.446286
chr14	102262243	102263248	BC062337	1005	0.527363
chr14	102352724	102354918	AK311282	2194	0.489517
chr14	102430864	102517135	DYNC1H1	86271	0.469474
chr14	102547074	102606086	HSP90AA1	59012	0.472734
chr14	102606188	102676867	WDR20	70679	0.441348
chr14	102695157	102771537	MOK	76380	0.460814
chr14	102786087	102809511	ZNF839	23424	0.488046
chr14	102814615	102829051	CINP	14436	0.449155
chr14	102829299	102968818	TECPR2	139519	0.472746
chr14	102973197	102976128	ANKRD9	2931	0.694302
chr14	103005980	103006063	MIR4309	83	0.542169
chr14	103058995	103196913	RCOR1	137918	0.434838
chr14	103243815	103377837	TRAF3	134022	0.458343
chr14	103388992	103397179	AMN	8187	0.638695
chr14	103398715	103523742	CDC42BPB	125027	0.489470
chr14	103566480	103576894	EXOC3L4	10414	0.630785
chr14	103592663	103603776	TNFAIP2	11113	0.604697
chr14	103653557	103655365	LINC00605	1808	0.490597
chr14	103766554	103766577	JB175177	23	0.347826
chr14	103798010	103798704	BC042372	694	0.351585
chr14	103800338	103811361	EIF5	11023	0.439989
chr14	103804185	103804311	SNORA28	126	0.412698
chr14	103851700	103970166	MARK3	118466	0.421589
chr14	103985994	103989196	CKB	3202	0.704560
chr14	103995508	104003410	TRMT61A	7902	0.642369
chr14	103995508	104003410	TRMT61A	7902	0.642369
chr14	104022880	104028655	BAG5	5775	0.437749
chr14	104095524	104167888	KLC1	72364	0.473896
chr14	104146165	104147812	AX746968	1647	0.457802
chr14	104148692	104150352	AX746968	1660	0.468072
chr14	104163953	104181823	XRCC3	17870	0.597818
chr14	104182080	104200005	ZFYVE21	17925	0.569651
chr14	104192070	104192090	JA611241	20	0.500000
chr14	104200087	104313927	PPP1R13B	113840	0.445142
chr14	104314057	104324386	LINC00637	10329	0.543228
chr14	104378624	104387903	C14orf2	9279	0.477099
chr14	104394816	104519004	TDRD9	124188	0.426941
chr14	104406762	104408645	RD3L	1883	0.355815
chr14	104515754	104519004	TDRD9	3250	0.438154
chr14	104552022	104579046	ASPG	27024	0.634732
chr14	104583741	104583851	MIR203	110	0.572727
chr14	104583754	104583840	MIR3545	86	0.546512
chr14	104605059	104647235	KIF26A	42176	0.637732
chr14	104975961	104978198	AX746996	2237	0.598570
chr14	104978212	104979413	AX746996	1201	0.568693
chr14	105046055	105056183	C14orf180	10128	0.628258
chr14	105060419	105071097	TMEM179	10678	0.608354
chr14	105144030	105144086	MIR4710	56	0.642857
chr14	105155942	105185947	INF2	30005	0.636761
chr14	105196227	105213647	ADSSL1	17420	0.590873
chr14	105219469	105225996	SIVA1	6527	0.575456
chr14	105235686	105262080	AKT1	26394	0.640752
chr14	105266932	105271048	ZBTB42	4116	0.646259
chr14	105287537	105290055	LINC00638	2518	0.591342
chr14	105331649	105363107	CEP170B	31458	0.642984
chr14	105391186	105399573	PLD4	8387	0.632288
chr14	105403590	105444694	AHNAK2	41104	0.572864
chr14	105452615	105461855	C14orf79	9240	0.552489
chr14	105475909	105487425	CDCA4	11516	0.519278
chr14	105515736	105531754	GPR132	16018	0.556499
chr14	105607317	105635161	JAG2	27844	0.658777
chr14	105639273	105647660	NUDT14	8387	0.645881
chr14	105675622	105767329	BRF1	91707	0.568288
chr14	105714878	105717430	BTBD6	2552	0.639890
chr14	105780751	105864484	PACS2	83733	0.579174
chr14	105864919	105880196	TEX22	15277	0.519081
chr14	105886185	105937057	MTA1	50872	0.594138
chr14	105939274	105946507	CRIP2	7233	0.695285
chr14	105945707	105945729	HV555659	22	0.681818
chr14	105953256	105955124	CRIP1	1868	0.684690
chr14	105957585	105965585	C14orf80	8000	0.647250
chr14	105992952	105996539	TMEM121	3587	0.713967
chr14	105994255	107283085	abParts	1288830	0.458160
chr14	105998191	106000654	BC033241	2463	0.590743
chr14	106053224	106330846	DKFZp686O16217	277622	0.546675
chr14	106064027	106064317	epsilon IgE	290	0.706897
chr14	106303098	106329462	IGHD	26364	0.583220
chr14	106095337	106095517	AY748447	180	0.683333
chr14	106134457	106139163	ELK2AP	4706	0.568848
chr14	106170300	106170939	Ig alpha 1-[alpha]2m	639	0.622848
chr14	106185758	106186048	epsilon IgE	290	0.706897
chr14	106202679	106330469	IGHG1	127790	0.509508
chr14	106230840	106239113	FLJ00385	8273	0.636649
chr14	106355979	106388530	KIAA0125	32551	0.603484
chr14	106435818	106438358	ADAM6	2540	0.483071
chr14	106744268	106744966	LINC00226	698	0.454155
chr14	106938454	106951529	LINC00221	13075	0.436788
chr14	107034168	107035191	immunoglobulin heavy chain	1023	0.497556
chr14	107258704	107259792	LOC90925	1088	0.462316
chr15	20319594	20319625	DQ576041	31	0.548387
chr15	20327817	20327845	DQ571479	28	0.571429
chr15	20362687	20364420	BC107108	1733	0.402770
chr15	20446055	20446082	DQ592463	27	0.444444
chr15	20487996	20496811	CHEK2P2	8815	0.450369
chr15	20588367	20711433	HERC2P3	123066	0.401882
chr15	20723928	20727150	HERC2P7	3222	0.447238
chr15	20737093	20747114	GOLGA6L6	10021	0.508931
chr15	20739311	20739342	DQ582073	31	0.483871
chr15	20742234	20742263	DQ594309	29	0.448276
chr15	20744538	20744567	DQ595648	29	0.413793
chr15	20767673	20781026	GOLGA8CP	13353	0.492099
chr15	20770228	20770259	DQ600342	31	0.483871
chr15	20771429	20771455	DQ582939	26	0.384615
chr15	20771844	20771879	DQ578838	35	0.457143
chr15	20776818	20776847	DQ572979	29	0.551724
chr15	20777431	20777451	JB175342	20	0.700000
chr15	20874796	20961480	NBEAP1	86684	0.190900
chr15	21033904	21033932	DQ573684	28	0.464286
chr15	21033955	21033995	DQ595048	40	0.575000
chr15	21040700	21071977	POTEB	31277	0.365764
chr15	21122020	21134625	NF1P2	12605	0.355494
chr15	21145766	21198633	CT60	52867	0.386820
chr15	21326209	21326240	DQ576041	31	0.548387
chr15	21334429	21334457	DQ571479	28	0.571429
chr15	21932513	21940739	LOC646214	8226	0.379407
chr15	22014419	22016878	CXADRP2	2459	0.395689
chr15	22040579	22040607	DQ583164	28	0.464286
chr15	22041221	22041253	DQ573684	32	0.468750
chr15	22041532	22041569	DQ582260	37	0.594595
chr15	22043462	22043502	DQ590589	40	0.575000
chr15	22043827	22043867	DQ595048	40	0.575000
chr15	22044476	22044506	DQ587539	30	0.566667
chr15	22044731	22044761	DQ590589	30	0.566667
chr15	22045053	22045081	DQ573684	28	0.464286
chr15	22045104	22045144	DQ595048	40	0.575000
chr15	22051852	22083137	POTEB	31285	0.365894
chr15	22099106	22797761	abParts	698655	0.347491
chr15	22133180	22145802	NF1P2	12622	0.354460
chr15	22195621	22199978	DQ786202	4357	0.383291
chr15	22278031	22282405	LOC727924	4374	0.384088
chr15	22382472	22383815	OR4N4	1343	0.434103
chr15	22368477	22369561	OR4M2	1084	0.418819
chr15	22413461	22414395	OR4N3P	934	0.467880
chr15	22448275	22448786	AJ004954	511	0.544031
chr15	22546564	22570831	REREP3	24267	0.450859
chr15	22675147	22675241	MIR4509-1	94	0.319149
chr15	22702284	22714634	GOLGA8DP	12350	0.484211
chr15	22705928	22705948	JB175342	20	0.700000
chr15	22706525	22706561	DQ582448	36	0.527778
chr15	22711520	22711555	DQ588687	35	0.457143
chr15	22711944	22711970	DQ582939	26	0.384615
chr15	22713140	22713171	DQ599733	31	0.483871
chr15	22736245	22746002	GOLGA6L1	9757	0.507943
chr15	22738792	22738821	DQ577902	29	0.413793
chr15	22741096	22741125	DQ579907	29	0.448276
chr15	22743752	22743783	DQ582071	31	0.483871
chr15	22833394	22873891	TUBGCP5	40497	0.422253
chr15	22892683	23003603	CYFIP1	110920	0.488758
chr15	23004683	23034427	NIPA2	29744	0.437265
chr15	23043278	23086436	NIPA1	43158	0.465406
chr15	23094330	23115254	LOC283683	20924	0.490585
chr15	23187728	23208357	WHAMMP3	20629	0.392215
chr15	23255241	23262743	GOLGA8I	7502	0.514396
chr15	23258061	23258092	DQ600342	31	0.483871
chr15	23259258	23259284	DQ582939	26	0.384615
chr15	23259601	23259636	DQ578838	35	0.457143
chr15	23260955	23260994	DQ588973	39	0.564103
chr15	23262207	23262241	DQ595055	34	0.588235
chr15	23264308	23264337	DQ572979	29	0.551724
chr15	23264927	23264947	JB175342	20	0.700000
chr15	23282264	23311039	HERC2P2	28775	0.431312
chr15	23311874	23378259	HERC2P2	66385	0.425051
chr15	23390721	23393943	HERC2P7	3222	0.447858
chr15	23406085	23406116	DQ582073	31	0.483871
chr15	23407866	23413995	LOC440243	6129	0.499592
chr15	23409337	23409366	DQ594309	29	0.448276
chr15	23411635	23411664	DQ595648	29	0.413793
chr15	23435069	23448423	GOLGA8EP	13354	0.491688
chr15	23437626	23437657	DQ600342	31	0.483871
chr15	23439242	23439277	DQ578838	35	0.457143
chr15	23444216	23444245	DQ572979	29	0.551724
chr15	23444829	23444849	JB175342	20	0.700000
chr15	23569671	23579379	LOC440243	9708	0.507932
chr15	23571890	23571921	DQ582073	31	0.483871
chr15	23574572	23574601	DQ594309	29	0.448276
chr15	23576875	23576904	DQ595648	29	0.413793
chr15	23599894	23613471	GOLGA8S	13577	0.488105
chr15	23602423	23602454	DQ600342	31	0.483871
chr15	23604036	23604071	DQ578838	35	0.457143
chr15	23609034	23609070	DQ578199	36	0.527778
chr15	23609652	23609672	JB175342	20	0.700000
chr15	23684611	23685207	LOC283685	596	0.558725
chr15	23686020	23692390	GOLGA6L2	6370	0.508006
chr15	23807208	23807278	MIR4508	70	0.800000
chr15	23810453	23813166	MKRN3	2713	0.495024
chr15	23888695	23892993	MAGEL2	4298	0.612611
chr15	23930553	23932450	NDN	1897	0.522931
chr15	24409925	24415053	PWRN2	5128	0.445788
chr15	24803303	24832926	PWRN1	29623	0.372616
chr15	24920540	24928593	NPAP1	8053	0.484167
chr15	25101697	25223729	SNRPN	122032	0.419095
chr15	25200069	25213976	SNURF	13907	0.411376
chr15	25227140	25228937	PAR-SN	1797	0.426822
chr15	25230006	25233379	PAR5	3373	0.357545
chr15	25277533	25281635	HBT8	4102	0.344466
chr15	25287120	25287187	SNORD109B	67	0.462687
chr15	25296622	25296719	SNORD116-1	97	0.412371
chr15	25304603	25367623	IPW	63020	0.447778
chr15	25299355	25299452	SNORD116-2	97	0.412371
chr15	25302005	25302102	SNORD116-3	97	0.443299
chr15	25307478	25307575	SNORD116-5	97	0.432990
chr15	25315577	25315674	SNORD116-8	97	0.432990
chr15	25318252	25318349	SNORD116-3	97	0.443299
chr15	25319259	25319363	SNORD116-10	104	0.326923
chr15	25321074	25321168	SNORD116-11	94	0.393617
chr15	25322196	25322290	SNORD116-12	94	0.361702
chr15	25324203	25325381	SNORD116-13	1178	0.476231
chr15	25326432	25326526	SNORD116-15	94	0.404255
chr15	25327913	25328007	SNORD116-16	94	0.425532
chr15	25328733	25328827	SNORD116-19	94	0.414894
chr15	25330530	25330624	SNORD116-18	94	0.414894
chr15	25332807	25334043	SNORD116-20	1236	0.497573
chr15	25336931	25337025	SNORD116-23	94	0.436170
chr15	25337106	25337524	C15orf49	418	0.514354
chr15	25339182	25339276	SNORD116-24	94	0.393617
chr15	25342808	25342902	SNORD116-25	94	0.425532
chr15	25344644	25346814	SNORD116-26	2170	0.376037
chr15	25351666	25351751	SNORD116-29	85	0.400000
chr15	25380788	25383200	PAR1	2412	0.385158
chr15	25415869	25415951	SNORD115-1	82	0.402439
chr15	25417781	25417863	SNORD115-2	82	0.426829
chr15	25420073	25420155	SNORD115-3	82	0.414634
chr15	25421978	25422060	SNORD115-4	82	0.414634
chr15	25423884	25423966	SNORD115-5	82	0.426829
chr15	25425643	25425725	SNORD115-6	82	0.414634
chr15	25426956	25430721	SNURF-SNRPN	3765	0.591501
chr15	25427531	25427613	SNORD115-7	82	0.402439
chr15	25429452	25429534	SNORD115-8	82	0.414634
chr15	25430777	25430859	SNORD115-9	82	0.439024
chr15	25432682	25432763	SNORD115-10	81	0.432099
chr15	25434560	25434642	SNORD115-11	82	0.426829
chr15	25442574	25459165	SNURF-SNRPN	16591	0.586704
chr15	25436562	25436644	SNORD115-9	82	0.439024
chr15	25440067	25440148	SNORD115-14	81	0.419753
chr15	25444594	25444676	SNORD115-16	82	0.414634
chr15	25446469	25446551	SNORD115-17	82	0.414634
chr15	25448373	25448455	SNORD115-17	82	0.414634
chr15	25449503	25449585	SNORD115-17	82	0.414634
chr15	25451408	25477615	SNORD115-15	26207	0.581524
chr15	25455064	25455146	SNORD115-22	82	0.414634
chr15	25458805	25458876	SNORD115-24	71	0.422535
chr15	25460687	25460769	SNORD115-25	82	0.426829
chr15	25465649	25465725	SNORD115-27	76	0.368421
chr15	25467500	25467574	SNORD115-28	74	0.391892
chr15	25468392	25468474	SNORD115-11	82	0.426829
chr15	25470349	25470431	SNORD115-30	82	0.390244
chr15	25472255	25472337	SNORD115-31	82	0.414634
chr15	25474113	25474195	SNORD115-32	82	0.414634
chr15	25475984	25476066	SNORD115-33	82	0.439024
chr15	25479393	25479475	SNORD115-35	82	0.402439
chr15	25481231	25481313	SNORD115-11	82	0.426829
chr15	25481555	25620623	SNURF-SNRPN	139068	0.392722
chr15	25483132	25483214	SNORD115-37	82	0.378049
chr15	25484984	25485066	SNORD115-38	82	0.426829
chr15	25486892	25486974	SNORD115-39	82	0.414634
chr15	25488760	25488842	SNORD115-40	82	0.426829
chr15	25490624	25490706	SNORD115-41	82	0.451219
chr15	25492491	25492573	SNORD115-10	82	0.426829
chr15	25494344	25494426	SNORD115-11	82	0.426829
chr15	25496005	25496087	SNORD115-44	82	0.439024
chr15	25509673	25509726	SNORD115-45	53	0.283019
chr15	25511577	25583288	SNURF-SNRPN	71711	0.366011
chr15	25513663	25513696	SNORD115-47	33	0.333333
chr15	25514929	25515005	SNORD115-48	76	0.407895
chr15	25523489	25523556	SNORD109B	67	0.462687
chr15	25582395	25684175	UBE3A	101780	0.361407
chr15	25917503	25919572	AX747189	2069	0.521508
chr15	25923859	26108349	ATP10A	184490	0.463386
chr15	26093893	26093972	MIR4715	79	0.493671
chr15	26147506	26298267	LOC100128714	150761	0.430934
chr15	26360959	26371518	LINC00929	10559	0.464911
chr15	26788693	27018223	GABRB3	229530	0.418433
chr15	27112272	27194357	GABRA5	82085	0.433794
chr15	27216428	27778373	GABRG3	561945	0.407917
chr15	28000022	28344458	OCA2	344436	0.434908
chr15	28356182	28567298	HERC2	211116	0.437428
chr15	28595211	28595242	DQ582073	31	0.483871
chr15	28596695	28603079	AK302306	6384	0.502976
chr15	28598422	28598451	DQ594309	29	0.448276
chr15	28600726	28600755	DQ595648	29	0.413793
chr15	28623783	28632839	GOLGA8F	9056	0.520318
chr15	28626338	28626369	DQ600342	31	0.483871
chr15	28627953	28627988	DQ578838	35	0.457143
chr15	28632954	28632987	DQ578199	33	0.545455
chr15	28633576	28633596	JB175342	20	0.700000
chr15	28671636	28671730	MIR4509-1	94	0.319149
chr15	28735897	28735991	MIR4509-1	94	0.319149
chr15	28769088	28778143	GOLGA8F	9055	0.520486
chr15	28768331	28768351	JB175342	20	0.700000
chr15	28768940	28768973	DQ578700	33	0.545455
chr15	28773938	28773973	DQ588687	35	0.457143
chr15	28775557	28775588	DQ599733	31	0.483871
chr15	28798717	28804944	GOLGA6L1	6227	0.502329
chr15	28801166	28801199	DQ600136	33	0.424242
chr15	28803466	28803495	DQ579907	29	0.448276
chr15	28806018	28807725	LOC283767	1707	0.541886
chr15	28806679	28806710	DQ582071	31	0.483871
chr15	28834637	28836269	AK311660	1632	0.466299
chr15	28878268	28886727	AK309255	8459	0.440241
chr15	28895707	28895736	DQ593342	29	0.586207
chr15	28899419	28930410	HERC2P9	30991	0.436449
chr15	28947499	28947622	DQ596685	123	0.666667
chr15	28948317	28948346	DQ582448	29	0.551724
chr15	28950406	28950440	DQ593032	34	0.588235
chr15	28953178	28953213	DQ588687	35	0.457143
chr15	28953530	28953556	DQ582939	26	0.384615
chr15	28954722	28954753	DQ597560	31	0.483871
chr15	28982728	29003508	WHAMMP2	20780	0.396583
chr15	29033388	29034538	LOC100289656	1150	0.583478
chr15	29034979	29101720	LOC646278	66741	0.411157
chr15	29090106	29093821	GOLGA6L7P	3715	0.510633
chr15	29213842	29410516	APBA2	196674	0.480846
chr15	29412454	29862927	FAM189A1	450473	0.435851
chr15	29560352	29562020	NDNL2	1668	0.505396
chr15	29967193	29971367	BC043570	4174	0.572832
chr15	29992356	30114706	TJP1	122350	0.388942
chr15	30375893	30380247	AK310526	4354	0.495866
chr15	30377966	30377997	DQ600342	31	0.483871
chr15	30379163	30379189	DQ582939	26	0.384615
chr15	30379567	30379602	DQ578838	35	0.457143
chr15	30382347	30382381	DQ595055	34	0.588235
chr15	30384454	30384483	DQ572979	29	0.551724
chr15	30385073	30385093	JB175342	20	0.700000
chr15	30385179	30385302	DQ596686	123	0.658537
chr15	30392652	30392686	DQ575576	34	0.558824
chr15	30392715	30392751	DQ575284	36	0.527778
chr15	30392754	30392798	DQ577333	44	0.431818
chr15	30392982	30393011	DQ590616	29	0.448276
chr15	30393044	30393077	DQ578369	33	0.606061
chr15	30393241	30393277	DQ597873	36	0.611111
chr15	30393301	30393331	DQ589249	30	0.533333
chr15	30393336	30393374	DQ596303	38	0.526316
chr15	30393355	30393381	DQ575741	26	0.500000
chr15	30394174	30394216	DQ590322	42	0.547619
chr15	30395934	30423948	ULK4P3	28014	0.398979
chr15	30427989	30439395	GOLGA8T	11406	0.504384
chr15	30430064	30430095	DQ600342	31	0.483871
chr15	30431263	30431289	DQ582939	26	0.384615
chr15	30431667	30431702	DQ578838	35	0.457143
chr15	30434449	30434483	DQ595055	34	0.588235
chr15	30436525	30436554	DQ572979	29	0.551724
chr15	30437141	30437161	JB175342	20	0.700000
chr15	30444333	30444363	DQ590616	30	0.500000
chr15	30444594	30444628	DQ593239	34	0.588235
chr15	30488238	30506743	DKFZP434L187	18505	0.405134
chr15	30653442	30685864	CHRFAM7A	32422	0.441521
chr15	30687435	30687477	DQ587888	42	0.547619
chr15	30688270	30688296	DQ575741	26	0.500000
chr15	30688277	30688315	DQ594669	38	0.526316
chr15	30688320	30688350	DQ596319	30	0.533333
chr15	30688374	30688410	DQ585847	36	0.611111
chr15	30688574	30688607	DQ589803	33	0.606061
chr15	30688640	30688669	DQ593983	29	0.448276
chr15	30688853	30688897	DQ583847	44	0.431818
chr15	30688903	30688936	DQ599785	33	0.515152
chr15	30688965	30688999	DQ575242	34	0.558824
chr15	30691303	30691343	DQ586415	40	0.575000
chr15	30696343	30696466	DQ596685	123	0.666667
chr15	30696552	30696572	JB175342	20	0.700000
chr15	30697162	30697191	DQ582448	29	0.551724
chr15	30698915	30700176	LOC643699	1261	0.578113
chr15	30699255	30699289	DQ593032	34	0.588235
chr15	30700507	30700546	FLJ00278	39	0.564103
chr15	30702036	30703662	FLJ00278	1626	0.543050
chr15	30846984	30848610	FLJ00278	1626	0.541820
chr15	30847017	30847044	DQ582641	27	0.592593
chr15	30851358	30851392	DQ595055	34	0.588235
chr15	30853455	30853484	DQ572979	29	0.551724
chr15	30854074	30854094	JB175342	20	0.700000
chr15	30854180	30854303	DQ596686	123	0.666667
chr15	30861649	30861683	DQ575576	34	0.558824
chr15	30861712	30861748	DQ575284	36	0.527778
chr15	30861751	30861795	DQ577333	44	0.431818
chr15	30861979	30862008	DQ590616	29	0.448276
chr15	30862041	30862074	DQ578369	33	0.606061
chr15	30862238	30862274	DQ597873	36	0.611111
chr15	30862298	30862328	DQ589249	30	0.533333
chr15	30862333	30862366	DQ596303	33	0.515152
chr15	30862352	30862378	DQ575741	26	0.500000
chr15	30863171	30863213	DQ590322	42	0.547619
chr15	30864942	30892911	ULK4P1	27969	0.399907
chr15	30899038	30899069	DQ600342	31	0.483871
chr15	30906135	30906155	JB175342	20	0.700000
chr15	30916696	30918469	AK310030	1773	0.459109
chr15	30918878	30931023	ARHGAP11B	12145	0.386167
chr15	30938316	31065209	LOC100288637	126893	0.413593
chr15	31086490	31086522	DQ600342	32	0.468750
chr15	31087686	31087712	DQ582939	26	0.384615
chr15	31089586	31089625	DQ588973	39	0.564103
chr15	31090848	31090882	DQ595055	34	0.588235
chr15	31092950	31092983	DQ572979	33	0.545455
chr15	31093570	31093590	JB175342	20	0.700000
chr15	31093676	31093793	DQ596686	117	0.658120
chr15	31110238	31119986	HERC2P10	9748	0.406135
chr15	31196075	31235310	FAN1	39235	0.425411
chr15	31231143	31283807	MTMR10	52664	0.399818
chr15	31293263	31453476	TRPM1	160213	0.439802
chr15	31357234	31357344	MIR211	110	0.590909
chr15	31362037	31362385	TRPM1	348	0.477012
chr15	31514970	31523050	LOC283710	8080	0.502351
chr15	31619082	31670102	KLF13	51020	0.540298
chr15	31685045	31696111	AK093758	11066	0.542292
chr15	31775328	31947542	OTUD7A	172214	0.438170
chr15	32322685	32462384	CHRNA7	139699	0.418249
chr15	32449488	32635000	DKFZp434L187	185512	0.418663
chr15	32576352	32576459	U6	107	0.448598
chr15	32618369	32635000	DKFZp434L187	16631	0.407793
chr15	32678126	32678160	DQ585295	34	0.588235
chr15	32678391	32678421	DQ590394	30	0.500000
chr15	32685591	32685611	JB175342	20	0.700000
chr15	32686198	32686227	DQ582448	29	0.551724
chr15	32688265	32688299	DQ593032	34	0.588235
chr15	32691166	32727434	ULK4P3	36268	0.416979
chr15	32691458	32691484	DQ582939	26	0.384615
chr15	32692650	32692681	DQ597560	31	0.483871
chr15	32728784	32728826	DQ587888	42	0.547619
chr15	32729619	32729645	DQ575741	26	0.500000
chr15	32729626	32729663	DQ594669	37	0.513514
chr15	32729669	32729699	DQ596319	30	0.533333
chr15	32729723	32729759	DQ585847	36	0.611111
chr15	32729923	32729956	DQ589803	33	0.606061
chr15	32729989	32730018	DQ593983	29	0.448276
chr15	32730202	32730246	DQ583847	44	0.431818
chr15	32730249	32730285	DQ599785	36	0.527778
chr15	32730314	32730348	DQ575242	34	0.558824
chr15	32734114	32747835	GOLGA8O	13721	0.490562
chr15	32737916	32737936	JB175342	20	0.700000
chr15	32738526	32738555	DQ582448	29	0.551724
chr15	32740620	32740654	DQ593032	34	0.588235
chr15	32741875	32741914	FLJ00278	39	0.564103
chr15	32814893	32825942	WHAMMP1	11049	0.373518
chr15	32828959	32872810	LOC100996255	43851	0.380812
chr15	32888448	32889841	AK310041	1393	0.543431
chr15	32891572	32891611	FLJ00278	39	0.564103
chr15	32891927	32893206	LOC643699	1279	0.575450
chr15	32892832	32892866	DQ595055	34	0.588235
chr15	32894930	32894959	DQ572979	29	0.551724
chr15	32895549	32895569	JB175342	20	0.700000
chr15	32895655	32895778	DQ596686	123	0.666667
chr15	32907690	32931868	ARHGAP11A	24178	0.377864
chr15	32933869	32989298	SCG5	55429	0.423208
chr15	32962079	32963900	C15orf45	1821	0.421746
chr15	33009470	33011208	AX747968	1738	0.697353
chr15	33010204	33026870	GREM1	16666	0.434837
chr15	33057744	33486934	FMN1	429190	0.396400
chr15	33262927	33262992	SNORD77	65	0.338462
chr15	33528676	33539756	TMCO5B	11080	0.413267
chr15	33603176	34158303	RYR3	555127	0.415541
chr15	34158427	34331303	AVEN	172876	0.398314
chr15	34261088	34357287	CHRM5	96199	0.408778
chr15	34376223	34394053	EMC7	17830	0.395625
chr15	34394273	34396591	PGBD4	2318	0.426661
chr15	34432874	34502297	KATNBL1	69423	0.405384
chr15	34517244	34522352	EMC4	5108	0.438528
chr15	34522196	34629045	SLC12A6	106849	0.393069
chr15	34633916	34635362	NOP10	1446	0.496542
chr15	34638065	34649931	NUTM1	11866	0.498483
chr15	34651088	34659395	LPCAT4	8307	0.523655
chr15	34666315	34666619	DQ580140	304	0.542763
chr15	34671269	34682001	GOLGA8A	10732	0.503914
chr15	34674269	34674351	MIR1233-2	82	0.731707
chr15	34674763	34674797	DQ593032	34	0.588235
chr15	34677950	34677976	DQ582939	26	0.384615
chr15	34679158	34679245	KIAA0855	87	0.505747
chr15	34812854	34812880	DQ570464	26	0.576923
chr15	34813826	34813860	DQ585295	34	0.588235
chr15	34814091	34814121	DQ590394	30	0.500000
chr15	34817483	34828222	GOLGA8B	10739	0.503771
chr15	34820490	34820572	MIR1233-2	82	0.731707
chr15	34820984	34821018	DQ593032	34	0.588235
chr15	34824171	34824197	DQ582939	26	0.384615
chr15	35044641	35046782	GJD2	2141	0.512844
chr15	35047284	35105124	AK092087	57840	0.416148
chr15	35080296	35087927	ACTC1	7631	0.452103
chr15	35148551	35261995	AQR	113444	0.374784
chr15	35270541	35280497	ZNF770	9956	0.379470
chr15	35270689	35272181	BC069776	1492	0.330429
chr15	35529526	35530264	ANP32AP1	738	0.483740
chr15	35663169	35838404	DPH6	175235	0.352624
chr15	35664456	35664565	MIR3942	109	0.357798
chr15	35838395	36151202	DPH6-AS1	312807	0.370938
chr15	36219056	36219124	MIR4510	68	0.397059
chr15	36871811	37102449	C15orf41	230638	0.374383
chr15	37091300	37110707	CSNK1A1P1	19407	0.378111
chr15	37156643	37178734	LOC145845	22091	0.410756
chr15	37183221	37392341	MEIS2	209120	0.381953
chr15	38227457	38243623	TMCO5A	16166	0.384820
chr15	38276966	38332682	BC039545	55716	0.394519
chr15	38431795	38519066	BC037952	87271	0.387586
chr15	38545051	38649450	SPRED1	104399	0.351833
chr15	38746327	38777063	FAM98B	30736	0.365923
chr15	38780301	38857007	RASGRP1	76706	0.415782
chr15	38988798	38992239	C15orf53	3441	0.471665
chr15	39542884	39547048	C15orf54	4164	0.387128
chr15	39873279	39889668	THBS1	16389	0.443163
chr15	39892231	40075039	FSIP1	182808	0.384644
chr15	40091222	40121477	GPR176	30255	0.408528
chr15	40226346	40327797	EIF2AK4	101451	0.401682
chr15	40327890	40331389	SRP14	3499	0.433552
chr15	40331511	40359710	SRP14-AS1	28199	0.491188
chr15	40380090	40401085	BMF	20995	0.524553
chr15	40453209	40513337	BUB1B	60128	0.387473
chr15	40545378	40569688	PAK6	24310	0.544508
chr15	40542865	40545110	C15orf56	2245	0.581292
chr15	40573644	40574787	ANKRD63	1143	0.738408
chr15	40580097	40600174	PLCB2	20077	0.557105
chr15	40616680	40618914	AL832909	2234	0.475380
chr15	40623652	40633168	C15orf52	9516	0.587852
chr15	40643233	40648634	PHGR1	5401	0.530087
chr15	40650433	40663256	DISP2	12823	0.572253
chr15	40674921	40686489	KNSTRN	11568	0.449084
chr15	40697685	40713512	IVD	15827	0.517154
chr15	40733410	40760441	BAHD1	27031	0.530280
chr15	40763159	40765357	CHST14	2198	0.619199
chr15	40845297	40857252	C15orf57	11955	0.431033
chr15	40824082	40824749	MRPL42P5	667	0.385307
chr15	40861536	40866661	RPUSD2	5125	0.495024
chr15	40886446	40954881	CASC5	68435	0.412786
chr15	40985952	40987303	RAD51-AS1	1351	0.539600
chr15	40987326	41024356	RAD51	37030	0.433270
chr15	41028085	41047458	RMDN3	19373	0.489392
chr15	41056284	41059911	GCHFR	3627	0.572650
chr15	41060066	41099676	DNAJC17	39610	0.497905
chr15	41062158	41064648	C15orf62	2490	0.585944
chr15	41099273	41106767	ZFYVE19	7494	0.534694
chr15	41107642	41120907	PPP1R14D	13265	0.466415
chr15	41136245	41149853	SPINT1	13608	0.534392
chr15	41164411	41166487	RHOV	2076	0.622832
chr15	41186627	41196173	VPS18	9546	0.536350
chr15	41199008	41201539	BC031952	2531	0.560253
chr15	41221530	41231258	DLL4	9728	0.571032
chr15	41245635	41248717	CHAC1	3082	0.562622
chr15	41271078	41408340	INO80	137262	0.422134
chr15	41474930	41522895	EXD1	47965	0.439529
chr15	41523436	41574083	CHP1	50647	0.438940
chr15	41576200	41591795	OIP5-AS1	15595	0.434114
chr15	41594572	41598726	BC067230	4154	0.367357
chr15	41601465	41624819	OIP5	23354	0.454612
chr15	41624891	41673248	NUSAP1	48357	0.445168
chr15	41679546	41694658	NDUFAF1	15112	0.460693
chr15	41709301	41775761	RTF1	66460	0.453987
chr15	41786055	41795757	ITPKA	9702	0.591012
chr15	41795839	41806085	LTK	10246	0.578958
chr15	41809374	41836464	RPAP1	27090	0.504245
chr15	41851219	41871536	TYRO3	20317	0.541517
chr15	41952609	42062141	MGA	109532	0.396167
chr15	41983782	41983876	MIR626	94	0.319149
chr15	42066631	42120053	MAPKBP1	53422	0.490903
chr15	42100588	42102743	BC045779	2155	0.530394
chr15	42120282	42140346	JMJD7-PLA2G4B	20064	0.576954
chr15	42140343	42186275	SPTBN5	45932	0.593094
chr15	42158692	42158749	MIR4310	57	0.614035
chr15	42191638	42264755	EHD4	73117	0.470027
chr15	42273779	42342901	PLA2G4E	69122	0.501996
chr15	42359880	42386752	PLA2G4D	26872	0.516374
chr15	42433331	42448839	PLA2G4F	15508	0.566095
chr15	42450898	42500502	VPS39	49604	0.426075
chr15	42491767	42491864	MIR627	97	0.350515
chr15	42502725	42565755	TMEM87A	63030	0.389180
chr15	42566365	42645864	GANC	79499	0.403112
chr15	42651697	42704515	CAPN3	52818	0.468533
chr15	42705020	42749730	ZNF106	44710	0.411183
chr15	42787503	42825259	SNAP23	37756	0.420701
chr15	42834719	42841002	LRRC57	6283	0.433392
chr15	42841010	42862190	HAUS2	21180	0.421105
chr15	42867856	43013196	STARD9	145340	0.434946
chr15	43015759	43029417	CDAN1	13658	0.546713
chr15	43030612	43035400	BC037861	4788	0.392022
chr15	43033743	43035546	DQ586540	1803	0.358292
chr15	43036541	43213007	TTBK2	176466	0.399352
chr15	43235097	43398286	UBR1	163189	0.398097
chr15	43425721	43477341	TMEM62	51620	0.401860
chr15	43477465	43489375	CCNDBP1	11910	0.407053
chr15	43489425	43513323	EPB42	23898	0.500670
chr15	43524792	43559055	TGM5	34263	0.462919
chr15	43568478	43594453	TGM7	25975	0.477382
chr15	43619973	43622820	LCMT2	2847	0.523007
chr15	43622871	43646096	ADAL	23225	0.398967
chr15	43650369	43662258	ZSCAN29	11889	0.427790
chr15	43663312	43698240	TUBGCP4	34928	0.419606
chr15	43699411	43785354	TP53BP1	85943	0.414612
chr15	43809805	43823818	MAP1A	14013	0.545493
chr15	43825659	43882451	PPIP5K1	56792	0.446137
chr15	43885251	43891604	CKMT1B	6353	0.502282
chr15	43891760	43910998	STRC	19238	0.510292
chr15	43894786	43894832	RNU6-28P	46	0.456522
chr15	43922771	43941039	CATSPER2	18268	0.427743
chr15	43925928	43927115	AX748052	1187	0.426285
chr15	43956615	43982247	PPIP5K1	25632	0.455993
chr15	43985083	43991420	CKMT1A	6337	0.502446
chr15	44002671	44004966	STRC	2295	0.564270
chr15	44006786	44010016	STRC	3230	0.559133
chr15	44028145	44038496	CATSPER2P1	10351	0.439378
chr15	44036030	44039292	CATSPER2P1	3262	0.545984
chr15	44038589	44064804	PDIA3	26215	0.431013
chr15	44064797	44069502	ELL3	4705	0.513709
chr15	44084173	44088287	SERF2	4114	0.544725
chr15	44091555	44094769	HYPK	3214	0.502800
chr15	44085856	44085957	MIR1282	101	0.544554
chr15	44086371	44092295	SERINC4	5924	0.496286
chr15	44096732	44116951	MFAP1	20219	0.439685
chr15	44119111	44160617	WDR76	41506	0.419120
chr15	44165729	44487429	FRMD5	321700	0.412406
chr15	44168023	44170369	PIN4P1	2346	0.469736
chr15	44580908	44707959	CASC4	127051	0.405955
chr15	44719578	44819429	CTDSPL2	99851	0.401608
chr15	44826702	44829121	EIF3J-AS1	2419	0.499380
chr15	44829265	44855001	EIF3J	25736	0.421355
chr15	44854893	44955876	SPG11	100983	0.412763
chr15	44957929	44969086	PATL2	11157	0.472260
chr15	44966960	45003514	PATL2	36554	0.418969
chr15	45003684	45010357	B2M	6673	0.429942
chr15	45028539	45060025	TRIM69	31486	0.390586
chr15	45176813	45176978	U1	165	0.490909
chr15	45248899	45271421	C15orf43	22522	0.375100
chr15	45295061	45295226	U1	165	0.496970
chr15	45315301	45367287	SORD	51986	0.452506
chr15	45384851	45406359	DUOX2	21508	0.547750
chr15	45406522	45410301	DUOXA2	3779	0.587722
chr15	45409563	45422059	DUOXA1	12496	0.490237
chr15	45422191	45457774	DUOX1	35583	0.528567
chr15	45459411	45493373	SHF	33962	0.508804
chr15	45490803	45490875	TRNA	72	0.569444
chr15	45492610	45492682	TRNA	72	0.569444
chr15	45544427	45568132	SLC28A2	23705	0.416494
chr15	45653321	45670980	GATM	17659	0.408007
chr15	45670897	45672321	GATM-AS1	1424	0.480337
chr15	45671399	45694520	BC039389	23121	0.396998
chr15	45694518	45713616	SPATA5L1	19098	0.414860
chr15	45722726	45725647	C15orf48	2921	0.393016
chr15	45742462	45771942	AK056686	29480	0.461160
chr15	45774679	45815002	SLC30A4	40323	0.401161
chr15	45803333	45848928	HMGN2P46	45595	0.434719
chr15	45879416	45901909	BLOC1S6	22493	0.387854
chr15	45923345	45983492	SQRDL	60147	0.449216
chr15	48010685	48066420	SEMA6D	55735	0.408792
chr15	48413168	48434589	SLC24A5	21421	0.354092
chr15	48426827	48428972	AK021664	2145	0.336597
chr15	48431628	48470558	MYEF2	38930	0.338633
chr15	48498497	48596275	SLC12A1	97778	0.384207
chr15	48483866	48495951	CTXN2	12085	0.351676
chr15	48623620	48635570	DUT	11950	0.390377
chr15	48700502	48937985	FBN1	237483	0.389194
chr15	49030134	49103343	CEP152	73209	0.360092
chr15	49115933	49255641	SHC4	139708	0.399469
chr15	49170289	49172380	EID1	2091	0.401722
chr15	49280834	49338760	SECISBP2L	57926	0.367762
chr15	49417470	49447854	COPS2	30384	0.349526
chr15	49462421	49622002	GALK2	159581	0.383204
chr15	49448494	49450822	NDUFAF4P1	2328	0.352663
chr15	49461266	49461350	MIR4716	84	0.452381
chr15	49620591	49913118	FAM227B	292527	0.361317
chr15	49715374	49779523	FGF7	64149	0.338322
chr15	49913225	49937333	DTWD1	24108	0.351087
chr15	50150434	50411419	ATP8B4	260985	0.379317
chr15	50474392	50528589	SLC27A2	54197	0.422496
chr15	50534145	50558162	HDC	24017	0.463921
chr15	50569388	50647605	GABPB1	78217	0.394492
chr15	50641134	50647076	FLJ10038	5942	0.412992
chr15	50646370	50650503	GABPB1-AS1	4133	0.508589
chr15	50647663	50650503	BX537481	2840	0.433803
chr15	50652525	50652607	MIR4712	82	0.390244
chr15	50716578	50793277	USP8	76699	0.395611
chr15	50784502	50787028	AX746640	2526	0.398654
chr15	50792758	50838902	USP50	46144	0.409414
chr15	50849351	50979012	TRPM7	129661	0.388320
chr15	50999736	51057910	SPPL2A	58174	0.407158
chr15	51132072	51144737	AK091906	12665	0.403079
chr15	51200868	51298097	AP4E1	97229	0.379198
chr15	51236325	51238762	DCAF13P3	2437	0.367665
chr15	51348798	51397473	TNFAIP8L3	48675	0.447191
chr15	51500253	51630795	CYP19A1	130542	0.440640
chr15	51534386	51534461	MIR4713	75	0.533333
chr15	51542453	51542483	DQ598506	30	0.566667
chr15	51543546	51543582	DQ588654	36	0.527778
chr15	51551890	51552606	DQ570035	716	0.402235
chr15	51557725	51557755	DQ577752	30	0.500000
chr15	51558439	51558475	DQ585809	36	0.555556
chr15	51563750	51563786	DQ570558	36	0.472222
chr15	51566742	51566778	DQ594218	36	0.361111
chr15	51567269	51567300	DQ579404	31	0.580645
chr15	51568560	51568591	DQ595419	31	0.451613
chr15	51571251	51571280	DQ596480	29	0.482759
chr15	51571425	51571483	DQ575060	58	0.500000
chr15	51571575	51571606	DQ594981	31	0.483871
chr15	51572986	51573445	DQ576445	459	0.546841
chr15	51578189	51578224	DQ584012	35	0.542857
chr15	51578440	51578490	DQ596502	50	0.440000
chr15	51578707	51578757	DQ589218	50	0.460000
chr15	51578925	51578955	DQ589533	30	0.466667
chr15	51579276	51579305	DQ591628	29	0.413793
chr15	51579552	51579609	DQ575848	57	0.508772
chr15	51579643	51579684	DQ573334	41	0.512195
chr15	51579760	51579791	DQ589081	31	0.612903
chr15	51579857	51579930	DQ570455	73	0.424658
chr15	51579964	51579995	DQ586227	31	0.548387
chr15	51580183	51580245	DQ589222	62	0.387097
chr15	51580359	51580388	DQ596958	29	0.379310
chr15	51580414	51580471	DQ574553	57	0.543860
chr15	51580871	51580940	DQ597104	69	0.550725
chr15	51581042	51581075	DQ593878	33	0.484848
chr15	51581135	51581177	DQ587578	42	0.547619
chr15	51581296	51581327	DQ591221	31	0.580645
chr15	51581605	51581640	DQ578051	35	0.600000
chr15	51582058	51582095	DQ577970	37	0.486486
chr15	51582198	51582232	DQ572519	34	0.500000
chr15	51582267	51582298	DQ577197	31	0.516129
chr15	51582486	51582530	DQ576221	44	0.454545
chr15	51582799	51582837	DQ588253	38	0.421053
chr15	51583124	51583176	DQ578013	52	0.461538
chr15	51583222	51583274	DQ601543	52	0.538462
chr15	51583428	51583499	DQ586374	71	0.507042
chr15	51583791	51583828	DQ573812	37	0.540541
chr15	51583923	51583957	DQ594762	34	0.500000
chr15	51583981	51584039	DQ577476	58	0.431034
chr15	51584105	51584148	DQ595618	43	0.395349
chr15	51584184	51584218	DQ579954	34	0.558824
chr15	51584347	51584383	DQ585102	36	0.500000
chr15	51584569	51584604	DQ586940	35	0.542857
chr15	51584694	51584723	DQ593177	29	0.448276
chr15	51584725	51584758	DQ592264	33	0.393939
chr15	51584946	51584998	DQ578940	52	0.557692
chr15	51585086	51585116	DQ584158	30	0.533333
chr15	51585224	51585272	DQ578873	48	0.500000
chr15	51585559	51585606	DQ599294	47	0.468085
chr15	51585635	51585685	DQ595015	50	0.440000
chr15	51588124	51589178	DQ572923	1054	0.444023
chr15	51589751	51589811	DQ577875	60	0.466667
chr15	51589957	51589988	DQ570267	31	0.419355
chr15	51590388	51590442	DQ582266	54	0.425926
chr15	51590457	51590493	DQ596795	36	0.388889
chr15	51590892	51590922	DQ599297	30	0.533333
chr15	51590960	51591000	DQ573486	40	0.475000
chr15	51591112	51591143	DQ591901	31	0.483871
chr15	51591384	51591428	DQ595884	44	0.431818
chr15	51591428	51591479	DQ591360	51	0.450980
chr15	51591579	51591620	DQ590886	41	0.463415
chr15	51591641	51591671	DQ599277	30	0.533333
chr15	51591675	51591706	DQ597610	31	0.580645
chr15	51591796	51591827	DQ583962	31	0.419355
chr15	51591834	51591862	DQ577380	28	0.500000
chr15	51591904	51591964	DQ589180	60	0.483333
chr15	51592244	51592286	DQ591818	42	0.523810
chr15	51592524	51592595	DQ594922	71	0.507042
chr15	51592820	51592850	DQ589785	30	0.533333
chr15	51593082	51593303	T-18	221	0.434389
chr15	51593475	51593552	DQ586425	77	0.454545
chr15	51593587	51593617	DQ575002	30	0.533333
chr15	51593629	51593658	DQ595346	29	0.551724
chr15	51593785	51593819	DQ596584	34	0.500000
chr15	51594293	51594327	DQ579261	34	0.382353
chr15	51594520	51594591	DQ577411	71	0.535211
chr15	51594624	51594661	DQ580114	37	0.486486
chr15	51594692	51594756	DQ601847	64	0.468750
chr15	51594867	51594896	DQ594304	29	0.551724
chr15	51595106	51595144	DQ585053	38	0.578947
chr15	51595234	51595275	DQ588149	41	0.512195
chr15	51633712	51700209	GLDN	66497	0.448035
chr15	51739920	51914967	DMXL2	175047	0.369438
chr15	51973549	52013223	SCG3	39674	0.401245
chr15	52015260	52030320	LYSMD2	15060	0.435724
chr15	52043757	52108558	TMOD2	64801	0.415225
chr15	52121824	52204331	TMOD3	82507	0.401069
chr15	52230221	52263958	LEO1	33737	0.430981
chr15	52311410	52358462	MAPK6	47052	0.421279
chr15	52401821	52404972	BCL2L10	3151	0.543320
chr15	52413122	52420992	GNB5	7870	0.420839
chr15	52413122	52483565	GNB5	70443	0.451826
chr15	52472222	52498076	LOC100129973	25854	0.432196
chr15	52484514	52587995	MYO5C	103481	0.455639
chr15	52569313	52569397	MIR1266	84	0.535714
chr15	52599479	52821247	MYO5A	221768	0.399174
chr15	52839431	52861213	ARPP19	21782	0.380084
chr15	52873517	52970820	FAM214A	97303	0.364151
chr15	53049159	53082209	ONECUT1	33050	0.461089
chr15	53805937	54051859	WDR72	245922	0.365128
chr15	53944173	53944320	U2	147	0.346939
chr15	54305100	54920806	UNC13C	615706	0.360549
chr15	55473511	55489231	RSL24D1	15720	0.364186
chr15	55495163	55563107	RAB27A	67944	0.395532
chr15	55609654	55611392	HP06981	1738	0.482739
chr15	55611132	55647846	PIGB	36714	0.400065
chr15	55647420	55700708	CCPG1	53288	0.404988
chr15	55665137	55665232	MIR628	95	0.410526
chr15	55700722	55710910	FLJ27352	10188	0.424519
chr15	55722505	55800432	DYX1C1	77927	0.423242
chr15	55831081	55834829	AK055370	3748	0.313234
chr15	55838220	55881050	PYGO1	42830	0.403782
chr15	55903738	56035177	PRTG	131439	0.385403
chr15	56119121	56209329	NEDD4	90208	0.378226
chr15	56382730	56535483	RFX7	152753	0.371417
chr15	56657643	56738072	TEX9	80429	0.358639
chr15	56720928	56757335	MNS1	36407	0.352927
chr15	56835149	56921786	BC037892	86637	0.368930
chr15	56922373	57025787	ZNF280D	103414	0.346384
chr15	57210832	57580714	TCF12	369882	0.370040
chr15	57592562	57599965	LINC00926	7403	0.493043
chr15	57668702	57842925	CGNL1	174223	0.437422
chr15	57669343	57699476	BC015433	30133	0.433943
chr15	57884101	58009755	GCOM1	125654	0.411535
chr15	57998900	58001556	POLR2M	2656	0.444277
chr15	58245621	58358121	ALDH1A2	112500	0.385991
chr15	58430407	58478110	AQP9	47703	0.406201
chr15	58724174	58861073	LIPC	136899	0.461304
chr15	58727099	58790934	AX747251	63835	0.464275
chr15	58813509	58815570	BC034927	2061	0.548763
chr15	58888509	59042177	ADAM10	153668	0.374424
chr15	58982650	58985478	HSP90AB4P	2828	0.459335
chr15	59052664	59052880	U3	216	0.458333
chr15	59063392	59149734	FAM63B	86342	0.402678
chr15	59152981	59154098	unknown	1117	0.310654
chr15	59171243	59225852	SLTM	54609	0.387280
chr15	59279864	59389618	RNF111	109754	0.383239
chr15	59397283	59417244	CCNB2	19961	0.426331
chr15	59428167	59665071	MYO1E	236904	0.434969
chr15	59463381	59463461	MIR2116	80	0.525000
chr15	59499014	59500785	LDHAL6B	1771	0.420102
chr15	59730371	59815751	FAM81A	85380	0.412275
chr15	59903981	59912210	GCNT3	8229	0.439665
chr15	59930260	59949737	GTF2A2	19477	0.397238
chr15	59955061	59981642	BNIP2	26581	0.387833
chr15	60296420	60298142	FOXB1	1722	0.668990
chr15	60639349	60690185	ANXA2	50836	0.446868
chr15	60641326	60641350	DJ439579	24	0.416667
chr15	60643390	60643412	DJ439566	22	0.545455
chr15	60643424	60643450	DJ439574	26	0.500000
chr15	60644610	60644633	DJ439529	23	0.521739
chr15	60674555	60674578	DJ439575	23	0.391304
chr15	60678229	60678259	DJ439531	30	0.533333
chr15	60711807	60771359	NARG2	59552	0.369140
chr15	60771379	60823166	BC035094	51787	0.393381
chr15	60780482	60919729	RORA	139247	0.400368
chr15	61571589	61571875	7SK	286	0.447552
chr15	61890712	61897440	BC033962	6728	0.396849
chr15	62144589	62352664	VPS13C	208075	0.348740
chr15	62352737	62353471	BC028842	734	0.527248
chr15	62359175	62363116	C2CD4A	3941	0.521188
chr15	62455736	62457482	C2CD4B	1746	0.671821
chr15	62512969	62513056	DQ578136	87	0.436782
chr15	62513157	62513187	DQ594846	30	0.366667
chr15	62513464	62513497	DQ573709	33	0.545455
chr15	62513722	62513758	DQ576270	36	0.555556
chr15	62513835	62513902	DQ571252	67	0.477612
chr15	62513945	62513972	DQ577682	27	0.481481
chr15	62513975	62514006	DQ594995	31	0.354839
chr15	62514118	62514153	DQ577554	35	0.542857
chr15	62514286	62514330	DQ576037	44	0.454545
chr15	62514422	62514461	DQ573033	39	0.410256
chr15	62514597	62514631	DQ598149	34	0.470588
chr15	62514635	62514702	DQ575070	67	0.522388
chr15	62514878	62514920	DQ573760	42	0.476190
chr15	62515075	62515109	DQ596663	34	0.470588
chr15	62515158	62515195	DQ595554	37	0.513514
chr15	62515211	62515244	DQ594736	33	0.545455
chr15	62515737	62515768	DQ575936	31	0.516129
chr15	62515891	62515925	DQ597410	34	0.529412
chr15	62515952	62515985	DQ577084	33	0.424242
chr15	62519455	62519484	DQ582356	29	0.413793
chr15	62521692	62521725	DQ571395	33	0.424242
chr15	62523739	62523776	DQ587974	37	0.594595
chr15	62524418	62524449	DQ579199	31	0.451613
chr15	62531008	62531059	DQ584023	51	0.490196
chr15	62531213	62531245	DQ573710	32	0.406250
chr15	62531272	62531303	DQ598244	31	0.451613
chr15	62531335	62531376	DQ579765	41	0.487805
chr15	62531655	62531684	DQ587000	29	0.551724
chr15	62531850	62531902	DQ600178	52	0.365385
chr15	62531928	62531971	DQ586290	43	0.511628
chr15	62532077	62532119	DQ595400	42	0.523810
chr15	62532182	62532229	DQ585588	47	0.425532
chr15	62532423	62532489	DQ575033	66	0.545455
chr15	62532598	62532641	DQ577410	43	0.441860
chr15	62532858	62532894	DQ578183	36	0.472222
chr15	62532979	62533010	DQ601882	31	0.387097
chr15	62533116	62533147	DQ596114	31	0.483871
chr15	62533248	62533279	DQ600633	31	0.580645
chr15	62533326	62533383	DQ601360	57	0.508772
chr15	62533392	62533492	DQ576562	100	0.530000
chr15	62533626	62533659	DQ593323	33	0.545455
chr15	62533667	62533730	DQ588198	63	0.603175
chr15	62534208	62534238	DQ600036	30	0.500000
chr15	62534376	62534406	DQ571566	30	0.500000
chr15	62534444	62534492	DQ600540	48	0.500000
chr15	62534767	62534820	DQ581622	53	0.490566
chr15	62534844	62534874	DQ600614	30	0.500000
chr15	62534933	62534982	DQ576354	49	0.448980
chr15	62535041	62535078	DQ579022	37	0.540541
chr15	62535220	62535252	DQ577256	32	0.625000
chr15	62535319	62535356	DQ583818	37	0.594595
chr15	62535522	62535664	DQ575950	142	0.591549
chr15	62535715	62535757	DQ598884	42	0.476190
chr15	62535966	62536093	DQ599798	127	0.559055
chr15	62536136	62536180	DQ579681	44	0.545455
chr15	62536322	62536353	DQ571691	31	0.580645
chr15	62536751	62536788	DQ575757	37	0.540541
chr15	62536847	62536907	DQ573567	60	0.583333
chr15	62537016	62537084	DQ570912	68	0.529412
chr15	62537091	62537139	DQ593779	48	0.520833
chr15	62537228	62537267	DQ592649	39	0.512821
chr15	62537394	62537456	DQ570033	62	0.516129
chr15	62537675	62537704	DQ596703	29	0.517241
chr15	62537737	62537766	DQ596118	29	0.586207
chr15	62537772	62537806	DQ601697	34	0.647059
chr15	62537905	62540994	FLJ38723	3089	0.538362
chr15	62537917	62537972	DQ593269	55	0.636364
chr15	62538064	62538104	DQ597549	40	0.575000
chr15	62538119	62538178	DQ577988	59	0.559322
chr15	62538303	62538373	DQ592221	70	0.500000
chr15	62538412	62538477	DQ586284	65	0.569231
chr15	62538639	62538706	DQ576429	67	0.522388
chr15	62538730	62538802	DQ586285	72	0.569444
chr15	62538850	62538890	DQ570129	40	0.500000
chr15	62538891	62538940	DQ590273	49	0.489796
chr15	62538954	62539000	DQ574151	46	0.500000
chr15	62539113	62539150	DQ584931	37	0.540541
chr15	62539261	62539305	DQ575559	44	0.545455
chr15	62539440	62539481	DQ572791	41	0.463415
chr15	62539585	62539616	DQ583624	31	0.516129
chr15	62539621	62539658	DQ596164	37	0.567568
chr15	62539727	62539767	DQ590682	40	0.600000
chr15	62540295	62540336	DQ578824	41	0.463415
chr15	62540676	62540745	DQ573543	69	0.507246
chr15	62540765	62540795	DQ596057	30	0.433333
chr15	62542515	62542546	DQ586930	31	0.548387
chr15	62542567	62542606	DQ592483	39	0.615385
chr15	62542822	62542867	DQ570108	45	0.511111
chr15	62543173	62543237	DQ581948	64	0.406250
chr15	62543339	62543381	DQ601452	42	0.476190
chr15	62543517	62543552	DQ591603	35	0.400000
chr15	62544055	62544086	DQ582866	31	0.612903
chr15	62544415	62544452	DQ580408	37	0.486486
chr15	62544604	62544653	DQ599965	49	0.448980
chr15	62545044	62545098	DQ588475	54	0.425926
chr15	62545375	62545429	DQ595396	54	0.518519
chr15	62545485	62545518	DQ591811	33	0.515152
chr15	62545532	62545562	DQ583824	30	0.533333
chr15	62546035	62546097	DQ590438	62	0.580645
chr15	62546178	62546220	DQ584326	42	0.523810
chr15	62546281	62546317	DQ588883	36	0.527778
chr15	62546358	62546423	DQ571370	65	0.615385
chr15	62546487	62546531	DQ589078	44	0.568182
chr15	62546602	62546634	DQ598459	32	0.625000
chr15	62546706	62546735	DQ584837	29	0.586207
chr15	62546973	62547012	DQ578258	39	0.512821
chr15	62547125	62547162	DQ584931	37	0.540541
chr15	62547452	62547493	DQ572791	41	0.463415
chr15	62547559	62547588	DQ576734	29	0.448276
chr15	62547590	62547628	DQ590839	38	0.473684
chr15	62547633	62547672	DQ576154	39	0.564103
chr15	62547749	62547793	DQ593480	44	0.613636
chr15	62547775	62547806	DQ590680	31	0.516129
chr15	62548179	62548241	DQ570108	62	0.500000
chr15	62548616	62548645	DQ588715	29	0.517241
chr15	62548724	62548764	DQ601452	40	0.475000
chr15	62549794	62549824	DQ576744	30	0.433333
chr15	62549878	62549941	DQ582184	63	0.460317
chr15	62555301	62555339	DQ585294	38	0.447368
chr15	62556276	62556310	DQ587962	34	0.470588
chr15	62929370	62937380	MGC15885	8010	0.465418
chr15	62939509	63136829	TLN2	197320	0.433864
chr15	63116155	63116240	MIR190A	85	0.341176
chr15	63124322	63127596	AK125516	3274	0.440440
chr15	63334837	63364113	TPM1	29276	0.450540
chr15	63338232	63341586	AX747619	3354	0.532797
chr15	63413998	63434260	LACTB	20262	0.400010
chr15	63445538	63449741	RPS27L	4203	0.379729
chr15	63481727	63559973	RAB8B	78246	0.397950
chr15	63569748	63601325	APH1B	31577	0.402952
chr15	63615729	63674075	CA12	58346	0.483769
chr15	63796709	63886839	USP3	90130	0.384434
chr15	63879908	63893026	USP3-AS1	13118	0.460665
chr15	63889551	63894620	FBXL22	5069	0.571513
chr15	63900816	64126147	HERC1	225331	0.388136
chr15	64199234	64338521	DAPK2	139287	0.470424
chr15	64364760	64386207	FAM96A	21447	0.417308
chr15	64388082	64436433	SNX1	48351	0.431160
chr15	64443915	64449680	SNX22	5765	0.580746
chr15	64448013	64455354	PPIB	7341	0.527721
chr15	64457715	64648442	CSNK1G1	190727	0.402796
chr15	64657210	64673702	KIAA0101	16492	0.432634
chr15	64680002	64747502	TRIP4	67500	0.420889
chr15	64791618	64978266	ZNF609	186648	0.425164
chr15	64979772	64995462	OAZ2	15690	0.478139
chr15	65032094	65067770	RBPMS2	35676	0.527105
chr15	65054585	65054714	MIR1272	129	0.480620
chr15	65107832	65117838	PIF1	10006	0.553268
chr15	65134081	65160201	PLEKHO2	26120	0.539587
chr15	65204100	65251041	ANKDD1A	46941	0.466927
chr15	65255362	65282251	SPG21	26889	0.438209
chr15	65293849	65321977	MTFMT	28128	0.399993
chr15	65337707	65345734	SLC51B	8027	0.478012
chr15	65345674	65360388	RASL12	14714	0.520593
chr15	65369153	65372276	KBTBD13	3123	0.598143
chr15	65385341	65398726	UBAP1L	13385	0.528427
chr15	65409716	65426174	PDCD7	16458	0.457224
chr15	65442783	65477563	CLPX	34780	0.399252
chr15	65488336	65503840	CILP	15504	0.498710
chr15	65550436	65579018	PARP16	28582	0.469911
chr15	65619464	65670378	IGDCC3	50914	0.518600
chr15	65673824	65715410	IGDCC4	41586	0.519021
chr15	65737997	65810035	DPP8	72038	0.411588
chr15	65822826	65870693	PTPLAD1	47867	0.424907
chr15	65871095	65903627	VWA9	32532	0.406646
chr15	65914269	65948598	SLC24A1	34329	0.462757
chr15	65952956	66084631	DENND4A	131675	0.373222
chr15	65989170	65989274	SnoU13	104	0.423077
chr15	66011583	66011670	MIR4511	87	0.367816
chr15	66161796	66184329	RAB11A	22533	0.392535
chr15	66187633	66546075	MEGF11	358442	0.489862
chr15	66332570	66332670	MIR4311	100	0.570000
chr15	66585919	66626236	DIS3L	40317	0.426991
chr15	66629007	66649054	TIPIN	20047	0.431885
chr15	66639543	66639680	SCARNA14	137	0.423358
chr15	66679210	66783882	MAP2K1	104672	0.447063
chr15	66782665	66784406	SNAPC5	1741	0.427915
chr15	66782665	66790146	SNAPC5	7481	0.445529
chr15	66791652	66797193	RPL4	5541	0.419058
chr15	66794359	66794429	SNORD18B	70	0.342857
chr15	66795148	66795248	SNORD16	100	0.440000
chr15	66795582	66795652	SNORD18A	70	0.414286
chr15	66797430	66841822	ZWILCH	44392	0.403992
chr15	66840536	66857835	LCTL	17299	0.446558
chr15	66994673	67074337	SMAD6	79664	0.509063
chr15	67152640	67156987	BX538221	4347	0.492984
chr15	67156988	67159361	BX538221	2373	0.525495
chr15	67358194	67487533	SMAD3	129339	0.481471
chr15	67493012	67547074	AAGAB	54062	0.392586
chr15	67547137	67794142	IQCH	247005	0.392114
chr15	67695948	67814182	IQCH-AS1	118234	0.416834
chr15	67807259	67813311	IQCH-AS1	6052	0.427462
chr15	67813521	67819641	C15orf61	6120	0.400000
chr15	67835020	68099455	MAP2K5	264435	0.395481
chr15	68112041	68126174	SKOR1	14133	0.604472
chr15	68346571	68480404	PIAS1	133833	0.375401
chr15	68483042	68498448	CALML4	15406	0.506945
chr15	68499329	68522080	CLN6	22751	0.527274
chr15	68570140	68583640	FEM1B	13500	0.408370
chr15	68594041	68724492	ITGA11	130451	0.495021
chr15	68908878	69020144	CORO2B	111266	0.488119
chr15	69070874	69113261	ANP32A	42387	0.494019
chr15	69094188	69094264	MIR4312	76	0.592105
chr15	69096159	69099440	ANP32A-IT1	3281	0.485523
chr15	69116302	69489862	MIR548H4	373560	0.424366
chr15	69307033	69349501	NOX5	42468	0.459546
chr15	69222838	69239150	SPESP1	16312	0.359919
chr15	69373189	69388163	LINC00277	14974	0.481034
chr15	69452972	69564544	GLCE	111572	0.366239
chr15	69591293	69699976	PAQR5	108683	0.468730
chr15	69706626	69740764	KIF23	34138	0.393257
chr15	69745158	69747884	RPLP1	2726	0.488261
chr15	69854058	69863779	LOC145837	9721	0.470528
chr15	69884467	69905229	AK097902	20762	0.490078
chr15	70127572	70135306	LINC00593	7734	0.521334
chr15	70340542	70390256	TLE3	49714	0.521362
chr15	70371710	70371807	MIR629	97	0.597938
chr15	70485574	70485683	U6	109	0.422018
chr15	70946892	71055850	UACA	108958	0.373364
chr15	71123888	71146498	LARP6	22610	0.445688
chr15	71184927	71342436	LRRC49	157509	0.369350
chr15	71173680	71184772	THAP10	11092	0.365849
chr15	71402582	71407839	CT62	5257	0.466045
chr15	71433787	72075722	THSD4	641935	0.423470
chr15	71477955	71481362	BC043587	3407	0.453478
chr15	72102893	72107270	NR2E3	4377	0.604752
chr15	72118360	72410440	MYO9A	292080	0.378722
chr15	72410630	72433311	SENP8	22681	0.397910
chr15	72452146	72490136	GRAMD2	37990	0.494209
chr15	72491369	72495005	PKM	3636	0.544004
chr15	72491369	72523727	PKM	32358	0.481519
chr15	72491955	72491985	JA375062	30	0.733333
chr15	72533521	72563628	PARP6	30107	0.431660
chr15	72571207	72644135	BC034424	72928	0.464719
chr15	72577067	72613043	CELF6	35976	0.487297
chr15	72635777	72668520	HEXA	32743	0.454082
chr15	72668453	72671129	HEXA-AS1	2676	0.411809
chr15	72690667	72700708	TMEM202	10041	0.410915
chr15	72766666	72878896	ARIH1	112230	0.387107
chr15	72879557	72879654	MIR630	97	0.340206
chr15	72901209	72901244	DQ578838	35	0.457143
chr15	72903490	72903521	DQ582071	31	0.483871
chr15	72904792	72904821	DQ578199	29	0.482759
chr15	72908150	72910583	AX748294	2433	0.485820
chr15	72947037	72959738	GOLGA6B	12701	0.521927
chr15	72953750	72953789	DQ588973	39	0.564103
chr15	72956240	72956269	DQ582073	29	0.482759
chr15	72956899	72956927	DQ577530	28	0.535714
chr15	72968122	72978490	HIGD2B	10368	0.439622
chr15	72978519	73030817	BBS4	52298	0.407549
chr15	73043707	73076126	ADPGK	32419	0.429748
chr15	73074464	73076667	ADPGK	2203	0.556968
chr15	73075175	73090540	ADPGK-AS1	15365	0.458314
chr15	73344824	73597547	NEO1	252723	0.386138
chr15	73612199	73661605	HCN4	49406	0.550844
chr15	73735498	73852353	C15orf60	116855	0.384006
chr15	73852343	73925753	NPTN	73410	0.410557
chr15	73976621	74006859	CD276	30238	0.523480
chr15	74032140	74043816	C15orf59	11676	0.539140
chr15	74165967	74181556	TBC1D21	15589	0.481942
chr15	74209808	74220127	LOXL1-AS1	10319	0.537552
chr15	74209808	74220589	LOXL1-AS1	10781	0.543920
chr15	74218788	74244478	LOXL1	25690	0.548774
chr15	74275558	74284689	STOML1	9131	0.551856
chr15	74287013	74340155	PML	53142	0.478172
chr15	74355216	74355242	DQ587888	26	0.538462
chr15	74356096	74356126	DQ587117	30	0.666667
chr15	74362197	74374891	GOLGA6A	12694	0.522136
chr15	74365007	74365035	DQ572823	28	0.535714
chr15	74365665	74365696	DQ582073	31	0.483871
chr15	74368141	74368180	DQ596164	39	0.564103
chr15	74418713	74421619	LOC283731	2906	0.586373
chr15	74422742	74429143	ISLR2	6401	0.612717
chr15	74466904	74469212	ISLR	2308	0.607452
chr15	74471807	74495220	STRA6	23413	0.555674
chr15	74495341	74505220	HP11097	9879	0.541249
chr15	74528629	74628482	CCDC33	99853	0.536819
chr15	74630102	74660081	CYP11A1	29979	0.475933
chr15	74646796	74656961	BC013681	10165	0.440728
chr15	74701629	74726299	SEMA7A	24670	0.578111
chr15	74738317	74753529	UBL7	15212	0.479490
chr15	74753605	74773633	UBL7-AS1	20028	0.437987
chr15	74833547	74890472	ARID3B	56925	0.466509
chr15	74907334	74922542	CLK3	15208	0.565952
chr15	74922898	74988386	EDC3	65488	0.436401
chr15	75011882	75017877	CYP1A1	5995	0.512093
chr15	75041183	75048941	CYP1A2	7758	0.518948
chr15	75074424	75091392	CSK	16968	0.555104
chr15	75074424	75095539	CSK	21115	0.566090
chr15	75081012	75081098	MIR4513	86	0.546512
chr15	75105193	75119208	LMAN1L	14015	0.570032
chr15	75117816	75124136	CPLX3	6320	0.547310
chr15	75128458	75135552	ULK3	7094	0.595433
chr15	75137196	75165670	SCAMP2	28474	0.508113
chr15	75182409	75190565	MPI	8156	0.528691
chr15	75192327	75199462	FAM219B	7135	0.511142
chr15	75212616	75230495	COX5A	17879	0.450640
chr15	75247442	75249775	RPP25	2333	0.650236
chr15	75287875	75313836	SCAMP5	25961	0.501907
chr15	75288944	75289555	BC150507	611	0.531915
chr15	75288944	75289555	BC150506	611	0.531915
chr15	75315926	75343067	PPCDC	27141	0.515383
chr15	75494220	75504510	C15orf39	10290	0.597668
chr15	75550898	75565796	GOLGA6C	14898	0.493422
chr15	75557608	75557647	DQ588973	39	0.564103
chr15	75560091	75560122	DQ582071	31	0.483871
chr15	75560752	75560780	DQ577530	28	0.535714
chr15	75575181	75588148	GOLGA6D	12967	0.518084
chr15	75581883	75581922	DQ588973	39	0.564103
chr15	75584367	75584398	DQ582071	31	0.483871
chr15	75585028	75585056	DQ577530	28	0.535714
chr15	75592908	75595306	DNM1P34	2398	0.576731
chr15	75628373	75632614	COMMD4	4241	0.576515
chr15	75639959	75647592	NEIL1	7633	0.577361
chr15	75645951	75646026	MIR631	75	0.613333
chr15	75648132	75660968	MAN2C1	12836	0.571206
chr15	75661719	75743926	SIN3A	82207	0.431776
chr15	75759461	75871625	PTPN9	112164	0.451098
chr15	75797278	75797797	BC016143	519	0.485549
chr15	75890423	75918719	SNUPN	28296	0.473565
chr15	75931425	75932664	IMP3	1239	0.564972
chr15	75941347	75950968	SNX33	9621	0.557323
chr15	75966662	76005189	CSPG4	38527	0.592935
chr15	76016318	76020027	ODF3L1	3709	0.554597
chr15	76020010	76032418	DNM1P35	12408	0.567859
chr15	76031603	76031629	DQ588677	26	0.653846
chr15	76054555	76054656	MIR4313	101	0.663366
chr15	76067893	76075544	AK302879	7651	0.500980
chr15	76072676	76072702	DQ582939	26	0.384615
chr15	76074572	76074602	DQ582208	30	0.533333
chr15	76076802	76076831	DQ582071	29	0.482759
chr15	76077456	76077484	DQ577530	28	0.535714
chr15	76078055	76078084	DQ578199	29	0.482759
chr15	76078775	76078808	DQ574368	33	0.575758
chr15	76084069	76084100	DQ601582	31	0.516129
chr15	76084892	76084921	DQ587887	29	0.551724
chr15	76135621	76193388	UBE2Q2	57767	0.385826
chr15	76196199	76227608	FBXO22	31409	0.400586
chr15	76225023	76225471	FBXO22-AS1	448	0.437500
chr15	76234327	76304785	NRG4	70458	0.372605
chr15	76352298	76497304	C15orf27	145006	0.484435
chr15	76508628	76603810	ETFA	95182	0.400969
chr15	76551629	76552493	TYRO3P	864	0.541667
chr15	76629146	76634816	ISL2	5670	0.594709
chr15	76640526	77176217	SCAPER	535691	0.375500
chr15	77223961	77242601	RCN2	18640	0.384710
chr15	77287464	77329671	PSTPIP1	42207	0.564527
chr15	77336359	77363570	TSPAN3	27211	0.400867
chr15	77400497	77712446	PEAK1	311949	0.379283
chr15	77516249	77517746	LINC00597	1497	0.341349
chr15	77713242	77777945	HMG20A	64703	0.381574
chr15	77905368	77924709	LINGO1	19341	0.564552
chr15	77934105	77941581	LOC253044	7476	0.573167
chr15	77952393	77960416	BC038758	8023	0.564751
chr15	78191477	78191503	DQ583793	26	0.615385
chr15	78202850	78202878	DQ586415	28	0.607143
chr15	78206558	78219188	LOC645752	12630	0.520032
chr15	78209283	78209311	DQ572823	28	0.535714
chr15	78209941	78209972	DQ582073	31	0.483871
chr15	78285574	78286567	LOC91450	993	0.596173
chr15	78287326	78369994	TBC1D2B	82668	0.460105
chr15	78375874	78375901	MIR5003	27	0.666667
chr15	78383513	78383639	SNORA63	126	0.357143
chr15	78384926	78396393	SH2D7	11467	0.507805
chr15	78396947	78423877	CIB2	26930	0.512625
chr15	78441718	78462884	IDH3A	21166	0.423037
chr15	78463186	78527049	ACSBG1	63863	0.483363
chr15	78556486	78574538	DNAJA4	18052	0.469699
chr15	78575577	78591940	WDR61	16363	0.420216
chr15	78632665	78640572	CRABP1	7907	0.486404
chr15	78730517	78793798	IREB2	63281	0.392408
chr15	78799905	78826012	AGPHD1	26107	0.435171
chr15	78832746	78841563	PSMA4	8817	0.421912
chr15	78857861	78887611	CHRNA5	29750	0.404269
chr15	78887646	78913637	CHRNA3	25991	0.477935
chr15	78916635	78933587	CHRNB4	16952	0.525130
chr15	78918695	78920535	AX748237	1840	0.470652
chr15	79026152	79026182	DQ582208	30	0.533333
chr15	79028604	79028635	DQ582071	31	0.483871
chr15	79030687	79030715	DQ586415	28	0.607143
chr15	79042402	79042433	DQ596823	31	0.483871
chr15	79044378	79045734	LOC646938	1356	0.553835
chr15	79051544	79103773	ADAMTS7	52229	0.560340
chr15	79165122	79190081	MORF4L1	24959	0.395328
chr15	79214091	79237420	CTSH	23329	0.519139
chr15	79252288	79383215	RASGRF1	130927	0.499614
chr15	79484048	79576287	LOC729911	92239	0.427455
chr15	79502129	79502213	MIR184	84	0.488095
chr15	79575145	79590581	ANKRD34C	15436	0.426341
chr15	79603490	79615189	TMED3	11699	0.491410
chr15	79724857	79764642	KIAA1024	39785	0.435993
chr15	80109690	80109792	U6	102	0.441176
chr15	80135888	80189391	MTHFS	53503	0.400856
chr15	80215112	80217196	C15orf37	2084	0.603167
chr15	80253231	80263643	BCL2A1	10412	0.385036
chr15	80351909	80430735	ZFAND6	78826	0.381676
chr15	80445232	80478924	FAH	33692	0.497240
chr15	80491137	80492976	AK124939	1839	0.467102
chr15	80555409	80634147	LINC00927	78738	0.431786
chr15	80658931	80659521	AB240015	590	0.469492
chr15	80696691	80890277	ARNT2	193586	0.454800
chr15	80987651	81047962	ABHD17C	60311	0.429839
chr15	81071711	81243999	KIAA1199	172288	0.470311
chr15	81134318	81134414	MIR549	96	0.395833
chr15	81134368	81134389	JB074934	21	0.428571
chr15	81268094	81282205	MESDC2	14111	0.445681
chr15	81289757	81289814	MIR4514	57	0.456140
chr15	81293294	81296345	MESDC1	3051	0.662406
chr15	81426643	81441516	C15orf26	14873	0.407517
chr15	81517639	81605104	IL16	87465	0.432962
chr15	81605006	81616524	STARD5	11518	0.484720
chr15	81624759	81666418	TMC3	41659	0.427135
chr15	82334118	82338484	MEX3B	4366	0.558406
chr15	82380934	82390034	BC043257	9100	0.452418
chr15	82422560	82555104	EFTUD1	132544	0.380425
chr15	82555151	82577267	FAM154B	22116	0.373757
chr15	82585620	82626915	LOC390660	41295	0.560891
chr15	82633122	82641706	GOLGA6L10	8584	0.494059
chr15	82647285	82707816	UBE2Q2P2	60531	0.395236
chr15	82664415	82665114	RPL9	699	0.427754
chr15	82722184	82731586	GOLGA6L9	9402	0.471495
chr15	82734423	82734454	DQ574758	31	0.451613
chr15	82734436	82734472	DQ582680	36	0.472222
chr15	82735847	82735875	DQ601279	28	0.500000
chr15	82748350	82748389	DQ586415	39	0.564103
chr15	82753446	82769399	CSPG4P8	15953	0.593681
chr15	82763612	82798352	LOC80154	34740	0.446344
chr15	82767744	82767775	DQ581594	31	0.451613
chr15	82769830	82769863	DQ578700	33	0.545455
chr15	82804002	83193409	LOC440295	389407	0.409818
chr15	83098709	83108111	GOLGA6L9	9402	0.471602
chr15	82817061	82817092	DQ574758	31	0.451613
chr15	82817074	82817110	DQ582680	36	0.472222
chr15	82821160	82824865	RPS17L	3705	0.494467
chr15	82882945	82924242	LOC390660	41297	0.561179
chr15	82932444	82939159	AK302092	6715	0.537453
chr15	82944749	82976263	LOC80154	31514	0.456971
chr15	82970014	82970047	DQ578199	33	0.545455
chr15	82970478	82986427	CSPG4P8	15949	0.593517
chr15	82972102	82972133	DQ574758	31	0.451613
chr15	82991527	82991566	DQ571121	39	0.564103
chr15	83005512	83005548	DQ576060	36	0.472222
chr15	83005530	83005561	DQ581594	31	0.451613
chr15	83009406	83018198	GOLGA6L10	8792	0.495678
chr15	83023772	83084341	UBE2Q2P2	60569	0.395054
chr15	83110948	83110979	DQ574758	31	0.451613
chr15	83110961	83110997	DQ582680	36	0.472222
chr15	83112372	83112400	DQ601279	28	0.500000
chr15	83124881	83124920	DQ586415	39	0.564103
chr15	83130032	83145983	CSPG4P8	15951	0.593630
chr15	83140198	83182973	LOC80154	42775	0.435371
chr15	83144328	83144359	DQ581594	31	0.451613
chr15	83146414	83146447	DQ578700	33	0.545455
chr15	83201404	83201435	DQ574758	31	0.451613
chr15	83201417	83201453	DQ582680	36	0.472222
chr15	83205503	83209208	RPS17L	3705	0.494467
chr15	83211950	83316728	CPEB1	104778	0.423763
chr15	83316520	83361572	LOC283692	45052	0.488968
chr15	83328032	83378635	AP3B2	50603	0.489240
chr15	83331978	83332006	DQ601936	28	0.500000
chr15	83379222	83382778	LOC338963	3556	0.546963
chr15	83394649	83408532	LOC283693	13883	0.435641
chr15	83424696	83424823	SCARNA15	127	0.370079
chr15	83428023	83474806	FSD2	46783	0.442618
chr15	83477972	83503613	WHAMM	25641	0.412932
chr15	83509837	83513971	AK130329	4134	0.377842
chr15	83517728	83621476	HOMER2	103748	0.458563
chr15	83626881	83654620	BC044934	27739	0.437038
chr15	83654954	83659809	FAM103A1	4855	0.411123
chr15	83659370	83680393	C15orf40	21023	0.454122
chr15	83685180	83736106	BTBD1	50926	0.395299
chr15	83736086	83736167	MIR4515	81	0.716049
chr15	83776323	83806111	TM6SF1	29788	0.448402
chr15	83806803	83876770	HDGFRP3	69967	0.385425
chr15	83924654	83953468	BNC1	28814	0.418616
chr15	84116090	84287493	SH3GL3	171403	0.407817
chr15	84322837	84708593	ADAMTSL3	385756	0.398096
chr15	84386178	84386274	U6	96	0.343750
chr15	84748938	84795353	EFTUD1P1	46415	0.380502
chr15	84838289	84838320	DQ574758	31	0.451613
chr15	84838302	84838338	DQ582680	36	0.472222
chr15	84839713	84839741	DQ601279	28	0.500000
chr15	84841241	84850985	LOC100505679	9744	0.437500
chr15	84860599	84878025	LOC440300	17426	0.549007
chr15	84868829	84869441	LOC642423	612	0.655229
chr15	84871729	84871765	DQ576060	36	0.472222
chr15	84871747	84871778	DQ574760	31	0.451613
chr15	84872928	84898920	LOC388152	25992	0.430863
chr15	84904524	84914120	GOLGA6L4	9596	0.480617
chr15	84910669	84910697	DQ582071	28	0.464286
chr15	84944255	84947249	DQ586822	2994	0.523714
chr15	84948106	84948134	DQ582071	28	0.464286
chr15	84949366	84949399	DQ578199	33	0.545455
chr15	84951427	84951455	DQ574758	28	0.428571
chr15	84979927	84979963	DQ576060	36	0.472222
chr15	84979945	84979976	DQ581594	31	0.451613
chr15	85045800	85045828	DQ601279	28	0.500000
chr15	85045805	85050249	DNM1P41	4444	0.554005
chr15	85047209	85047245	DQ576060	36	0.472222
chr15	85047737	85060078	GOLGA6L5	12341	0.488858
chr15	85053801	85053829	DQ582073	28	0.464286
chr15	85070426	85114026	UBE2Q2P1	43600	0.388716
chr15	85114364	85123412	LINC00933	9048	0.430150
chr15	85144248	85166947	ZSCAN2	22699	0.475968
chr15	85174690	85181644	SCAND2P	6954	0.479580
chr15	85186011	85197521	WDR73	11510	0.490964
chr15	85187181	85190709	AL357213	3528	0.504535
chr15	85198359	85201802	NMB	3443	0.563172
chr15	85212767	85259691	SEC11A	46924	0.423344
chr15	85291817	85349663	ZNF592	57846	0.459288
chr15	85359910	85416713	ALPK3	56803	0.481735
chr15	85427912	85489027	SLC28A1	61115	0.489160
chr15	85525204	85682376	PDE8A	157172	0.415138
chr15	85747305	85747565	DQ596274	260	0.607692
chr15	85747906	85748518	LOC642423	612	0.655229
chr15	85750824	85750855	DQ574760	31	0.451613
chr15	85752616	85777989	AK308544	25373	0.426004
chr15	85783673	85787993	GOLGA6L4	4320	0.521991
chr15	85788460	85790410	AK301968	1950	0.557949
chr15	85789743	85789771	DQ582071	28	0.464286
chr15	85923846	86292589	AKAP13	368743	0.399129
chr15	86302558	86338189	KLHL25	35631	0.535910
chr15	86313726	86313809	MIR1276	83	0.566265
chr15	86365085	86365188	U6	103	0.378641
chr15	86685241	87572283	AGBL1	887042	0.390423
chr15	86840064	86860199	AGBL1-AS1	20135	0.386839
chr15	88120159	88122917	LINC00052	2758	0.400653
chr15	88402981	88405587	AK094929	2606	0.383730
chr15	88419987	88799962	NTRK3	379975	0.454625
chr15	88795960	88814297	NTRK3-AS1	18337	0.527622
chr15	89002708	89010633	MRPL46	7925	0.409590
chr15	89010683	89021861	MRPS11	11178	0.451691
chr15	89045148	89048564	AX746605	3416	0.424766
chr15	89055581	89089912	DET1	34331	0.426612
chr15	89128801	89147834	AK054749	19033	0.384385
chr15	89151337	89151428	MIR1179	91	0.417582
chr15	89155055	89155165	MIR7-2	110	0.509091
chr15	89155077	89155155	MIR3529	78	0.474359
chr15	89164526	89175512	AEN	10986	0.514564
chr15	89182038	89198879	ISG20	16841	0.528116
chr15	89346673	89418585	ACAN	71912	0.502600
chr15	89411446	89411560	L12234	114	0.526316
chr15	89420518	89438770	HAPLN3	18252	0.528052
chr15	89441913	89456663	MFGE8	14750	0.555864
chr15	89631380	89745591	ABHD2	114211	0.439537
chr15	89753097	89764922	RLBP1	11825	0.489894
chr15	89787193	89860362	FANCI	73169	0.401044
chr15	89859535	89878026	POLG	18491	0.524742
chr15	89921272	89941718	LINC00925	20446	0.521814
chr15	90014637	90039799	RHCG	25162	0.521620
chr15	90048160	90067265	LINC00928	19105	0.408008
chr15	90118817	90171253	TICRR	52436	0.417728
chr15	90171200	90198682	KIF7	27482	0.529547
chr15	90207599	90222648	PLIN1	15049	0.520433
chr15	90224761	90234015	PEX11A	9254	0.427707
chr15	90234027	90286869	WDR93	52842	0.429866
chr15	90293097	90294540	MESP1	1443	0.706168
chr15	90319588	90321982	MESP2	2394	0.603175
chr15	90328125	90358072	ANPEP	29947	0.531138
chr15	90373830	90456222	C15orf38-AP3S2	82392	0.456404
chr15	90393868	90393953	MIR5094	85	0.388235
chr15	90544751	90625432	ZNF710	80681	0.506600
chr15	90617746	90619769	AK055981	2023	0.491349
chr15	90627211	90645708	IDH2	18497	0.525653
chr15	90744561	90772892	SEMA4B	28331	0.534679
chr15	90773476	90777387	CIB1	3911	0.573511
chr15	90773476	90777279	CIB1	3803	0.567184
chr15	90777486	90785312	GDPGP1	7826	0.484922
chr15	90792763	90802312	TTLL13	9549	0.512410
chr15	90808894	90815443	NGRN	6549	0.458543
chr15	90836503	90836532	DQ582071	29	0.482759
chr15	90837763	90837792	DQ578199	29	0.482759
chr15	90843734	90843763	DQ571566	29	0.517241
chr15	90844650	90844692	DQ571121	42	0.547619
chr15	90889762	90892679	GABARAPL3	2917	0.474803
chr15	90895476	90904715	ZNF774	9239	0.461522
chr15	90931472	91045475	IQGAP1	114003	0.407603
chr15	91073117	91188577	CRTC3	115460	0.440326
chr15	91203464	91208185	BC038778	4721	0.457107
chr15	91260578	91358686	BLM	98108	0.406797
chr15	91411884	91426687	FURIN	14803	0.584611
chr15	91427664	91439006	FES	11342	0.587286
chr15	91447419	91465815	MAN2A2	18396	0.542944
chr15	91478214	91497323	UNC45A	19109	0.534670
chr15	91474154	91475774	HDDC3	1620	0.553086
chr15	91498105	91506355	RCCD1	8250	0.544606
chr15	91509267	91537881	PRC1	28614	0.450269
chr15	91509598	91531854	PRC1-AS1	22256	0.448373
chr15	91541773	91565833	VPS33B	24060	0.468745
chr15	91565851	91574370	AK055351	8519	0.436671
chr15	91643181	91844539	SV2B	201358	0.425039
chr15	92006568	92038080	BC036442	31512	0.392803
chr15	92396937	92709137	SLCO3A1	312200	0.450964
chr15	92937139	93011958	ST8SIA2	74819	0.479691
chr15	92960776	92960919	SnoU109	143	0.419580
chr15	93014906	93044347	C15orf32	29441	0.440508
chr15	93111047	93115493	LINC00930	4446	0.473684
chr15	93116238	93116277	DQ597717	39	0.487179
chr15	93117764	93117807	DQ571973	43	0.395349
chr15	93117864	93117905	DQ585572	41	0.536585
chr15	93118123	93118179	DQ583728	56	0.464286
chr15	93118268	93118303	DQ575581	35	0.514286
chr15	93118365	93118409	DQ598122	44	0.500000
chr15	93119586	93119624	DQ589659	38	0.500000
chr15	93120054	93120085	DQ579218	31	0.483871
chr15	93120107	93120143	DQ579313	36	0.472222
chr15	93120318	93120366	DQ596488	48	0.562500
chr15	93121021	93121059	DQ594004	38	0.447368
chr15	93121374	93121424	DQ580251	50	0.480000
chr15	93121443	93121472	DQ596667	29	0.517241
chr15	93121589	93121618	DQ596681	29	0.482759
chr15	93121656	93121697	DQ599441	41	0.390244
chr15	93121788	93121826	DQ591574	38	0.578947
chr15	93122030	93122065	DQ601664	35	0.514286
chr15	93122277	93122307	DQ589053	30	0.566667
chr15	93123025	93123056	DQ576504	31	0.516129
chr15	93123173	93123206	DQ588655	33	0.515152
chr15	93124320	93124360	DQ582158	40	0.575000
chr15	93124431	93124491	DQ599802	60	0.533333
chr15	93125740	93125776	DQ596379	36	0.472222
chr15	93126289	93126324	DQ601873	35	0.428571
chr15	93126885	93126926	DQ582977	41	0.487805
chr15	93127000	93127041	DQ582622	41	0.585366
chr15	93127133	93127175	DQ576106	42	0.523810
chr15	93127771	93127842	DQ598082	71	0.549296
chr15	93127970	93128001	DQ583486	31	0.483871
chr15	93128009	93128043	DQ580504	34	0.558824
chr15	93128189	93128236	DQ570806	47	0.553191
chr15	93128268	93128301	DQ595407	33	0.454545
chr15	93129064	93129104	DQ586639	40	0.500000
chr15	93129309	93129373	DQ579595	64	0.593750
chr15	93129419	93129449	DQ572592	30	0.400000
chr15	93129464	93129494	DQ571347	30	0.433333
chr15	93129527	93129573	DQ580783	46	0.478261
chr15	93129959	93130039	DQ590038	80	0.487500
chr15	93130117	93130167	DQ599537	50	0.460000
chr15	93130251	93130279	DQ586689	28	0.571429
chr15	93130539	93130572	DQ581392	33	0.515152
chr15	93132507	93132541	DQ591781	34	0.470588
chr15	93132563	93132593	DQ580421	30	0.433333
chr15	93132958	93133002	DQ573962	44	0.431818
chr15	93139675	93139751	DQ578058	76	0.565789
chr15	93140177	93140219	DQ584918	42	0.500000
chr15	93140417	93140447	DQ600930	30	0.533333
chr15	93140979	93141008	DQ580467	29	0.482759
chr15	93145811	93145840	DQ579432	29	0.379310
chr15	93147132	93147170	DQ575076	38	0.447368
chr15	93151238	93151294	DQ593762	56	0.500000
chr15	93152741	93152770	DQ574028	29	0.551724
chr15	93152935	93152967	DQ571124	32	0.562500
chr15	93153425	93153470	DQ589911	45	0.488889
chr15	93160678	93199031	FAM174B	38353	0.463249
chr15	93338713	93340338	ASB9P1	1625	0.461538
chr15	93443550	93571237	CHD2	127687	0.394848
chr15	93438055	93441319	AK024092	3264	0.322917
chr15	93447628	93447705	MIR3175	77	0.714286
chr15	93586635	93617216	RGMA	30581	0.557536
chr15	93855785	94098099	AK094352	242314	0.427784
chr15	93955933	93955980	DQ593531	47	0.489362
chr15	93956914	93956954	DQ586064	40	0.500000
chr15	93957919	93957995	DQ582871	76	0.539474
chr15	93958074	93958109	DQ583307	35	0.571429
chr15	93958262	93958297	DQ572925	35	0.457143
chr15	93958364	93958392	DQ598152	28	0.428571
chr15	93958406	93958436	DQ592588	30	0.466667
chr15	93958463	93958491	DQ572208	28	0.500000
chr15	93958530	93958592	DQ582013	62	0.451613
chr15	93958692	93958754	DQ576238	62	0.532258
chr15	93958860	93958889	DQ583009	29	0.586207
chr15	93958953	93958982	DQ578778	29	0.482759
chr15	93959182	93959233	DQ600033	51	0.509804
chr15	93960078	93965805	AK097829	5727	0.467260
chr15	93963105	93963140	DQ593143	35	0.542857
chr15	93963461	93963505	DQ578892	44	0.500000
chr15	93963628	93963659	DQ579181	31	0.419355
chr15	93963759	93963789	DQ577534	30	0.533333
chr15	93964602	93964633	DQ595590	31	0.387097
chr15	93965023	93965053	DQ580631	30	0.566667
chr15	93965466	93965514	DQ571165	48	0.416667
chr15	93965687	93965717	DQ585433	30	0.333333
chr15	93969553	93969587	DQ601182	34	0.441176
chr15	94303843	94443828	BC037497	139985	0.399729
chr15	94443929	94517161	BC021741	73232	0.374508
chr15	94841429	95027181	MCTP2	185752	0.384104
chr15	95398591	95400293	LOC440311	1702	0.606345
chr15	95822518	95870329	LOC400456	47811	0.402376
chr15	95976321	96051076	LINC00924	74755	0.373045
chr15	96615638	96615661	JA429839	23	0.130435
chr15	96812000	96870590	NR2F2-AS1	58590	0.411726
chr15	96874110	96883492	NR2F2	9382	0.503837
chr15	96876489	96876536	MIR1469	47	0.851064
chr15	97311810	97311840	DQ600899	30	0.533333
chr15	97312025	97312063	DQ584981	38	0.500000
chr15	97312148	97312178	DQ591093	30	0.566667
chr15	97313184	97313220	DQ570891	36	0.500000
chr15	97314336	97314369	DQ571799	33	0.515152
chr15	97314398	97314432	DQ595265	34	0.441176
chr15	97314965	97314997	DQ590811	32	0.500000
chr15	97315156	97315216	DQ582375	60	0.383333
chr15	97315234	97326567	SPATA8-AS1	11333	0.491044
chr15	97315517	97315563	DQ595383	46	0.608696
chr15	97316931	97316961	DQ601004	30	0.400000
chr15	97317561	97317615	DQ573857	54	0.500000
chr15	97318767	97318799	DQ590792	32	0.437500
chr15	97319864	97319911	DQ576810	47	0.446809
chr15	97320890	97320923	DQ577158	33	0.575758
chr15	97321250	97321285	DQ594177	35	0.457143
chr15	97321363	97321403	DQ586241	40	0.425000
chr15	97321486	97321517	DQ599224	31	0.483871
chr15	97321671	97321727	DQ574839	56	0.482143
chr15	97321735	97321771	DQ577036	36	0.472222
chr15	97321802	97321835	DQ569978	33	0.484848
chr15	97321837	97321867	DQ584667	30	0.466667
chr15	97322129	97322159	DQ597986	30	0.400000
chr15	97322161	97322216	DQ577480	55	0.400000
chr15	97322264	97322298	DQ572928	34	0.558824
chr15	97322339	97322371	DQ595853	32	0.500000
chr15	97322554	97322593	DQ573982	39	0.564103
chr15	97322772	97322812	DQ597589	40	0.450000
chr15	97323003	97323040	DQ594400	37	0.513514
chr15	97323512	97323577	DQ601402	65	0.553846
chr15	97323977	97324014	DQ596112	37	0.567568
chr15	97324048	97324086	DQ595670	38	0.526316
chr15	97324088	97324124	DQ574554	36	0.500000
chr15	97324893	97324938	DQ591967	45	0.488889
chr15	97324965	97325011	DQ585716	46	0.500000
chr15	97325379	97325418	DQ576557	39	0.538462
chr15	97325483	97325529	DQ593900	46	0.565217
chr15	97326074	97326105	DQ594674	31	0.387097
chr15	97326306	97326353	DQ599954	47	0.553191
chr15	97326678	97328845	SPATA8	2167	0.512229
chr15	98080195	98081456	BC024169	1261	0.371134
chr15	98285845	98417659	LINC00923	131814	0.395095
chr15	98503932	98517068	ARRDC4	13136	0.394032
chr15	98980390	99057611	FAM169B	77221	0.428886
chr15	99192760	99507759	IGF1R	314999	0.444795
chr15	99327654	99327731	MIR4714	77	0.467532
chr15	99511458	99548885	PGPEP1L	37427	0.441900
chr15	99571772	99574275	AL109706	2503	0.464642
chr15	99645285	99675800	SYNM	30515	0.496543
chr15	99676527	99789815	TTC23	113288	0.418650
chr15	99791651	99927280	LRRC28	135629	0.380265
chr15	99797729	99800481	HSP90B2P	2752	0.406977
chr15	100106132	100256629	MEF2A	150497	0.367509
chr15	100267611	100273626	LYSMD4	6015	0.501746
chr15	100330360	100335657	DNM1P46	5297	0.454219
chr15	100337611	100337651	DQ571121	40	0.575000
chr15	100339652	100339682	DQ590616	30	0.500000
chr15	100339996	100340056	DQ575742	60	0.566667
chr15	100340093	100340147	DQ595494	54	0.574074
chr15	100340121	100347132	DNM1P46	7011	0.500927
chr15	100340436	100340462	DQ575741	26	0.500000
chr15	100348034	100379280	DJ031154	31246	0.370831
chr15	100511642	100882183	ADAMTS17	370541	0.466089
chr15	100605272	100607374	AK093600	2102	0.371551
chr15	100884661	100890923	SPATA41	6262	0.483232
chr15	100940599	101084925	CERS3	144326	0.407515
chr15	101087956	101099488	PRKXP1	11532	0.512660
chr15	101098884	101100003	BC032026	1119	0.591600
chr15	101109427	101142445	LINS	33018	0.391090
chr15	101142754	101191904	ASB7	49150	0.400671
chr15	101390035	101404501	LOC145757	14466	0.484792
chr15	101420008	101456830	ALDH1A3	36822	0.480745
chr15	101453408	101459488	BC073817	6080	0.479934
chr15	101449472	101453362	AF198444	3890	0.472494
chr15	101459459	101610317	LRRK1	150858	0.458405
chr15	101715927	101792137	CHSY1	76210	0.433618
chr15	101811213	101817700	VIMP	6487	0.449977
chr15	101821714	101835460	SNRPA1	13746	0.422159
chr15	101839860	101841742	AK130759	1882	0.446334
chr15	101844132	102030187	PCSK6	186055	0.486770
chr15	102182048	102192594	TM2D3	10546	0.405936
chr15	102193954	102264645	TARSL2	70691	0.410717
chr15	102286121	102294721	BC101079	8600	0.517209
chr15	102292790	102292854	DQ597539	64	0.640625
chr15	102292948	102293177	DQ593624	229	0.589520
chr15	102292973	102293005	DQ593864	32	0.625000
chr15	102293069	102293192	DQ582666	123	0.593496
chr15	102293342	102293502	DQ597539	160	0.606250
chr15	102293408	102293886	DQ576888	478	0.594142
chr15	102293648	102293678	DQ575740	30	0.533333
chr15	102293682	102293712	DQ582460	30	0.600000
chr15	102293837	102293897	DQ593630	60	0.566667
chr15	102293992	102294022	DQ575740	30	0.533333
chr15	102294026	102294056	DQ582460	30	0.600000
chr15	102294160	102294210	DQ597539	50	0.580000
chr15	102294234	102294352	DQ596486	118	0.593220
chr15	102294272	102294335	DQ582666	63	0.571429
chr15	102294400	102294449	DQ582294	49	0.591837
chr15	102294518	102294548	DQ575740	30	0.533333
chr15	102294538	102294602	DQ595661	64	0.578125
chr15	102294552	102294582	DQ582460	30	0.600000
chr15	102294729	102294790	DQ588439	61	0.590164
chr15	102294738	102294770	DQ582666	32	0.593750
chr15	102294830	102294861	DQ593630	31	0.645161
chr15	102294846	102294881	DQ593353	35	0.571429
chr15	102294916	102294949	DQ597703	33	0.575758
chr15	102294973	102295069	DQ585237	96	0.614583
chr15	102294987	102295017	DQ582460	30	0.600000
chr15	102295104	102295134	DQ588452	30	0.600000
chr15	102295173	102295205	DQ593627	32	0.593750
chr15	102295173	102295224	DQ586526	51	0.607843
chr15	102295262	102295296	DQ582666	34	0.647059
chr15	102295264	102295310	DQ588428	46	0.586957
chr15	102295377	102295446	DQ597703	69	0.608696
chr15	102295513	102295543	DQ582460	30	0.600000
chr15	102295528	102295623	DQ571896	95	0.642105
chr15	102295699	102295731	DQ593627	32	0.593750
chr15	102295699	102295750	DQ586526	51	0.607843
chr15	102295781	102295823	DQ588425	42	0.595238
chr15	102295788	102295822	DQ582666	34	0.647059
chr15	102295903	102295972	DQ597703	69	0.608696
chr15	102296005	102296035	DQ575740	30	0.533333
chr15	102296022	102296070	DQ588362	48	0.583333
chr15	102296039	102296069	DQ582460	30	0.600000
chr15	102296123	102296157	DQ593630	34	0.647059
chr15	102296128	102296177	DQ588425	49	0.612245
chr15	102296200	102296232	DQ578285	32	0.500000
chr15	102296238	102296288	DQ597461	50	0.640000
chr15	102296340	102296370	DQ575740	30	0.533333
chr15	102296374	102296404	DQ582460	30	0.600000
chr15	102296389	102296474	DQ586138	85	0.623529
chr15	102296548	102296577	DQ578289	29	0.517241
chr15	102296582	102296612	DQ586526	30	0.633333
chr15	102296673	102296757	DQ583497	84	0.547619
chr15	102296855	102296924	DQ597703	69	0.608696
chr15	102296957	102296987	DQ575740	30	0.533333
chr15	102296991	102297021	DQ582460	30	0.600000
chr15	102296992	102297089	DQ586138	97	0.608247
chr15	102297177	102297209	DQ593627	32	0.593750
chr15	102297177	102297228	DQ586526	51	0.607843
chr15	102297280	102297320	DQ588439	40	0.625000
chr15	102297381	102297450	DQ597703	69	0.608696
chr15	102297483	102297513	DQ575740	30	0.533333
chr15	102297500	102297538	DQ576933	38	0.552632
chr15	102297517	102297547	DQ582460	30	0.600000
chr15	102297609	102297652	DQ588425	43	0.558140
chr15	102297685	102297728	DQ600537	43	0.558140
chr15	102297697	102297729	DQ593627	32	0.593750
chr15	102297810	102297857	DQ593353	47	0.617021
chr15	102297875	102297908	DQ597703	33	0.575758
chr15	102297922	102297957	DQ573820	35	0.514286
chr15	102297967	102298035	DQ585237	68	0.617647
chr15	102298252	102298318	DQ576896	66	0.636364
chr15	102298347	102298377	DQ575740	30	0.533333
chr15	102298381	102298411	DQ582460	30	0.600000
chr15	102298401	102298479	DQ586246	78	0.615385
chr15	102298556	102298604	DQ588439	48	0.541667
chr15	102298568	102298600	DQ593627	32	0.593750
chr15	102298681	102298751	DQ579816	70	0.614286
chr15	102298839	102298915	DQ586246	76	0.618421
chr15	102298934	102298964	DQ595216	30	0.600000
chr15	102299003	102299049	DQ588439	46	0.565217
chr15	102299123	102299187	DQ576896	64	0.640625
chr15	102299218	102299248	DQ575740	30	0.533333
chr15	102299224	102299257	DQ582610	33	0.545455
chr15	102299274	102299367	DQ588066	93	0.612903
chr15	102299460	102299489	DQ586526	29	0.620690
chr15	102299551	102299581	DQ576999	30	0.533333
chr15	102299642	102299672	DQ588584	30	0.600000
chr15	102299766	102299803	DQ591415	37	0.621622
chr15	102299835	102299865	DQ575740	30	0.533333
chr15	102299841	102299874	DQ582610	33	0.545455
chr15	102299889	102299919	DQ588362	30	0.633333
chr15	102299964	102300010	DQ588439	46	0.608696
chr15	102300102	102300145	DQ591415	43	0.627907
chr15	102300275	102300306	DQ585242	31	0.580645
chr15	102300399	102300445	DQ588439	46	0.608696
chr15	102300523	102300576	DQ597461	53	0.679245
chr15	102300640	102300672	DQ582462	32	0.562500
chr15	102300657	102300692	DQ576947	35	0.571429
chr15	102300728	102300783	DQ588394	55	0.581818
chr15	102300850	102300880	DQ586526	30	0.633333
chr15	102300941	102300971	DQ576999	30	0.533333
chr15	102301032	102301062	DQ588584	30	0.600000
chr15	102301156	102301193	DQ591415	37	0.621622
chr15	102301376	102301405	DQ588329	29	0.551724
chr15	102301459	102301497	DQ588370	38	0.605263
chr15	102301558	102301628	DQ597461	70	0.614286
chr15	102301811	102301841	DQ595216	30	0.600000
chr15	102302005	102302063	DQ597461	58	0.672414
chr15	102302218	102302270	DQ588406	52	0.596154
chr15	102302337	102302366	DQ586526	29	0.620690
chr15	102302428	102302458	DQ576999	30	0.533333
chr15	102302610	102302660	DQ587115	50	0.620000
chr15	102302896	102302959	DQ597461	63	0.650794
chr15	102303023	102303055	DQ582462	32	0.562500
chr15	102303044	102303075	DQ576947	31	0.548387
chr15	102303118	102303153	DQ601306	35	0.600000
chr15	102303324	102303355	DQ598070	31	0.580645
chr15	102303415	102303444	DQ588329	29	0.551724
chr15	102303506	102303580	DQ591415	74	0.594595
chr15	102303662	102303692	DQ576947	30	0.566667
chr15	102303759	102303789	DQ595216	30	0.600000
chr15	102303850	102303880	DQ588439	30	0.600000
chr15	102303941	102303988	DQ593353	47	0.617021
chr15	102304097	102304127	DQ576947	30	0.566667
chr15	102304162	102304209	DQ588066	47	0.574468
chr15	102304376	102304406	DQ588424	30	0.600000
chr15	102304462	102304537	DQ591415	75	0.613333
chr15	102304720	102304769	DQ597025	49	0.632653
chr15	102304876	102304902	DQ588388	26	0.576923
chr15	102305059	102305097	DQ573799	38	0.500000
chr15	102305288	102305318	DQ590394	30	0.500000
chr15	102305509	102305546	DQ574757	37	0.378378
chr15	102305547	102305583	DQ599785	36	0.527778
chr15	102305613	102305647	DQ575242	34	0.558824
chr15	102307333	102307373	DQ586415	40	0.575000
chr15	102310750	102310800	DQ592653	50	0.420000
chr15	102311987	102312030	DQ583348	43	0.581395
chr15	102312058	102312154	DQ577251	96	0.604167
chr15	102312209	102312240	DQ593367	31	0.645161
chr15	102312328	102312362	DQ592190	34	0.588235
chr15	102312411	102312475	DQ588143	64	0.578125
chr15	102312675	102312717	DQ596604	42	0.500000
chr15	102312852	102312896	DQ578010	44	0.613636
chr15	102312967	102313028	DQ599787	61	0.475410
chr15	102313082	102313127	DQ588124	45	0.533333
chr15	102313674	102313703	DQ572823	29	0.517241
chr15	102313845	102313875	DQ580168	30	0.533333
chr15	102314206	102314235	DQ601694	29	0.482759
chr15	102314348	102314379	DQ582073	31	0.483871
chr15	102314920	102314959	DQ571638	39	0.538462
chr15	102314998	102315029	DQ570882	31	0.516129
chr15	102315194	102315282	DQ593032	88	0.522727
chr15	102315599	102315644	DQ589204	45	0.555556
chr15	102315832	102315874	DQ578258	42	0.500000
chr15	102316500	102316537	DQ571326	37	0.567568
chr15	102316628	102316659	DQ576544	31	0.483871
chr15	102317999	102318034	DQ588687	35	0.457143
chr15	102318415	102318445	DQ582940	30	0.433333
chr15	102319617	102319667	DQ596816	50	0.520000
chr15	102322260	102322289	DQ570906	29	0.517241
chr15	102345922	102346861	OR4F6	939	0.411076
chr15	102358389	102359328	OR4F15	939	0.425985
chr15	102382321	102390527	OR4F13P	8206	0.367170
chr15	102462344	102463262	OR4F4	918	0.429194
chr15	102495087	102496558	FAM138E	1471	0.507818
chr15	102501015	102516808	WASH3P	15793	0.544038
chr15	102501015	102513250	WASH3P	12235	0.528811
chr15	102516760	102519296	DDX11L9	2536	0.575315
chr16	61554	64090	DDX11L10	2536	0.576498
chr16	66540	69448	WASH1	2908	0.596974
chr16	72924	74938	BC032901	2014	0.550645
chr16	96978	103632	POLR3K	6654	0.495341
chr16	103828	107669	SNRNP25	3841	0.547514
chr16	108057	122629	RHBDF1	14572	0.614054
chr16	128168	135850	MPG	7682	0.607784
chr16	135803	188697	NPRL3	52894	0.509226
chr16	202853	204504	HBZ	1651	0.692308
chr16	215972	216767	HBM	795	0.684277
chr16	222845	223709	HBA2	864	0.672454
chr16	226678	227520	HBA1	842	0.673397
chr16	230332	231178	HBQ1	846	0.730496
chr16	238973	279449	LUC7L	40476	0.473120
chr16	277240	279164	LUC7L	1924	0.448025
chr16	284800	316119	ITFG3	31319	0.515885
chr16	318309	325914	RGS11	7605	0.643393
chr16	332614	337209	PDIA2	4595	0.645484
chr16	330605	333368	ARHGDIG	2763	0.685487
chr16	337439	402676	AXIN1	65237	0.543587
chr16	417383	420569	MRPL28	3186	0.649404
chr16	420775	431950	TMEM8A	11175	0.645995
chr16	432240	442960	LOC100134368	10720	0.520243
chr16	436662	437323	RPL2B	661	0.468986
chr16	447191	450754	NME4	3563	0.642717
chr16	451857	462487	DECR2	10630	0.568956
chr16	475667	572481	RAB11FIP3	96814	0.528043
chr16	576846	577407	LINC00235	561	0.725490
chr16	577855	604636	SOLH	26781	0.649080
chr16	585315	585368	MIR5587	53	0.641509
chr16	593276	593366	MIR3176	90	0.744444
chr16	610421	615529	C16orf11	5108	0.682459
chr16	619967	634136	PIGQ	14169	0.640765
chr16	617031	619495	NHLRC4	2464	0.646104
chr16	632876	633922	PIGQ	1046	0.657744
chr16	640076	679273	RAB40C	39197	0.565553
chr16	679238	684116	AK128777	4878	0.669742
chr16	681011	684116	WFIKKN1	3105	0.671820
chr16	684428	686347	C16orf13	1919	0.677436
chr16	686735	686806	TRNA	71	0.619718
chr16	686816	688620	AK301549	1804	0.664634
chr16	691848	698474	FAM195A	6626	0.630848
chr16	699362	717829	WDR90	18467	0.645909
chr16	718082	724174	RHOT2	6092	0.663821
chr16	726074	728267	RHBDL1	2193	0.673051
chr16	730114	732768	STUB1	2654	0.651846
chr16	731666	734439	JMJD8	2773	0.650559
chr16	734701	740400	WDR24	5699	0.639586
chr16	742499	755825	FBXL16	13326	0.642653
chr16	765172	767480	METRN	2308	0.706239
chr16	767618	769655	AL360260	2037	0.623957
chr16	771141	772590	FAM173A	1449	0.719117
chr16	772581	776473	CCDC78	3892	0.646968
chr16	777265	779715	HAGHL	2450	0.706531
chr16	779768	790997	NARFL	11229	0.604773
chr16	781564	782746	NARFL	1182	0.588832
chr16	811072	818865	MSLN	7793	0.670217
chr16	820182	820277	MIR662	95	0.684211
chr16	834973	838383	RPUSD1	3410	0.671261
chr16	838621	848074	CHTF18	9453	0.658838
chr16	848040	850733	GNG13	2693	0.655403
chr16	855442	863861	PRR25	8419	0.579285
chr16	903634	1020984	LMF1	117350	0.563818
chr16	1025760	1030913	LMF1	5153	0.631865
chr16	1031807	1036979	SOX8	5172	0.647912
chr16	1114081	1128731	SSTR5-AS1	14650	0.631058
chr16	1122755	1131454	SSTR5	8699	0.647431
chr16	1138225	1146244	C1QTNF8	8019	0.652825
chr16	1203240	1271772	CACNA1H	68532	0.650849
chr16	1271650	1275254	TPSG1	3604	0.637625
chr16	1278335	1280185	TPSB2	1850	0.671351
chr16	1290677	1292555	TPSAB1	1878	0.669329
chr16	1306272	1308494	TPSD1	2222	0.659766
chr16	1359153	1377019	UBE2I	17866	0.592802
chr16	1384504	1399442	BAIAP3	14938	0.651359
chr16	1399240	1401873	TSR3	2633	0.623623
chr16	1401899	1413352	GNPTG	11453	0.564219
chr16	1413205	1464705	UNKL	51500	0.578019
chr16	1469744	1470801	C16orf91	1057	0.569536
chr16	1484388	1494490	CCDC154	10102	0.639774
chr16	1494933	1525085	CLCN7	30152	0.598202
chr16	1535939	1538468	PTX4	2529	0.654013
chr16	1543351	1560460	TELO2	17109	0.630779
chr16	1560427	1662109	IFT140	101682	0.544413
chr16	1578741	1605581	TMEM204	26840	0.580216
chr16	1603655	1604131	BC114455	476	0.554622
chr16	1664640	1727909	CRAMP1L	63269	0.526055
chr16	1728277	1752073	HN1L	23796	0.478106
chr16	1756220	1820318	MAPK8IP3	64098	0.568286
chr16	1784985	1785067	MIR3177	82	0.634146
chr16	1820320	1821710	NME3	1390	0.701439
chr16	1821895	1823140	MRPS34	1245	0.652209
chr16	1823228	1826340	EME2	3112	0.669023
chr16	1826712	1832581	SPSB3	5869	0.637076
chr16	1832932	1839192	NUBP2	6260	0.621406
chr16	1840413	1843734	IGFALS	3321	0.682927
chr16	1859103	1877195	HAGH	18092	0.568483
chr16	1877224	1890203	FAHD1	12979	0.449033
chr16	1883983	1922179	MEIOB	38196	0.430935
chr16	1903351	2173093	TCRBV20S1	269742	0.579001
chr16	1961464	1968231	HS3ST6	6767	0.634550
chr16	1988233	1993294	MSRB1	5061	0.586248
chr16	1994579	2004679	RPL3L	10100	0.568713
chr16	2009516	2011976	NDUFB10	2460	0.589024
chr16	2012061	2014827	RPS2	2766	0.577007
chr16	2012334	2012467	SNORA10	133	0.563910
chr16	2012973	2013107	SNORA64	134	0.552239
chr16	2014996	2015505	SNHG9	509	0.658153
chr16	2015184	2015311	SNORA78	127	0.724409
chr16	2016874	2018976	RNF151	2102	0.587536
chr16	2022063	2028751	TBL3	6688	0.646531
chr16	2028917	2031550	NOXO1	2633	0.675655
chr16	2034149	2037750	GFER	3601	0.611497
chr16	2039945	2044276	SYNGR3	4331	0.660817
chr16	2047652	2059822	ZNF598	12170	0.642235
chr16	2069520	2070756	NPW	1236	0.726537
chr16	2076868	2089027	SLC9A3R2	12159	0.645366
chr16	2089815	2097867	NTHL1	8052	0.614381
chr16	2097989	2138713	TSC2	40724	0.599204
chr16	2138710	2185899	PKD1	47189	0.631037
chr16	2140195	2140285	MIR1225	90	0.744444
chr16	2183119	2183205	MIR4516	86	0.720930
chr16	2185977	2186130	MIR3180-5	153	0.758170
chr16	2198650	2204141	RAB26	5491	0.614824
chr16	2205023	2205106	SNORD60	83	0.421687
chr16	2205798	2228130	TRAF7	22332	0.636978
chr16	2227183	2246465	CASKIN1	19282	0.647962
chr16	2255177	2259418	MLST8	4241	0.645838
chr16	2259253	2261069	BRICD5	1816	0.658590
chr16	2261602	2264822	PGP	3220	0.612733
chr16	2273566	2285743	E4F1	12177	0.615751
chr16	2286467	2288712	DNASE1L2	2245	0.694432
chr16	2289872	2301602	ECI1	11730	0.546036
chr16	2303099	2317858	RNPS1	14759	0.484653
chr16	2320713	2320773	MIR3677	60	0.716667
chr16	2321747	2321841	MIR940	94	0.765957
chr16	2324620	2324692	MIR4717	72	0.597222
chr16	2325878	2390747	ABCA3	64869	0.530346
chr16	2390922	2476700	ABCA17P	85778	0.433922
chr16	2479394	2508859	CCNF	29465	0.527575
chr16	2510114	2514964	C16orf59	4850	0.620000
chr16	2521499	2524146	NTN3	2647	0.708349
chr16	2525146	2555734	TBC1D24	30588	0.558095
chr16	2563726	2570224	ATP6V0C	6498	0.607264
chr16	2570362	2580955	AMDHD2	10593	0.591617
chr16	2580035	2581409	CEMP1	1374	0.614993
chr16	2581922	2582006	MIR3178	84	0.726190
chr16	2587964	2653191	PDPK1	65227	0.525120
chr16	2611467	2614643	DQ577714	3176	0.594144
chr16	2642514	2644557	AX748261	2043	0.557024
chr16	2653384	2667132	LOC652276	13748	0.565173
chr16	2653384	2680495	LOC652276	27111	0.542252
chr16	2666121	2693297	PDPK1	27176	0.529842
chr16	2685550	2688726	AK056253	3176	0.593199
chr16	2688982	2696130	FLJ42627	7148	0.517487
chr16	2708389	2723440	ERVK13-1	15051	0.475317
chr16	2732494	2759031	KCTD5	26537	0.592305
chr16	2762422	2770552	PRSS27	8130	0.611808
chr16	2787076	2802601	SRRM2-AS1	15525	0.560515
chr16	2787076	2800811	SRRM2-AS1	13735	0.559738
chr16	2802329	2821413	SRRM2	19084	0.525519
chr16	2821414	2827297	TCEB2	5883	0.555159
chr16	2833953	2836708	PRSS33	2755	0.638113
chr16	2848485	2855133	PRSS41	6648	0.512485
chr16	2867163	2871723	PRSS21	4560	0.614693
chr16	2880172	2882285	ZG16B	2113	0.584004
chr16	2889573	2892473	PRSS30P	2900	0.618276
chr16	2902727	2908171	PRSS22	5444	0.593497
chr16	2933195	2949383	FLYWCH2	16188	0.514826
chr16	2961979	3001209	FLYWCH1	39230	0.522967
chr16	3014216	3018384	KREMEN2	4168	0.669626
chr16	3019341	3023485	PAQR4	4144	0.641168
chr16	3022791	3030540	PKMYT1	7749	0.603304
chr16	3040194	3044510	LINC00514	4316	0.605422
chr16	3048955	3050814	HM587423	1859	0.586337
chr16	3062456	3064506	CLDN9	2050	0.644878
chr16	3064712	3068188	CLDN6	3476	0.580552
chr16	3070312	3072383	TNFRSF12A	2071	0.654756
chr16	3070390	3072383	TNFRSF12A	1993	0.646262
chr16	3072625	3074287	HCFC1R1	1662	0.637184
chr16	3074031	3077756	THOC6	3725	0.572349
chr16	3077867	3085542	CCDC64B	7675	0.593876
chr16	3079970	3081151	CCDC64B	1181	0.634208
chr16	3082481	3089133	LOC100128770	6652	0.580126
chr16	3087250	3087800	BC045731	550	0.487273
chr16	3096681	3110724	MMP25	14043	0.582141
chr16	3101995	3109336	BC045731	7341	0.594197
chr16	3115312	3119668	IL32	4356	0.596878
chr16	3138894	3142861	ZSCAN10	3967	0.624149
chr16	3160460	3162490	ZNF205-AS1	2030	0.495567
chr16	3162562	3170518	ZNF205	7956	0.585093
chr16	3178834	3182043	BC013599	3209	0.506700
chr16	3185056	3192805	ZNF213	7749	0.565105
chr16	3194219	3199964	CASP16	5745	0.608529
chr16	3254246	3255185	OR1F1	939	0.512247
chr16	3265561	3266546	OR1F2P	985	0.513706
chr16	3272324	3285456	ZNF200	13132	0.422632
chr16	3292027	3306627	MEFV	14600	0.514247
chr16	3333486	3341459	ZNF263	7973	0.507839
chr16	3348807	3355439	TIGD7	6632	0.428981
chr16	3355432	3368576	ZNF75A	13144	0.450396
chr16	3405888	3406924	OR2C1	1036	0.539575
chr16	3421052	3422283	MTRNR2L4	1231	0.402112
chr16	3432084	3451013	ZSCAN32	18929	0.454118
chr16	3451189	3459364	ZNF174	8175	0.466422
chr16	3486109	3493490	ZNF597	7381	0.452378
chr16	3507991	3536963	NAA60	28972	0.526060
chr16	3507991	3535907	NAA60	27916	0.522317
chr16	3543483	3545421	C16orf90	1938	0.626419
chr16	3550944	3589051	CLUAP1	38107	0.455822
chr16	3583436	3584255	BC141902	819	0.561661
chr16	3589035	3627392	NLRC3	38357	0.510102
chr16	3631183	3661585	SLX4	30402	0.523979
chr16	3702939	3708096	DNASE1	5157	0.572620
chr16	3708037	3767598	TRAP1	59561	0.501637
chr16	3710742	3715458	BC095475	4716	0.558736
chr16	3775055	3930121	CREBBP	155066	0.448628
chr16	4012649	4166186	ADCY9	153537	0.471665
chr16	4239374	4292081	SRL	52707	0.517977
chr16	4295825	4303790	LOC100507501	7965	0.503955
chr16	4307186	4323001	TFAP4	15815	0.564085
chr16	4382215	4389598	GLIS2	7383	0.606122
chr16	4390251	4466962	CORO7-PAM16	76711	0.578131
chr16	4421848	4433529	VASN	11681	0.634620
chr16	4475805	4506775	DNAJA3	30970	0.490184
chr16	4511694	4524896	NMRAL1	13202	0.521360
chr16	4526340	4560348	HMOX2	34008	0.474447
chr16	4560676	4588816	CDIP1	28140	0.519687
chr16	4606490	4650318	C16orf96	43828	0.507575
chr16	4658883	4664927	UBALD1	6044	0.644606
chr16	4674824	4740975	MGRN1	66151	0.556484
chr16	4684329	4690624	AX748066	6295	0.545512
chr16	4743693	4745860	NUDT16L1	2167	0.650208
chr16	4746510	4784163	ANKS3	37653	0.496322
chr16	4784288	4799397	C16orf71	15109	0.527103
chr16	4800814	4817166	ZNF500	16352	0.539139
chr16	4827614	4838522	SEPT12	10908	0.533553
chr16	4845378	4846492	LOC440335	1114	0.653501
chr16	4846962	4852951	ROGDI	5989	0.632660
chr16	4853203	4897303	GLYR1	44100	0.476236
chr16	4897911	4932363	UBN1	34452	0.470074
chr16	4932507	4987136	PPL	54629	0.535302
chr16	5008317	5069156	SEC14L5	60839	0.498430
chr16	5074844	5083942	NAGPA	9098	0.562541
chr16	5121809	5137380	ALG1	15571	0.523216
chr16	5094122	5116146	C16orf89	22024	0.480113
chr16	5134300	5147789	FAM86A	13489	0.538068
chr16	5289815	5649140	BC108660	359325	0.451917
chr16	7382750	7763340	RBFOX1	380590	0.419336
chr16	6798908	6798970	U7	62	0.354839
chr16	8619501	8622226	TMEM114	2725	0.524037
chr16	8715526	8740079	METTL22	24553	0.495540
chr16	8740037	8743496	BX537921	3459	0.497254
chr16	8768443	8878432	ABAT	109989	0.473466
chr16	8799312	8799374	U7	62	0.419355
chr16	8889036	8891505	TMEM186	2469	0.504658
chr16	8891669	8943194	PMM2	51525	0.458399
chr16	8946798	8955667	CARHSP1	8869	0.540760
chr16	8985950	9057341	USP7	71391	0.457999
chr16	9185536	9213555	C16orf72	28019	0.420072
chr16	9202200	9205958	AK057657	3758	0.392230
chr16	9328773	9328803	MIR548X	30	0.366667
chr16	9847264	10276263	GRIN2A	428999	0.420304
chr16	10206501	10206530	DQ595173	29	0.551724
chr16	10207164	10207199	DQ587956	35	0.600000
chr16	10479911	10577495	ATF7IP2	97584	0.394183
chr16	10622278	10674539	EMP2	52261	0.483018
chr16	10721360	10788802	TEKT5	67442	0.481273
chr16	10837697	10863208	NUBP1	25511	0.506135
chr16	10860532	10912621	TVP23A	52089	0.471923
chr16	10971054	11018840	CIITA	47786	0.498723
chr16	11022747	11036257	DEXI	13510	0.512065
chr16	11029865	11031993	AX748339	2128	0.487312
chr16	11038344	11276046	CLEC16A	237702	0.480610
chr16	11348273	11350039	SOCS1	1766	0.690827
chr16	11361713	11363160	TNP2	1447	0.465100
chr16	11367143	11367452	PRM3	309	0.640777
chr16	11369492	11370337	PRM2	845	0.597633
chr16	11374692	11375192	PRM1	500	0.554000
chr16	11439310	11445617	RMI2	6307	0.519423
chr16	11536046	11585611	AK126539	49565	0.491254
chr16	11641577	11680806	LITAF	39229	0.478014
chr16	11762288	11773015	SNN	10727	0.593642
chr16	11772942	11836648	TXNDC11	63706	0.435014
chr16	11844441	11891114	ZC3H7A	46673	0.427635
chr16	11913691	11922689	BCAR4	8998	0.453323
chr16	11928054	11945442	RSL1D1	17388	0.453359
chr16	11961984	12009825	GSPT1	47841	0.422211
chr16	12058963	12061925	TNFRSF17	2962	0.404794
chr16	12070601	12668146	SNX29	597545	0.471252
chr16	12753655	12897744	CPPED1	144089	0.443892
chr16	12814177	12814228	MIR4718	51	0.470588
chr16	12936343	12936467	SNORA27	124	0.387097
chr16	12995476	13334273	SHISA9	338797	0.432153
chr16	13821945	13822026	JA611291	81	0.432099
chr16	14014013	14046205	ERCC4	32192	0.395688
chr16	14112736	14114934	BC039386	2198	0.443585
chr16	14165195	14360630	MKL2	195435	0.385248
chr16	14397823	14397906	MIR193B	83	0.493976
chr16	14403141	14403228	MIR365A	87	0.448276
chr16	14403150	14403230	mir-108-1	80	0.412500
chr16	14529556	14724128	PARN	194572	0.418185
chr16	14726667	14763093	BFAR	36426	0.460770
chr16	14766404	14788526	PLA2G10	22122	0.479116
chr16	14805545	14820195	LOC642778	14650	0.462594
chr16	14844669	14859315	LOC642778	14646	0.462857
chr16	14916288	14918559	ABCC6P2	2271	0.501981
chr16	14927642	14990014	NOMO1	62372	0.455076
chr16	14995364	14995448	MIR3179-3	84	0.440476
chr16	15005076	15005170	MIR3180-3	94	0.755319
chr16	15016485	15016511	DQ586919	26	0.576923
chr16	15019860	15023486	FLJ00322	3626	0.658025
chr16	15031299	15045931	NPIP	14632	0.461386
chr16	15068832	15131552	PDXDC1	62720	0.449617
chr16	15131709	15149936	NTAN1	18227	0.475997
chr16	15153878	15188158	RRN3	34280	0.420741
chr16	15198369	15225567	FLJ00285	27198	0.489558
chr16	15226577	15229270	FLJ00285	2693	0.653175
chr16	15248706	15248859	MIR3180-4	153	0.745098
chr16	15457480	15472151	LOC100288332	14671	0.460568
chr16	15459057	15459082	DQ599532	25	0.360000
chr16	15489610	15503543	MPV17L	13933	0.455896
chr16	15528324	15682116	C16orf45	153792	0.458203
chr16	15688225	15737023	KIAA0430	48798	0.441801
chr16	15744082	15820208	NDE1	76126	0.488913
chr16	15796991	15950887	MYH11	153896	0.481650
chr16	15959576	15982447	FOPNL	22871	0.416335
chr16	16043433	16236930	ABCC1	193497	0.484772
chr16	16243421	16317328	ABCC6	73907	0.498302
chr16	16326388	16388668	NOMO3	62280	0.455026
chr16	16394015	16394099	MIR3179-2	84	0.440476
chr16	16403731	16403825	MIR3180-3	94	0.755319
chr16	16418511	16421971	PKD1P1	3460	0.654335
chr16	16425710	16444465	PKD1P1	18755	0.474860
chr16	16455165	16455191	DQ586919	26	0.576923
chr16	16461117	16461143	DQ596229	26	0.615385
chr16	16464996	16469696	AK310228	4700	0.614681
chr16	16481597	16487807	NPIP	6210	0.462480
chr16	17196180	17564738	XYLT1	368558	0.458864
chr16	17431653	17432716	AX747757	1063	0.508937
chr16	18411797	18466711	NPIP	54914	0.526969
chr16	18429924	18434624	AK310228	4700	0.615745
chr16	18437720	18444915	AK304826	7195	0.669910
chr16	18478751	18478777	DQ596229	26	0.615385
chr16	18484703	18484729	DQ586919	26	0.576923
chr16	18496034	18496128	MIR3180-3	94	0.755319
chr16	18505750	18505834	MIR3179-3	84	0.440476
chr16	18511181	18573434	NOMO2	62253	0.454838
chr16	18582569	18609607	ABCC6P1	27038	0.478845
chr16	18794276	18801656	RPS15A	7380	0.460163
chr16	18802990	18812857	ARL6IP1	9867	0.405392
chr16	18816174	18937726	SMG1	121552	0.399286
chr16	18995255	19075262	TMC7	80007	0.461660
chr16	19078916	19091417	COQ7	12501	0.461963
chr16	19125253	19132952	ITPRIPL2	7699	0.493181
chr16	19179637	19278554	SYT17	98917	0.458101
chr16	19297104	19322269	CLEC19A	25165	0.450825
chr16	19429017	19510434	TMC5	81417	0.447904
chr16	19513014	19533450	GDE1	20436	0.401399
chr16	19535178	19564728	CCP110	29550	0.378342
chr16	19566736	19712485	C16orf62	145749	0.449856
chr16	19717673	19729492	KNOP1	11819	0.528471
chr16	19727777	19868859	IQCK	141082	0.438355
chr16	19870292	19896151	GPRC5B	25859	0.509184
chr16	20043042	20085100	GPR139	42058	0.445147
chr16	20321810	20338835	GP2	17025	0.450514
chr16	20344372	20364037	UMOD	19665	0.468091
chr16	20370491	20416033	PDILT	45542	0.451034
chr16	20420855	20452281	ACSM5	31426	0.425189
chr16	20462858	20498991	ACSM2A	36133	0.405059
chr16	20499023	20500981	AX747287	1958	0.417263
chr16	20548082	20587695	ACSM2B	39613	0.391917
chr16	20603667	20603695	DQ576448	28	0.571429
chr16	20634558	20702578	ACSM1	68020	0.403337
chr16	20744988	20753199	THUMPD1	8211	0.413226
chr16	20775311	20808479	ACSM3	33168	0.398848
chr16	20807661	20817795	ERI2	10134	0.373890
chr16	20817766	20860990	LOC81691	43224	0.398899
chr16	20869395	20911561	DCUN1D3	42166	0.430442
chr16	20912074	20936328	LYRM1	24254	0.437083
chr16	20944475	21170762	DNAH3	226287	0.440374
chr16	21169911	21191937	TMEM159	22026	0.435122
chr16	21208772	21223067	ZP2	14295	0.452116
chr16	21245015	21263750	ANKS4B	18735	0.425407
chr16	21269838	21314404	CRYM	44566	0.431989
chr16	21312169	21329912	CRYM-AS1	17743	0.416220
chr16	21360683	21397254	SNX29P1	36571	0.482404
chr16	21413454	21436699	NPIPL3	23245	0.475328
chr16	21413547	21847993	LOC23117	434446	0.448463
chr16	21414220	21414250	DQ576952	30	0.466667
chr16	21414989	21415019	DQ576952	30	0.466667
chr16	21430882	21430909	DQ595631	27	0.481481
chr16	21443344	21445776	LOC100190986	2432	0.448191
chr16	21458833	21468260	LOC100271836	9427	0.392384
chr16	21483648	21498990	LOC100271836	15342	0.384826
chr16	21529229	21531765	SLC7A5P2	2536	0.573344
chr16	21610855	21668792	METTL9	57937	0.425842
chr16	21652604	21663987	IGSF6	11383	0.408855
chr16	21653374	21653481	U6	107	0.439252
chr16	21689834	21772050	OTOA	82216	0.449511
chr16	21807950	21830495	RRN3P1	22545	0.408561
chr16	21846038	21847993	LOC23117	1955	0.588235
chr16	21848005	21868927	LOC100132247	20922	0.465921
chr16	21875622	21877693	DQ598910	2071	0.440850
chr16	21891093	21900501	DKFZp779K0112	9408	0.392113
chr16	21903255	21903282	DQ592203	27	0.481481
chr16	21915443	21930477	DKFZp547E087	15034	0.380937
chr16	21964608	21994668	UQCRC2	30060	0.401863
chr16	21995185	22012431	PDZD9	17246	0.446306
chr16	22019455	22095972	C16orf52	76517	0.390828
chr16	22103862	22168287	VWA3A	64425	0.467179
chr16	22217591	22300066	EEF2K	82475	0.478375
chr16	22308460	22308542	TRNA	82	0.646341
chr16	22308695	22346424	POLR3E	37729	0.516738
chr16	22357256	22385938	CDR2	28682	0.420787
chr16	22430866	22449036	RRN3P3	18170	0.494276
chr16	22462887	22477935	SMG1P1	15048	0.381114
chr16	22493284	22502712	SMG1P1	9428	0.392554
chr16	22524843	22547841	LOC100132247	22998	0.474041
chr16	22517267	22517294	DQ584116	27	0.370370
chr16	22530636	22530663	DQ595631	27	0.481481
chr16	22545695	22545725	DQ576951	30	0.466667
chr16	22545821	22545851	DQ576951	30	0.466667
chr16	22545935	22545965	DQ576951	30	0.466667
chr16	22546291	22546321	DQ576951	30	0.466667
chr16	22546543	22546573	DQ576951	30	0.466667
chr16	22546795	22546825	DQ576951	30	0.466667
chr16	22546934	22546964	DQ576951	30	0.466667
chr16	22547060	22547090	DQ576951	30	0.466667
chr16	22557018	22588186	LOC653786	31168	0.441382
chr16	22729602	22803363	MIR548AA2	73761	0.420968
chr16	22729602	22803362	MIR548D2	73760	0.420973
chr16	22825859	22927659	HS3ST2	101800	0.433792
chr16	23072727	23160591	USP31	87864	0.413708
chr16	23194039	23228200	SCNN1G	34161	0.475191
chr16	23313590	23392620	SCNN1B	79030	0.488523
chr16	23399813	23464512	COG7	64699	0.459729
chr16	23424904	23425197	7SK	293	0.470990
chr16	23457785	23458603	BC062350	818	0.488998
chr16	23474862	23521815	GGA2	46953	0.480949
chr16	23533333	23568696	EARS2	35363	0.477307
chr16	23568861	23585710	UBFD1	16849	0.472669
chr16	23592334	23607639	NDUFAB1	15305	0.487292
chr16	23614482	23652678	PALB2	38196	0.435517
chr16	23652686	23685068	DCTN5	32382	0.426966
chr16	23690200	23701688	PLK1	11488	0.502873
chr16	23701625	23724821	ERN2	23196	0.507932
chr16	23765947	23770256	CHP2	4309	0.542585
chr16	23847299	24231932	PRKCB	384633	0.437667
chr16	24266873	24373737	CACNG3	106864	0.445304
chr16	24344735	24344868	SNORA1	133	0.398496
chr16	24550907	24584183	RBBP6	33276	0.371138
chr16	24586235	24586264	DQ573285	29	0.689655
chr16	24672742	24682383	AK127191	9641	0.450472
chr16	24741048	24837547	TNRC6A	96499	0.404357
chr16	24857552	24922949	SLC5A11	65397	0.454256
chr16	24930711	25026675	ARHGAP17	95964	0.442906
chr16	25013690	25013720	DQ583809	30	0.566667
chr16	25043061	25044098	LOC554206	1037	0.538091
chr16	25078257	25080275	BC023651	2018	0.528246
chr16	25081004	25081035	DQ589737	31	0.387097
chr16	25081124	25081154	DQ598334	30	0.600000
chr16	25081175	25081238	DQ598207	63	0.492063
chr16	25081658	25081725	DQ590011	67	0.507463
chr16	25083071	25083105	DQ581863	34	0.588235
chr16	25083137	25083167	DQ579263	30	0.533333
chr16	25083230	25083272	DQ598724	42	0.428571
chr16	25083319	25083397	DQ583840	78	0.435897
chr16	25083456	25083487	DQ583840	31	0.451613
chr16	25083497	25083575	DQ583840	78	0.448718
chr16	25083586	25083664	DQ583840	78	0.448718
chr16	25083675	25083709	DQ595581	34	0.441176
chr16	25083731	25083794	DQ598345	63	0.412698
chr16	25083812	25083862	DQ573186	50	0.420000
chr16	25084430	25084472	DQ591690	42	0.523810
chr16	25123046	25189551	LCMT1	66505	0.453500
chr16	25151891	25160353	LOC100506655	8462	0.478374
chr16	25228284	25240253	AQP8	11969	0.507728
chr16	25247321	25268855	ZKSCAN2	21534	0.425792
chr16	25703346	26149009	HS3ST4	445663	0.421260
chr16	27078218	27080487	C16orf82	2269	0.552226
chr16	27215295	27233089	KDM8	17794	0.516522
chr16	27236314	27280113	NSMCE1	43799	0.472842
chr16	27279525	27301789	FLJ21408	22264	0.441026
chr16	27280189	27282880	AK025061	2691	0.442958
chr16	27325229	27376099	IL4R	50870	0.497798
chr16	27438578	27463363	IL21R	24785	0.523825
chr16	27458990	27464714	IL21R-AS1	5724	0.542977
chr16	27471933	27561251	GTF3C1	89318	0.494133
chr16	27561467	27791692	KIAA0556	230225	0.478358
chr16	27798849	28074830	GSG1L	275981	0.481881
chr16	27874571	27874677	U6	106	0.358491
chr16	28109297	28223239	XPO6	113942	0.437942
chr16	28296205	28303385	AX746995	7180	0.491643
chr16	28303839	28335170	SBK1	31331	0.552935
chr16	28353875	28367975	NPIPL1	14100	0.456383
chr16	28390899	28415165	EIF3C	24266	0.472266
chr16	28467695	29415809	NPIPL1	948114	0.499603
chr16	28488599	28503623	CLN3	15024	0.516108
chr16	28505969	28510291	APOBR	4322	0.625868
chr16	28510682	28518155	IL27	7473	0.552522
chr16	28548661	28550495	NUPR1	1834	0.562704
chr16	28565248	28603111	CCDC101	37863	0.483057
chr16	28603263	28608391	SULT1A2	5128	0.557527
chr16	28616907	28620649	SULT1A1	3742	0.555318
chr16	28655909	28668196	NPIPL1	12287	0.452918
chr16	28722781	28747053	EIF3C	24272	0.472067
chr16	28769971	28784125	NPIPL1	14154	0.456196
chr16	28814096	28829149	AK125489	15053	0.478443
chr16	28834368	28848558	ATXN2L	14190	0.526286
chr16	28853731	28857729	TUFM	3998	0.554777
chr16	28875077	28885534	SH2B1	10457	0.569762
chr16	28889808	28915830	ATP2A1	26022	0.539851
chr16	28890277	28891242	LOC100289092	965	0.593782
chr16	28915741	28936532	RABEP2	20791	0.532923
chr16	28943259	28950668	CD19	7409	0.565798
chr16	28962317	28977767	NFATC2IP	15450	0.498706
chr16	28986095	28996838	SPNS1	10743	0.567812
chr16	28996146	29002104	LAT	5958	0.580396
chr16	29086162	29128038	RRN3P2	41876	0.440467
chr16	29114977	29119032	AK075019	4055	0.527004
chr16	29370432	29381114	SNX29P2	10682	0.471354
chr16	29393169	29393199	DQ576952	30	0.466667
chr16	29394278	29395579	AF072097	1301	0.561875
chr16	29439631	29450024	AK096982	10393	0.385933
chr16	29451168	29451195	DQ592203	27	0.481481
chr16	29460665	29461236	LOC606724	571	0.590193
chr16	29464913	29466285	BOLA2	1372	0.631195
chr16	29465821	29469545	SLX1A	3724	0.600161
chr16	29471206	29476301	SULT1A3	5095	0.559176
chr16	29476288	29478899	LOC613038	2611	0.629644
chr16	29494887	29496200	LOC100132247	1313	0.572734
chr16	29494950	29497180	LOC23117	2230	0.573543
chr16	29495625	29495781	DQ576952	156	0.564103
chr16	29497000	29516913	NPIPL3	19913	0.462663
chr16	29511390	29511417	DQ595631	27	0.481481
chr16	29538928	29577570	LOC440354	38642	0.390689
chr16	29624423	29625038	SLC7A5P1	615	0.702439
chr16	29674270	29681823	SPN	7553	0.542566
chr16	29690440	29709314	QPRT	18874	0.520451
chr16	29753785	29757340	C16orf54	3555	0.567370
chr16	29756599	29761150	BC041466	4551	0.554164
chr16	29789560	29792969	ZG16	3409	0.508654
chr16	29802033	29816706	KIF22	14673	0.502011
chr16	29817857	29822504	MAZ	4647	0.650097
chr16	29819965	29823306	AK097472	3341	0.613888
chr16	29823408	29827202	PRRT2	3794	0.608593
chr16	29827527	29833816	PAGR1	6289	0.537605
chr16	29829310	29832541	BC029255	3231	0.513773
chr16	29831714	29859360	MVP	27646	0.525392
chr16	29869677	29874578	CDIPT	4901	0.565395
chr16	29875154	29879374	CDIPT-AS1	4220	0.523697
chr16	29882479	29910585	SEZ6L2	28106	0.527645
chr16	29912146	29917377	ASPHD1	5231	0.535271
chr16	29917656	29937545	KCTD13	19889	0.480718
chr16	29973350	29984373	TMEM219	11023	0.485712
chr16	29985187	29999726	TAOK2	14539	0.545154
chr16	30003641	30007417	HIRIP3	3776	0.571504
chr16	30007530	30017112	INO80E	9582	0.568879
chr16	30016834	30022401	DOC2A	5567	0.620083
chr16	30034654	30036023	C16orf92	1369	0.585829
chr16	30035747	30042186	FAM57B	6439	0.606927
chr16	30043985	30047851	AK097527	3866	0.497155
chr16	30076993	30081741	ALDOA	4748	0.575400
chr16	30087383	30096695	PPP4C	9312	0.542848
chr16	30097114	30103205	TBX6	6091	0.573469
chr16	30103634	30107537	YPEL3	3903	0.568537
chr16	30107750	30116777	AK097453	9027	0.484879
chr16	30116130	30124878	GDPD3	8748	0.536123
chr16	30125425	30134630	MAPK3	9205	0.559153
chr16	30194730	30200397	CORO1A	5667	0.638786
chr16	30204255	30205627	BOLA2	1372	0.631195
chr16	30205163	30208887	SLX1A	3724	0.600161
chr16	30210548	30215650	SULT1A4	5102	0.558408
chr16	30215637	30218248	LOC613038	2611	0.629644
chr16	30234290	30235813	LOC23117	1523	0.587656
chr16	30234349	30257122	LOC613037	22773	0.475958
chr16	30251358	30251385	DQ595631	27	0.481481
chr16	30278913	30346695	LOC595101	67782	0.406465
chr16	30362086	30366682	CD2BP2	4596	0.578764
chr16	30368421	30370995	TBC1D10B	2574	0.606449
chr16	30368421	30381522	TBC1D10B	13101	0.539653
chr16	30386122	30389310	MYLPF	3188	0.559912
chr16	30389453	30394171	SEPT1	4718	0.581178
chr16	30389632	30411429	ZNF48	21797	0.529614
chr16	30418734	30429916	ZNF771	11182	0.518512
chr16	30435018	30441373	DCTPP1	6355	0.533438
chr16	30454951	30457224	SEPHS2	2273	0.512538
chr16	30483982	30534506	ITGAL	50524	0.504612
chr16	30515239	30515322	MIR4518	83	0.554217
chr16	30535321	30537910	ZNF768	2589	0.630745
chr16	30542778	30546194	ZNF747	3416	0.597775
chr16	30546393	30548465	AK056973	2072	0.475386
chr16	30565084	30569642	ZNF764	4558	0.581395
chr16	30581018	30583728	ZNF688	2710	0.582288
chr16	30583575	30595168	ZNF785	11593	0.490813
chr16	30591993	30597092	ZNF785	5099	0.544813
chr16	30613878	30621754	ZNF689	7876	0.514982
chr16	30613878	30621707	ZNF689	7829	0.514497
chr16	30662240	30667734	PRR14	5494	0.577539
chr16	30675777	30682131	FBRS	6354	0.607964
chr16	30709024	30709810	LOC730183	786	0.606870
chr16	30710461	30752028	SRCAP	41567	0.491881
chr16	30721857	30721986	SNORA30	129	0.519380
chr16	30748369	30756517	LOC100862671	8148	0.521969
chr16	30759619	30772497	PHKG2	12878	0.525703
chr16	30768743	30773565	C16orf93	4822	0.538781
chr16	30772932	30787628	RNF40	14696	0.558723
chr16	30789769	30798523	ZNF629	8754	0.577450
chr16	30899115	30905399	BCL7C	6284	0.544876
chr16	30886586	30886644	MIR4519	58	0.637931
chr16	30887232	30906539	BC073928	19307	0.525095
chr16	30905223	30905306	MIR762	83	0.855422
chr16	30907927	30914881	CTF1	6954	0.537389
chr16	30930639	30934590	FBXL19-AS1	3951	0.526196
chr16	30935895	30960104	FBXL19	24209	0.544467
chr16	30960404	30966259	ORAI3	5855	0.554740
chr16	30968614	30995981	SETD1A	27367	0.557167
chr16	30996518	31000473	HSD3B7	3955	0.606827
chr16	31000576	31021829	STX1B	21253	0.550416
chr16	31044415	31051488	STX4	7073	0.547151
chr16	31053031	31054276	BC039500	1245	0.606426
chr16	31072163	31076409	ZNF668	4246	0.601507
chr16	31085742	31094833	ZNF646	9091	0.585194
chr16	31094744	31100130	PRSS53	5386	0.588934
chr16	31102174	31106276	VKORC1	4102	0.554608
chr16	31119614	31124112	BCKDK	4498	0.614495
chr16	31128984	31142714	KAT8	13730	0.520685
chr16	31142753	31147151	PRSS8	4398	0.592769
chr16	31150246	31161415	PRSS36	11169	0.576238
chr16	31191430	31206192	FUS	14762	0.468703
chr16	31212806	31214097	PYCARD	1291	0.649884
chr16	31213205	31214773	C16orf98	1568	0.628189
chr16	31225341	31236510	TRIM72	11169	0.576954
chr16	31227282	31228395	PYDC1	1113	0.619048
chr16	31237192	31237830	TRIM72	638	0.484326
chr16	31271287	31344213	ITGAM	72926	0.433618
chr16	31366508	31394318	ITGAX	27810	0.521935
chr16	31404632	31437826	ITGAD	33194	0.517835
chr16	31439051	31439749	COX6A2	698	0.714900
chr16	31446884	31454348	ZNF843	7464	0.504019
chr16	31470316	31478488	ARMC5	8172	0.578561
chr16	31483475	31489281	TGFB1I1	5806	0.596452
chr16	31494438	31502091	SLC5A2	7653	0.593493
chr16	31500795	31519740	C16orf58	18945	0.512483
chr16	31539202	31540124	AHSP	922	0.521692
chr16	31579087	31580845	YBX3P1	1758	0.518771
chr16	31711933	31718745	CLUHP3	6812	0.559748
chr16	31724565	31771207	ZNF720	46642	0.380901
chr16	31819167	31820174	FKSG46	1007	0.459782
chr16	31885078	31928629	ZNF267	43551	0.388280
chr16	31973408	31973499	IGH	91	0.626374
chr16	31985055	31985202	IGHV 3-07	147	0.632653
chr16	32049999	32077674	VHDJH	27675	0.396134
chr16	32063481	32063597	IGH	116	0.491379
chr16	32070547	32070635	IGH	88	0.602273
chr16	32077385	32077476	IGH	91	0.604396
chr16	32162608	32163874	HERC2P4	1266	0.453397
chr16	32187410	32199434	AK300387	12024	0.428975
chr16	32264649	32267243	TP53TG3D	2594	0.489206
chr16	32274228	32276669	BC042588	2441	0.485866
chr16	32300867	32321785	BC041879	20918	0.438713
chr16	32329028	32329056	DQ571479	28	0.571429
chr16	32684848	32687448	TP53TG3	2600	0.489615
chr16	32752634	32764659	AK300387	12025	0.428607
chr16	32772265	32782580	X69637	10315	0.438875
chr16	32781018	32781045	DQ574674	27	0.555556
chr16	32888796	32891922	SLC6A10P	3126	0.587012
chr16	32914930	33208857	abParts	293927	0.418124
chr16	33013796	33013884	IGH	88	0.613636
chr16	33020652	33020790	IGH	138	0.623188
chr16	33110461	33120784	X69637	10323	0.438535
chr16	33112002	33112029	DQ574674	27	0.555556
chr16	33205584	33208179	TP53TG3B	2595	0.489403
chr16	33262119	33264719	TP53TG3B	2600	0.489615
chr16	33298267	33319211	BC041879	20944	0.438121
chr16	33326455	33326483	DQ571479	28	0.571429
chr16	33563209	33563243	RNU6-76P	34	0.352941
chr16	33571843	33586742	JF934746	14899	0.389892
chr16	33647451	33647542	IGH	91	0.604396
chr16	33654256	33654392	IGH	136	0.602941
chr16	33752502	33752887	IGH	385	0.514286
chr16	33784510	33786528	BC068290	2018	0.575322
chr16	33961051	33962503	LINC00273	1452	0.703857
chr16	33961676	33961696	JB158072	20	0.900000
chr16	33965507	33965534	JB175072	27	0.407407
chr16	34403801	34404762	UBE2MP1	961	0.601457
chr16	34597901	34624955	LOC283914	27054	0.394544
chr16	34711784	34714967	LOC146481	3183	0.424442
chr16	34739458	34740840	LOC100130700	1382	0.507959
chr16	34980922	34990995	FLJ26245	10073	0.589298
chr16	46503248	46603009	ANKRD26P1	99761	0.377613
chr16	46614467	46655311	SHCBP1	40844	0.394721
chr16	46693588	46723144	VPS35	29556	0.381615
chr16	46723557	46732306	ORC6	8749	0.441765
chr16	46736193	46782221	MYLK3	46028	0.468780
chr16	46835958	46865074	C16orf87	29116	0.369762
chr16	46918307	46965201	GPT2	46894	0.519491
chr16	46989273	47007625	DNAJA2	18352	0.425948
chr16	47115430	47177936	NETO2	62506	0.387499
chr16	47189297	47495015	ITFG1	305718	0.374610
chr16	47495209	47735434	PHKB	240225	0.381651
chr16	47883224	47921041	BC048130	37817	0.436100
chr16	48116883	48180681	ABCC12	63798	0.478071
chr16	48200821	48269088	ABCC11	68267	0.460398
chr16	48274602	48420559	MIR548AE2	145957	0.402324
chr16	48278210	48387407	LONP2	109197	0.395853
chr16	48389595	48396910	LOC100507577	7315	0.380861
chr16	48394445	48419229	SIAH1	24784	0.417285
chr16	48572636	48644120	N4BP1	71484	0.415771
chr16	48765614	48765712	U6	98	0.326531
chr16	49311828	49315742	CBLN1	3914	0.568472
chr16	49407807	49433319	C16orf78	25512	0.422154
chr16	49524514	49856649	ZNF423	332135	0.505216
chr16	50059188	50070999	CNEP1R1	11811	0.398527
chr16	50099880	50139375	HEATR3	39495	0.426763
chr16	50139751	50140297	AF086132	546	0.346154
chr16	50186828	50269219	PAPD5	82391	0.415094
chr16	50321822	50352043	ADCY7	30221	0.570597
chr16	50352928	50402845	BRD7	49917	0.390288
chr16	50532071	50532141	SNORD112	70	0.371429
chr16	50582240	50674771	NKD1	92531	0.518172
chr16	50706885	50715264	SNX20	8379	0.521781
chr16	50702765	50705550	AF143871	2785	0.513824
chr16	50731049	50766987	NOD2	35938	0.475096
chr16	50775960	50835846	CYLD	59886	0.364225
chr16	51169885	51185183	SALL1	15298	0.443391
chr16	51705146	51705474	7SK	328	0.475610
chr16	52060263	52107847	C16orf97	47584	0.377522
chr16	52116976	52119021	LINC00919	2045	0.381907
chr16	52471917	52580806	TOX3	108889	0.384465
chr16	52585998	52640887	LINC00918	54889	0.415493
chr16	53088944	53361414	CHD9	272470	0.389379
chr16	53403273	53405041	LOC643802	1768	0.337670
chr16	53468350	53525560	RBL2	57210	0.386331
chr16	53477139	53477244	U6	105	0.371429
chr16	53525191	53537170	AKTIP	11979	0.442858
chr16	53633817	53737771	RPGRIP1L	103954	0.372742
chr16	53737874	54148379	FTO	410505	0.397303
chr16	53952604	53952627	JB149426	23	0.478261
chr16	54317211	54320378	IRX3	3167	0.653615
chr16	54952776	54963101	CRNDE	10325	0.367554
chr16	54965110	54968395	IRX5	3285	0.578995
chr16	55358470	55364672	IRX6	6202	0.544663
chr16	55513080	55540586	MMP2	27506	0.490293
chr16	55542912	55620582	LPCAT2	77670	0.355195
chr16	55600583	55601592	CAPNS2	1009	0.457879
chr16	55690555	55740104	SLC6A2	49549	0.480756
chr16	55758836	55784123	CES1P2	25287	0.464468
chr16	55794510	55808826	CES1P1	14316	0.496438
chr16	55836763	55867075	CES1	30312	0.479579
chr16	55880065	55989943	CES5A	109878	0.430741
chr16	56126898	56225006	LOC283856	98108	0.384556
chr16	56225250	56382111	GNAO1	156861	0.491225
chr16	56226528	56228437	DKFZP434H168	1909	0.522787
chr16	56279431	56279535	MIR3935	104	0.461538
chr16	56395363	56459450	AMFR	64087	0.422004
chr16	56463047	56485261	NUDT21	22214	0.389169
chr16	56485423	56511407	OGFOD1	25984	0.405057
chr16	56518258	56554008	BBS2	35750	0.395804
chr16	56598960	56602869	MT4	3909	0.486825
chr16	56623266	56625000	MT3	1734	0.604960
chr16	56642477	56643409	MT2A	932	0.545064
chr16	56651372	56652730	MT1L	1358	0.553756
chr16	56659584	56661024	MT1E	1440	0.555556
chr16	56666533	56667898	MT1M	1365	0.553114
chr16	56669674	56670998	MT1JP	1324	0.539275
chr16	56672577	56673999	MT1A	1422	0.510549
chr16	56677715	56678853	MT1DP	1138	0.519332
chr16	56685810	56687116	MT1B	1306	0.540582
chr16	56691854	56693215	MT1F	1361	0.559882
chr16	56700652	56701977	MT1G	1325	0.541887
chr16	56703725	56705041	MT1H	1316	0.546353
chr16	56709648	56711653	MT1IP	2005	0.571072
chr16	56716381	56718108	MT1X	1727	0.537348
chr16	56764016	56878861	NUP93	114845	0.422395
chr16	56892429	56892513	MIR138-2	84	0.571429
chr16	56899118	56949762	SLC12A3	50644	0.528256
chr16	56966001	56977793	HERPUD1	11792	0.429953
chr16	56995834	57017756	CETP	21922	0.507618
chr16	57050985	57117436	NLRC5	66451	0.513205
chr16	57126454	57181878	CPNE2	55424	0.541444
chr16	57186377	57219976	FAM192A	33599	0.419001
chr16	57220240	57272947	RSPRY1	52707	0.417535
chr16	57279037	57287545	ARL2BP	8508	0.453573
chr16	57290008	57318584	PLLP	28576	0.526281
chr16	57392694	57400102	CCL22	7408	0.511474
chr16	57406413	57418956	CX3CL1	12543	0.537112
chr16	57438678	57449974	CCL17	11296	0.534880
chr16	57462086	57481369	CIAPIN1	19283	0.443085
chr16	57481336	57495187	COQ9	13851	0.458306
chr16	57496550	57505921	POLR2C	9371	0.480098
chr16	57505869	57520385	DOK4	14516	0.582667
chr16	57546089	57570477	CCDC102A	24388	0.560235
chr16	57576600	57611100	GPR114	34500	0.476986
chr16	57653909	57698944	GPR56	45035	0.565716
chr16	57702156	57723290	GPR97	21134	0.523800
chr16	57728712	57765367	CCDC135	36655	0.502251
chr16	57769659	57791162	KATNB1	21503	0.565782
chr16	57792128	57836439	KIFC3	44311	0.547155
chr16	57844548	57850831	LOC388282	6283	0.535572
chr16	57916243	58005020	CNGB1	88777	0.502653
chr16	58010338	58022017	TEPP	11679	0.509205
chr16	58028572	58033762	ZNF319	5190	0.586127
chr16	58035276	58055527	USB1	20251	0.478050
chr16	58059281	58080804	MMP15	21523	0.595688
chr16	58147496	58163296	C16orf80	15800	0.448481
chr16	58191811	58231782	CSNK2A2	39971	0.412499
chr16	58193777	58199612	CSNK2A2	5835	0.425021
chr16	58283839	58317734	CCDC113	33895	0.436082
chr16	58313900	58328951	PRSS54	15051	0.459172
chr16	58426297	58440048	GINS3	13751	0.466293
chr16	58497548	58547523	NDRG4	49975	0.535948
chr16	58549382	58554431	SETD6	5049	0.494751
chr16	58553849	58663790	CNOT1	109941	0.414404
chr16	58582402	58582537	SNORA46	135	0.437037
chr16	58593699	58593835	SNORA50	136	0.433824
chr16	58700297	58718674	SLC38A7	18377	0.525385
chr16	58741034	58768246	GOT2	27212	0.441533
chr16	58783809	59142878	AK057513	359069	0.395885
chr16	59788044	59789095	LOC644649	1051	0.454805
chr16	61685914	62070739	CDH8	384825	0.368313
chr16	64980682	65155919	CDH11	175237	0.401222
chr16	65318401	65610203	LINC00922	291802	0.396653
chr16	65420321	65420381	JB153694	60	0.350000
chr16	66400524	66438689	CDH5	38165	0.495480
chr16	66442426	66444803	LINC00920	2377	0.427850
chr16	66461199	66516745	BEAN1	55546	0.500918
chr16	66541905	66584315	TK2	42410	0.495072
chr16	66600349	66613038	CMTM1	12689	0.431713
chr16	66603838	66613038	CMTM1	9200	0.445761
chr16	66613350	66622177	CMTM2	8827	0.464711
chr16	66638227	66647795	CMTM3	9568	0.587061
chr16	66648652	66730610	CMTM4	81958	0.452598
chr16	66754798	66785525	DYNC1LI2	30727	0.448726
chr16	66788878	66835523	CCDC79	46645	0.399528
chr16	66836780	66864879	NAE1	28099	0.409908
chr16	66875335	66887351	AF086125	12016	0.545356
chr16	66878281	66888049	CA7	9768	0.553747
chr16	66914382	66925002	PDP2	10620	0.462806
chr16	66942024	66952887	CDH16	10863	0.565590
chr16	66955581	66959439	RRAD	3858	0.598497
chr16	66965957	66968326	FAM96B	2369	0.557197
chr16	66968346	66978994	CES2	10648	0.555128
chr16	66995131	67009052	CES3	13921	0.550176
chr16	67022491	67043659	CES4A	21168	0.511527
chr16	67063049	67134958	CBFB	71909	0.404233
chr16	67143914	67182442	C16orf70	38528	0.478224
chr16	67182004	67184902	B3GNT9	2898	0.626984
chr16	67183118	67184867	BC007896	1749	0.695254
chr16	67188088	67193812	TRADD	5724	0.586827
chr16	67193890	67198077	FBXL8	4187	0.599475
chr16	67197287	67203848	HSF4	6561	0.626124
chr16	67207755	67209640	NOL3	1885	0.627056
chr16	67209504	67217943	KIAA0895L	8439	0.565825
chr16	67218268	67224107	EXOC3L1	5839	0.597705
chr16	67226067	67232821	E2F4	6754	0.565739
chr16	67233027	67237927	ELMO3	4900	0.640204
chr16	67236223	67236298	MIR328	75	0.680000
chr16	67241041	67260901	LRRC29	19860	0.534240
chr16	67244250	67260901	LRRC29	16651	0.518287
chr16	67261015	67263182	TMEM208	2167	0.554684
chr16	67263291	67281425	FHOD1	18134	0.565071
chr16	67282854	67306094	SLC9A5	23240	0.506670
chr16	67295830	67297687	AK021876	1857	0.481960
chr16	67313049	67323403	PLEKHG4	10354	0.596195
chr16	67323392	67360661	KCTD19	37269	0.474791
chr16	67360746	67419109	LRRC36	58363	0.413001
chr16	67423711	67427421	TPPP3	3710	0.612399
chr16	67424593	67424753	U1	160	0.487500
chr16	67428321	67450339	ZDHHC1	22018	0.553229
chr16	67465035	67471454	HSD11B2	6419	0.589967
chr16	67471916	67515089	ATP6V0D1	43173	0.537674
chr16	67516473	67517716	AGRP	1243	0.604183
chr16	67563539	67580691	FAM65A	17152	0.579466
chr16	67596309	67673088	CTCF	76779	0.453249
chr16	67679029	67691472	RLTPR	12443	0.626135
chr16	67691414	67694718	ACD	3304	0.620157
chr16	67694850	67696681	PARD6A	1831	0.632441
chr16	67696849	67700628	ENKD1	3779	0.592220
chr16	67700716	67702661	C16orf86	1945	0.643702
chr16	67708435	67753273	GFOD2	44838	0.464561
chr16	67757004	67840555	RANBP10	83551	0.497361
chr16	67841009	67861971	TSNAXIP1	20962	0.517460
chr16	67862059	67881361	CENPT	19302	0.535799
chr16	67876212	67878098	THAP11	1886	0.599152
chr16	67880818	67905219	NUTF2	24401	0.510307
chr16	67906925	67918417	EDC4	11492	0.573094
chr16	67918780	67920271	NRN1L	1491	0.599598
chr16	67927174	67963581	PSKH1	36407	0.522949
chr16	67963472	67965778	CTRL	2306	0.594536
chr16	67964628	67970780	PSMB10	6152	0.577861
chr16	67973786	67978015	LCAT	4229	0.587609
chr16	67977376	67997968	SLC12A4	20592	0.568230
chr16	68009565	68014452	DPEP3	4887	0.571107
chr16	68021292	68033421	DPEP2	12129	0.546954
chr16	68055176	68057770	DDX28	2594	0.571704
chr16	68056846	68113226	DUS2L	56380	0.470823
chr16	68119268	68263162	NFATC3	143894	0.414277
chr16	68262449	68270136	ESRP2	7687	0.566541
chr16	68279246	68294961	PLA2G15	15715	0.538466
chr16	68298418	68335726	SLC7A6	37308	0.478101
chr16	68318125	68318221	U6	96	0.333333
chr16	68334517	68344868	SLC7A6OS	10351	0.462854
chr16	68344876	68391169	PRMT7	46293	0.483442
chr16	68363289	68363432	U4	143	0.412587
chr16	68392229	68482409	SMPD3	90180	0.510180
chr16	68573186	68601039	ZFP90	27853	0.440994
chr16	68573660	68601039	ZFP90	27379	0.436283
chr16	68678150	68732957	CDH3	54807	0.486635
chr16	68771194	68869444	CDH1	98250	0.468784
chr16	68877508	69119085	TANGO6	241577	0.430840
chr16	69139466	69151570	HAS3	12104	0.557171
chr16	69151911	69166493	CHTF8	14582	0.481621
chr16	69151911	69166071	CHTF8	14160	0.472458
chr16	69166498	69202937	CIRH1A	36439	0.444743
chr16	69221049	69342955	SNTB2	121906	0.419167
chr16	69345286	69358946	VPS4A	13660	0.550293
chr16	69362523	69364498	PDF	1975	0.612658
chr16	69362523	69373526	COG8	11003	0.522403
chr16	69373414	69377013	NIP7	3599	0.451236
chr16	69377148	69385712	TMED6	8564	0.455979
chr16	69389463	69419891	TERF2	30428	0.437525
chr16	69458497	69500167	CYB5B	41670	0.397672
chr16	69599710	69599771	MIR1538	61	0.704918
chr16	69599868	69738569	NFAT5	138701	0.385232
chr16	69743303	69760533	NQO1	17230	0.470110
chr16	69775756	69788871	NOB1	13115	0.482806
chr16	69796186	69975644	WWP2	179458	0.455990
chr16	69966983	69967083	MIR140	100	0.540000
chr16	69984607	69998250	CLEC18A	13643	0.571868
chr16	70010447	70024111	PDXDC2P	13664	0.454918
chr16	70027033	70027059	DQ601612	26	0.576923
chr16	70064248	70064325	MIR1972-1	77	0.467532
chr16	70147528	70195184	PDPR	47656	0.474001
chr16	70192859	70207351	AK096066	14492	0.489235
chr16	70253483	70259936	LOC100506060	6453	0.434372
chr16	70263706	70269272	AK308867	5566	0.354833
chr16	70284133	70285833	EXOSC6	1700	0.637647
chr16	70286296	70323412	AARS	37116	0.494558
chr16	70333061	70367735	DDX19B	34674	0.452183
chr16	70349542	70380650	LOC100506083	31108	0.469493
chr16	70413337	70472991	ST3GAL2	59654	0.519429
chr16	70488497	70514177	FUK	25680	0.551791
chr16	70514471	70557457	COG4	42986	0.472293
chr16	70557690	70611571	SF3B3	53881	0.437223
chr16	70563401	70563502	SNORD111B	101	0.396040
chr16	70571907	70572001	SNORD111	94	0.372340
chr16	70613797	70694585	IL34	80788	0.485171
chr16	70695106	70719954	MTSS1L	24848	0.562299
chr16	70721341	70835061	VAC14	113720	0.539984
chr16	70788962	70807154	VAC14-AS1	18192	0.525451
chr16	70802883	70804124	BC033164	1241	0.551974
chr16	70812113	70812184	TRNA	71	0.619718
chr16	70841286	71264625	HYDIN	423339	0.410784
chr16	71316202	71323315	FTSJD1	7113	0.393505
chr16	71392615	71424342	CALB2	31727	0.490339
chr16	71481502	71496117	ZNF23	14615	0.443243
chr16	71496180	71499844	AK123826	3664	0.444323
chr16	71507975	71523254	ZNF19	15279	0.441652
chr16	71560153	71572493	CHST4	12340	0.466126
chr16	71589390	71589412	JA374918	22	0.545455
chr16	71600753	71610998	TAT	10245	0.418643
chr16	71660055	71670108	MARVELD3	10053	0.494877
chr16	71678851	71748704	PHLPP2	69853	0.406912
chr16	71732469	71732604	SNORA70D	135	0.533333
chr16	71762904	71842976	AP1G1	80072	0.406971
chr16	71792304	71792390	SNORD71	86	0.488372
chr16	71879893	71891236	ATXN1L	11343	0.493961
chr16	71893582	71918093	ZNF821	24511	0.458406
chr16	71929395	71964540	IST1	35145	0.432380
chr16	71963440	72033877	PKD1L3	70437	0.435595
chr16	72042642	72059316	DHODH	16674	0.493823
chr16	72088507	72094955	HP	6448	0.476892
chr16	72097124	72111145	HPR	14021	0.448684
chr16	72118755	72127768	TXNL4B	9013	0.435149
chr16	72127614	72146811	DHX38	19197	0.514560
chr16	72152995	72206064	PMFBP1	53069	0.434698
chr16	72459846	72462787	AK055364	2941	0.427406
chr16	72463251	72567788	AK095618	104537	0.357041
chr16	72699067	72821759	AK021563	122692	0.380416
chr16	72816785	73082274	ZFHX3	265489	0.463409
chr16	72855831	72855891	U7	60	0.433333
chr16	73126247	73127672	HCCAT5	1425	0.518596
chr16	73420703	73436379	LOC100506172	15676	0.443098
chr16	74226290	74249420	BC043527	23130	0.412408
chr16	74330672	74340186	PSMD7	9514	0.435464
chr16	74366303	74402153	LOC283922	35850	0.469038
chr16	74411870	74425977	NPIPL2	14107	0.455093
chr16	74442528	74455368	CLEC18B	12840	0.568536
chr16	74481325	74641042	GLG1	159717	0.423781
chr16	74655296	74700779	RFWD3	45483	0.435306
chr16	74705752	74734789	MLKL	29037	0.456831
chr16	74746855	74808729	FA2H	61874	0.508921
chr16	74907470	75019017	WDR59	111547	0.442038
chr16	75032914	75144892	ZNRF1	111978	0.458492
chr16	75145757	75150670	LDHD	4913	0.624262
chr16	75182420	75206132	ZFP1	23712	0.422233
chr16	75237993	75241072	CTRB2	3079	0.650861
chr16	75252883	75258822	CTRB1	5939	0.561037
chr16	75262927	75299905	BCAR1	36978	0.593272
chr16	75327607	75467387	CFDP1	139780	0.422972
chr16	75479880	75498584	TMEM170A	18704	0.451240
chr16	75507021	75528926	CHST6	21905	0.500023
chr16	75562427	75569068	CHST5	6641	0.546153
chr16	75572014	75590184	TMEM231	18170	0.453770
chr16	75600248	75611779	GABARAPL2	11531	0.471772
chr16	75632246	75657221	ADAT1	24975	0.445245
chr16	75661621	75681585	KARS	19964	0.445953
chr16	75681634	75691341	TERF2IP	9707	0.428969
chr16	76343734	76593135	CNTNAP4	249401	0.365620
chr16	76321526	76321636	7SK	110	0.536364
chr16	76668894	76692375	AK057218	23481	0.350411
chr16	76902832	76902916	MIR4719	84	0.261905
chr16	77224835	77233543	MON1B	8708	0.518948
chr16	77233348	77246976	SYCE1L	13628	0.459202
chr16	77316024	77469011	ADAMTS18	152987	0.401603
chr16	77756388	77776157	NUDT7	19769	0.427639
chr16	77822482	78014001	VAT1L	191519	0.443188
chr16	78056442	78066001	CLEC3A	9559	0.410399
chr16	78133326	79246564	WWOX	1113238	0.426411
chr16	79627744	79634622	MAF	6878	0.460308
chr16	80574853	80584541	DYNLRB2	9688	0.380471
chr16	80600690	80603584	AK098656	2894	0.490325
chr16	80637675	80838175	CDYL2	200500	0.418863
chr16	80862639	80926493	AK093002	63854	0.388229
chr16	81009698	81040502	CMC2	30804	0.392059
chr16	81040102	81066709	CENPN	26607	0.432706
chr16	81069457	81080951	ATMIN	11494	0.446146
chr16	81094584	81110872	C16orf46	16288	0.432036
chr16	81115551	81129980	GCSH	14429	0.438076
chr16	81134483	81169977	PKD1L2	35494	0.494901
chr16	81203894	81253975	PKD1L2	50081	0.493720
chr16	81272295	81324747	BCMO1	52452	0.474396
chr16	81348570	81413803	GAN	65233	0.414575
chr16	81418622	81418698	MIR4720	76	0.381579
chr16	81478774	81745367	CMIP	266593	0.513318
chr16	81698958	81700879	LOC100129617	1921	0.493493
chr16	81772678	81774192	BC040927	1514	0.538970
chr16	81812898	81991899	PLCG2	179001	0.468204
chr16	81995530	81995848	7SK	318	0.556604
chr16	82031250	82045093	SDR42E1	13843	0.444557
chr16	82068857	82132139	HSD17B2	63282	0.423865
chr16	82181766	82203829	MPHOSPH6	22063	0.407424
chr16	82226109	82226395	7SK	286	0.479021
chr16	82660398	83830215	CDH13	1169817	0.422274
chr16	83541950	83542013	MIR3182	63	0.539683
chr16	83841507	83846607	HSBP1	5100	0.446275
chr16	83932729	83949787	MLYCD	17058	0.478602
chr16	83986826	83999937	OSGIN1	13111	0.557013
chr16	84002236	84036379	NECAB2	34143	0.529127
chr16	84043388	84075762	SLC38A8	32374	0.527769
chr16	84087368	84150517	MBTPS1	63149	0.451361
chr16	84155743	84178800	HSDL1	23057	0.450709
chr16	84178864	84211524	DNAAF1	32660	0.472045
chr16	84211452	84220676	TAF1C	9224	0.591284
chr16	84224722	84230772	ADAD2	6050	0.586116
chr16	84226163	84230659	AK123582	4496	0.591415
chr16	84254740	84273356	KCNG4	18616	0.517834
chr16	84328400	84363450	WFDC1	35050	0.498545
chr16	84402132	84497793	ATP2C2	95661	0.488255
chr16	84509965	84538288	TLDC1	28323	0.481905
chr16	84599203	84651669	COTL1	52466	0.502363
chr16	84682130	84695916	KLHL36	13786	0.531626
chr16	84696933	84700667	AK057887	3734	0.483931
chr16	84733554	84813527	USP10	79973	0.436410
chr16	84853586	84943116	CRISPLD2	89530	0.504445
chr16	85008066	85045141	ZDHHC7	37075	0.485853
chr16	85061409	85127828	KIAA0513	66419	0.516117
chr16	85131964	85146114	FAM92B	14150	0.537739
chr16	85170755	85183049	LOC400548	12294	0.559948
chr16	85316563	85321685	LINC00311	5122	0.561695
chr16	85339831	85339931	MIR5093	100	0.610000
chr16	85646841	85709812	GSE1	62971	0.586079
chr16	85711279	85722588	GINS2	11309	0.491467
chr16	85741123	85784689	C16orf74	43566	0.537483
chr16	85775226	85775306	MIR1910	80	0.587500
chr16	85812230	85833148	EMC8	20918	0.496319
chr16	85833172	85840607	COX4I1	7435	0.492670
chr16	85932773	85956211	IRF8	23438	0.496715
chr16	86320036	86326995	LOC146513	6959	0.508119
chr16	86365455	86379285	LINC00917	13830	0.524512
chr16	86508130	86542466	FENDRR	34336	0.516484
chr16	86544132	86548070	FOXF1	3938	0.590909
chr16	86563781	86588841	MTHFSD	25060	0.491381
chr16	86588925	86590905	FLJ30679	1980	0.505556
chr16	86600856	86602537	FOXC2	1681	0.709697
chr16	86612114	86615304	FOXL1	3190	0.568965
chr16	86754289	86755565	BC041439	1276	0.429467
chr16	87117167	87336368	AK125749	219201	0.478438
chr16	87245727	87260035	BC043543	14308	0.492592
chr16	87336403	87351026	C16orf95	14623	0.489298
chr16	87362941	87417394	FBXO31	54453	0.520449
chr16	87425800	87438380	MAP1LC3B	12580	0.459221
chr16	87439851	87525460	ZCCHC14	85609	0.479716
chr16	87527801	87549236	BC131758	21435	0.486587
chr16	87636492	87731761	JPH3	95269	0.563993
chr16	87736678	87739290	AX747795	2612	0.593032
chr16	87741417	87799598	KLHDC4	58181	0.519293
chr16	87863628	87903100	SLC7A5	39472	0.584136
chr16	87921624	87970112	CA5A	48488	0.520933
chr16	87985037	88110924	BANP	125887	0.511022
chr16	88121646	88134565	AK126852	12919	0.578141
chr16	88493878	88507165	ZNF469	13287	0.661549
chr16	88520013	88601574	ZFPM1	81561	0.630792
chr16	88535325	88535439	MIR5189	114	0.675439
chr16	88620184	88633125	C16orf85	12941	0.553898
chr16	88636788	88698372	ZC3H18	61584	0.517472
chr16	88705000	88706882	IL17C	1882	0.641870
chr16	88709696	88717492	CYBA	7796	0.617240
chr16	88718347	88729495	MVD	11148	0.591945
chr16	88729780	88741914	SNAI3-AS1	12134	0.525713
chr16	88744089	88752882	SNAI3	8793	0.571591
chr16	88762902	88772829	RNF166	9927	0.625264
chr16	88772890	88781786	CTU2	8896	0.609825
chr16	88781745	88851372	PIEZO1	69627	0.619214
chr16	88782685	88782745	MIR4722	60	0.716667
chr16	88797587	88807826	AK294743	10239	0.648598
chr16	88809228	88812156	FLJ40448	2928	0.643784
chr16	88870185	88875666	CDT1	5481	0.653165
chr16	88875876	88878342	APRT	2466	0.643958
chr16	88880141	88923374	GALNS	43233	0.601693
chr16	88923505	88927520	TRAPPC2L	4015	0.550685
chr16	88927604	88929086	TRAPPC2L	1482	0.584345
chr16	88929747	88933068	PABPN1L	3321	0.646793
chr16	88941262	89043504	CBFA2T3	102242	0.606590
chr16	89112579	89119373	AK055272	6794	0.630556
chr16	89160216	89222171	ACSF3	61955	0.547769
chr16	89225627	89230083	LINC00304	4456	0.613330
chr16	89232790	89235555	LOC400558	2765	0.652441
chr16	89238162	89261900	CDH15	23738	0.625495
chr16	89262168	89266529	SLC22A31	4361	0.633570
chr16	89284110	89295965	ZNF778	11855	0.492113
chr16	89299633	89302402	DQ583205	2769	0.475984
chr16	89334028	89556969	ANKRD11	222941	0.511848
chr16	89334511	89339452	AX747440	4941	0.538150
chr16	89387540	89391518	LOC100287036	3978	0.559578
chr16	89497374	89520902	AK097694	23528	0.478281
chr16	89574804	89624174	SPG7	49370	0.525096
chr16	89607524	89607552	DQ596025	28	0.428571
chr16	89607703	89619543	SPG7	11840	0.543159
chr16	89627064	89633237	RPL13	6173	0.559371
chr16	89627837	89627909	SNORD68	72	0.472222
chr16	89642175	89663654	CPNE7	21479	0.603194
chr16	89686999	89704839	DPEP1	17840	0.581110
chr16	89710838	89724193	CHMP1A	13355	0.585998
chr16	89724211	89736866	C16orf55	12655	0.521928
chr16	89748969	89751884	BC031657	2915	0.493310
chr16	89753075	89762772	CDK10	9697	0.588017
chr16	89762764	89768121	SPATA2L	5357	0.627217
chr16	89773540	89787394	VPS9D1	13854	0.595424
chr16	89782935	89784573	LOC100128881	1638	0.634921
chr16	89787951	89807332	ZNF276	19381	0.554564
chr16	89803958	89883065	FANCA	79107	0.504570
chr16	89894906	89937727	SPIRE2	42821	0.552953
chr16	89939993	89977792	TCF25	37799	0.547475
chr16	89978911	89981576	BC160930	2665	0.578612
chr16	89989686	90002505	TUBB3	12819	0.576644
chr16	89989686	90000546	TUBB3	10860	0.567495
chr16	90001645	90002211	TUBB3	566	0.641343
chr16	90015138	90034468	DEF8	19330	0.567926
chr16	90036182	90039240	CENPBD1	3058	0.542838
chr16	90044085	90051109	AFG3L1P	7024	0.485336
chr16	90056739	90063028	AFG3L1P	6289	0.528383
chr16	90071278	90076529	DBNDD1	5251	0.613788
chr16	90089007	90111379	GAS8	22372	0.527177
chr16	90095315	90096309	C16orf3	994	0.556338
chr16	90109309	90114191	LOC100130015	4882	0.592380
chr16	90107059	90108062	AK127378	1003	0.615155
chr16	90122973	90142338	PRDM7	19365	0.440279
chr16	90159561	90162762	TUBB4Q	3201	0.566073
chr16	90160430	90162762	BC139719	2332	0.596484
chr16	90168701	90204399	AX747598	35698	0.439044
chr16	90224862	90233897	AK302511	9035	0.471278
chr16	90237091	90238407	DQ574721	1316	0.651976
chr16	90244124	90289081	BC071667	44957	0.390907
chr17	6010	31420	DOC2B	25410	0.574262
chr17	62179	202633	RPH3AL	140454	0.535827
chr17	180995	183279	LOC100506388	2284	0.562609
chr17	260117	264457	C17orf97	4340	0.550922
chr17	289770	295731	FAM101B	5961	0.488341
chr17	411907	618096	VPS53	206189	0.458570
chr17	635846	646075	FAM57A	10229	0.495747
chr17	647660	655501	GEMIN4	7841	0.549292
chr17	654896	654925	DQ581337	29	0.448276
chr17	655572	658576	DBIL5P	3004	0.522636
chr17	662548	685571	GLOD4	23023	0.452895
chr17	685512	695741	RNMTL1	10229	0.486460
chr17	699304	701487	AX748314	2183	0.536418
chr17	702552	882998	NXN	180446	0.509859
chr17	722367	800254	NXN	77887	0.507723
chr17	900356	905390	TIMM22	5034	0.485896
chr17	906757	1083166	ABR	176409	0.560839
chr17	925715	925799	MIR3183	84	0.678571
chr17	1173857	1174565	BHLHA9	708	0.786723
chr17	1182956	1204281	TUSC5	21325	0.559062
chr17	1247833	1303556	YWHAE	55723	0.447894
chr17	1324646	1359561	CRK	34915	0.488558
chr17	1367479	1396001	MYO1C	28522	0.600799
chr17	1397870	1420182	INPP5K	22312	0.538813
chr17	1420212	1421390	PITPNA-AS1	1178	0.515280
chr17	1421282	1466110	PITPNA	44828	0.499264
chr17	1477695	1532130	SLC43A2	54435	0.545054
chr17	1537151	1549083	SCARF1	11932	0.580707
chr17	1549444	1553392	RILP	3948	0.643364
chr17	1553922	1588176	PRPF8	34254	0.488731
chr17	1606083	1613662	TLCD2	7579	0.517219
chr17	1614797	1619566	MIR22HG	4769	0.564060
chr17	1628124	1641893	WDR81	13769	0.606580
chr17	1646129	1658559	SERPINF2	12430	0.570716
chr17	1665258	1680859	SERPINF1	15601	0.534966
chr17	1682828	1733175	SMYD4	50347	0.459233
chr17	1733272	1802848	RPA1	69576	0.444076
chr17	1837970	1928178	RTN4RL1	90208	0.542391
chr17	1921176	1924000	BC040634	2824	0.559844
chr17	1933430	1946725	DPH1	13295	0.565175
chr17	1945276	1946725	OVCA2	1449	0.588682
chr17	1953201	1953302	MIR132	101	0.653465
chr17	1953564	1953674	MIR212	110	0.736364
chr17	1959603	1962981	HIC1	3378	0.703671
chr17	1963132	2207069	SMG6	243937	0.457553
chr17	2139006	2139380	AJ276246	374	0.438503
chr17	2207247	2228553	SRR	21306	0.448324
chr17	2225981	2240678	TSR1	14697	0.454787
chr17	2232418	2232504	SNORD91B	86	0.395349
chr17	2233572	2233664	SNORD91A	92	0.413043
chr17	2240805	2284348	SGSM2	43543	0.549801
chr17	2287353	2304258	MNT	16905	0.616090
chr17	2310274	2318730	LOC284009	8456	0.501064
chr17	2319347	2415200	METTL16	95853	0.441082
chr17	2489695	2489717	DD413682	22	0.409091
chr17	2496922	2588909	PAFAH1B1	91987	0.422560
chr17	2592679	2614927	CLUH	22248	0.624101
chr17	2651371	2651476	MIR1253	105	0.457143
chr17	2699731	2941035	RAP1GAP2	241304	0.512536
chr17	2965962	2966901	OR1D5	939	0.529287
chr17	2995351	2996290	OR1D2	939	0.504792
chr17	3029903	3030845	OR1G1	942	0.489384
chr17	3100812	3101742	OR1A2	930	0.452688
chr17	3118914	3119844	OR1A1	930	0.474194
chr17	3143969	3144559	OR1D4	590	0.540678
chr17	3181183	3182268	OR3A2	1085	0.529032
chr17	3194928	3195876	OR3A1	948	0.542194
chr17	3213538	3214740	OR3A4P	1202	0.554077
chr17	3300759	3301704	OR1E1	945	0.501587
chr17	3323861	3324827	OR3A3	966	0.547619
chr17	3336163	3337135	OR1E2	972	0.500000
chr17	3343305	3375126	SPATA22	31821	0.384023
chr17	3379295	3402700	ASPA	23405	0.411878
chr17	3413795	3461289	TRPV3	47494	0.516907
chr17	3468739	3500336	TRPV1	31597	0.529924
chr17	3511555	3539616	SHPK	28061	0.505043
chr17	3539761	3566397	CTNS	26636	0.542649
chr17	3566186	3571973	TAX1BP3	5787	0.572663
chr17	3572089	3572962	EMC6	873	0.599084
chr17	3576521	3599698	P2RX5	23177	0.585149
chr17	3617918	3704537	ITGAE	86619	0.508826
chr17	3627196	3629992	GSG2	2796	0.539342
chr17	3710044	3749545	C17orf85	39501	0.439559
chr17	3763616	3794037	CAMKK1	30421	0.565037
chr17	3799884	3819960	P2RX1	20076	0.556934
chr17	3808513	3819960	P2RX1	11447	0.552721
chr17	3827162	3867758	ATP2A3	40596	0.568948
chr17	3900704	3910012	AB062083	9308	0.511925
chr17	3907738	4046253	ZZEF1	138515	0.444789
chr17	4046461	4060995	CYB5D2	14534	0.504266
chr17	4066664	4167142	ANKFY1	100478	0.448645
chr17	4172511	4269969	UBE2G1	97458	0.417893
chr17	4337218	4391499	SPNS3	54281	0.532654
chr17	4384323	4389747	AX748345	5424	0.565450
chr17	4402128	4443228	SPNS2	41100	0.574769
chr17	4440056	4443228	SPNS2	3172	0.609395
chr17	4442190	4458681	MYBBP1A	16491	0.597902
chr17	4460221	4463876	GGT6	3655	0.598358
chr17	4481332	4481583	AB062083	251	0.438247
chr17	4487833	4511614	SMTNL2	23781	0.568942
chr17	4513743	4520942	BC043554	7199	0.490068
chr17	4534213	4544971	ALOX15	10758	0.544618
chr17	4574678	4607632	PELP1	32954	0.481489
chr17	4607524	4608824	LOC101559451	1300	0.505385
chr17	4613788	4624795	ARRB2	11007	0.567639
chr17	4634722	4636896	MED11	2174	0.522539
chr17	4636827	4643223	CXCL16	6396	0.515166
chr17	4643309	4649414	ZMYND15	6105	0.585258
chr17	4675186	4686506	TM4SF5	11320	0.506537
chr17	4688579	4689729	VMO1	1150	0.626957
chr17	4690351	4693628	BC150535	3277	0.582240
chr17	4692253	4693884	GLTPD2	1631	0.695279
chr17	4699438	4701798	PSMB6	2360	0.527119
chr17	4710395	4726727	PLD2	16332	0.542616
chr17	4736634	4801356	MINK1	64722	0.519422
chr17	4801063	4806369	CHRNE	5306	0.622880
chr17	4802947	4806227	C17orf107	3280	0.627134
chr17	4835591	4838325	GP1BA	2734	0.559620
chr17	4835898	4837135	GP1BA	1237	0.556184
chr17	4837174	4837856	GP1BA	682	0.599707
chr17	4840425	4843462	SLC25A11	3037	0.590385
chr17	4843629	4848517	RNF167	4888	0.520867
chr17	4848944	4852381	PFN1	3437	0.581612
chr17	4854383	4860426	ENO3	6043	0.543108
chr17	4862520	4871132	SPAG7	8612	0.516373
chr17	4870225	4870252	DQ588877	27	0.592593
chr17	4871286	4890665	CAMTA2	19379	0.536354
chr17	4891424	4900905	INCA1	9481	0.515241
chr17	4901242	4931694	KIF1C	30452	0.538717
chr17	4935896	4938727	SLC52A1	2831	0.588485
chr17	4981753	4999669	ZFP3	17916	0.455291
chr17	5009030	5026397	ZNF232	17367	0.504923
chr17	5031686	5078324	USP6	46638	0.445431
chr17	5033286	5033325	DQ594352	39	0.564103
chr17	5035360	5035393	DQ586040	33	0.575758
chr17	5036572	5036602	DQ575687	30	0.533333
chr17	5036851	5036880	DQ570124	29	0.551724
chr17	5037135	5037192	DQ576627	57	0.543860
chr17	5038691	5038723	DQ584383	32	0.531250
chr17	5038915	5038944	DQ574802	29	0.517241
chr17	5039983	5040025	DQ573130	42	0.547619
chr17	5082830	5095178	ZNF594	12348	0.439504
chr17	5095378	5126779	LOC100130950	31401	0.465845
chr17	5112215	5138155	SCIMP	25940	0.484734
chr17	5185557	5289132	RABEP1	103575	0.413691
chr17	5289345	5323059	NUP88	33714	0.424304
chr17	5322960	5332985	RPAIN	10025	0.450673
chr17	5336098	5342471	C1QBP	6373	0.468382
chr17	5344231	5372380	DHX33	28149	0.458134
chr17	5377612	5389494	DERL2	11882	0.412220
chr17	5389693	5394130	MIS12	4437	0.436331
chr17	5402746	5404319	LOC728392	1573	0.598220
chr17	5417437	5487832	NLRP1	70395	0.461794
chr17	5675553	5834016	LOC339166	158463	0.452913
chr17	5973933	6027747	WSCD1	53814	0.506727
chr17	6327058	6338519	AIPL1	11461	0.507111
chr17	6347734	6354385	FAM64A	6651	0.538265
chr17	6354582	6459877	PITPNM3	105295	0.520148
chr17	6481644	6544247	KIAA0753	62603	0.415955
chr17	6544221	6547861	TXNDC17	3640	0.423352
chr17	6546632	6554954	MED31	8322	0.402187
chr17	6555058	6556617	C17orf100	1559	0.511867
chr17	6558758	6558828	MIR4520A	70	0.457143
chr17	6558767	6558821	MIR4520B	54	0.444444
chr17	6561037	6564701	ALOX15P1	3664	0.548581
chr17	6588038	6616740	SLC13A5	28702	0.516515
chr17	6659155	6678964	XAF1	19809	0.439548
chr17	6679551	6690965	FBXO39	11414	0.421850
chr17	6703299	6735060	TEKT1	31761	0.422436
chr17	6756894	6803668	ALOX12P2	46774	0.417561
chr17	6899383	6914055	ALOX12	14672	0.488754
chr17	6904450	6915653	LOC100506713	11203	0.457556
chr17	6917463	6920843	RNASEK-C17orf49	3380	0.583136
chr17	6915735	6918197	RNASEK-C17orf49	2462	0.588546
chr17	6919136	6922973	MIR497HG	3837	0.558509
chr17	6920933	6921341	MIR497	408	0.573529
chr17	6926368	6932961	BCL6B	6593	0.538450
chr17	6939393	6943440	SLC16A13	4047	0.558685
chr17	6944948	6947242	SLC16A11	2294	0.669573
chr17	6977855	6983600	CLEC10A	5745	0.532115
chr17	7004640	7018130	ASGR2	13490	0.520163
chr17	7076750	7082883	ASGR1	6133	0.559596
chr17	7093209	7120928	DLG4	27719	0.549767
chr17	7123149	7128586	ACADVL	5437	0.581019
chr17	7126615	7126698	MIR324	83	0.614458
chr17	7128660	7137863	DVL2	9203	0.551451
chr17	7138346	7142825	PHF23	4479	0.591203
chr17	7143737	7145753	GABARAP	2016	0.521825
chr17	7146905	7154995	CTDNEP1	8090	0.511496
chr17	7155550	7163259	ELP5	7709	0.495006
chr17	7163221	7166264	CLDN7	3043	0.629642
chr17	7185053	7191367	SLC2A4	6314	0.578872
chr17	7191570	7197876	YBX2	6306	0.577228
chr17	7210317	7215782	EIF5A	5465	0.552973
chr17	7210644	7213772	EIF5A	3128	0.586317
chr17	7215977	7218974	GPS2	2997	0.575909
chr17	7218950	7232638	NEURL4	13688	0.571376
chr17	7239847	7254793	ACAP1	14946	0.545564
chr17	7255207	7258262	KCTD11	3055	0.604583
chr17	7258496	7260538	TMEM95	2042	0.594025
chr17	7284292	7293092	TNK1	8800	0.580455
chr17	7293046	7298162	PLSCR3	5116	0.584636
chr17	7306292	7307450	TMEM256	1158	0.578584
chr17	7311501	7323179	NLGN2	11678	0.587172
chr17	7323678	7324951	SPEM1	1273	0.600943
chr17	7328934	7330886	C17orf74	1952	0.622439
chr17	7338761	7340998	TMEM102	2237	0.639249
chr17	7342688	7348251	FGF11	5563	0.569477
chr17	7348405	7360932	CHRNB1	12527	0.520556
chr17	7362684	7387568	ZBTB4	24884	0.549108
chr17	7384720	7386383	SLC35G6	1663	0.588695
chr17	7387697	7417935	POLR2A	30238	0.496726
chr17	7452374	7464925	TNFSF12-TNFSF13	12551	0.547367
chr17	7475601	7482324	SENP3-EIF4A1	6723	0.533542
chr17	7465308	7475287	SENP3	9979	0.512476
chr17	7478030	7478165	SNORA48	135	0.533333
chr17	7480128	7480276	SNORD10	148	0.587838
chr17	7481272	7481409	SNORA67	137	0.525547
chr17	7482804	7485429	CD68	2625	0.558095
chr17	7486964	7491527	MPDU1	4563	0.533640
chr17	7491497	7493488	SOX15	1991	0.632346
chr17	7494547	7518215	FXR2	23668	0.480987
chr17	7533452	7536700	SHBG	3248	0.541564
chr17	7529555	7531194	SAT2	1639	0.567419
chr17	7554253	7561089	ATP1B2	6836	0.557343
chr17	7571719	7590868	TP53	19149	0.493916
chr17	7572991	7573011	HV941431	20	0.500000
chr17	7576852	7576876	HV941433	24	0.416667
chr17	7577062	7577083	HV941428	21	0.476190
chr17	7577127	7577148	HV941434	21	0.523810
chr17	7577498	7577522	HV941486	24	0.500000
chr17	7577557	7577590	HV941429	33	0.424242
chr17	7578201	7578240	HV941440	39	0.384615
chr17	7578243	7578266	HV941478	23	0.478261
chr17	7578433	7578454	HV941442	21	0.523810
chr17	7579311	7579337	HV941444	26	0.576923
chr17	7579525	7579546	HV941430	21	0.380952
chr17	7589388	7606820	WRAP53	17432	0.501319
chr17	7608519	7614693	EFNB3	6174	0.580985
chr17	7623038	7737058	DNAH2	114020	0.483126
chr17	7657637	7658286	RPL29P2	649	0.551618
chr17	7743234	7758118	KDM6B	14884	0.606154
chr17	7758383	7759417	TMEM88	1034	0.630561
chr17	7760002	7761172	LSMD1	1170	0.583761
chr17	7761063	7765600	CYB5D1	4537	0.481816
chr17	7788122	7816075	CHD3	27953	0.531750
chr17	7809440	7809578	SCARNA21	138	0.644928
chr17	7816639	7819265	LOC284023	2626	0.487433
chr17	7816657	7818978	AX746771	2321	0.463593
chr17	7825176	7832753	KCNAB3	7577	0.529233
chr17	7833662	7835267	TRAPPC1	1605	0.564486
chr17	7835441	7853237	CNTROB	17796	0.487188
chr17	7905987	7923658	GUCY2D	17671	0.555203
chr17	7942357	7952451	ALOX15B	10094	0.556568
chr17	7960203	7962083	AX747630	1880	0.476064
chr17	7975953	7991021	ALOX12B	15068	0.554553
chr17	7982799	7984883	BC046191	2084	0.618042
chr17	7991373	7991465	MIR4314	92	0.597826
chr17	7999217	8022234	ALOXE3	23017	0.517617
chr17	8023907	8027410	HES7	3503	0.632601
chr17	8043787	8055753	PER1	11966	0.601788
chr17	8062464	8066293	VAMP2	3829	0.561765
chr17	8076296	8079714	TMEM107	3418	0.489468
chr17	8090262	8090322	MIR4521	60	0.416667
chr17	8090492	8090577	MIR3676	85	0.541176
chr17	8091650	8093564	C17orf59	1914	0.656740
chr17	8108048	8113944	AURKB	5896	0.526967
chr17	8123947	8127361	LINC00324	3414	0.545987
chr17	8128138	8151413	CTC1	23275	0.488980
chr17	8152595	8173809	PFAS	21214	0.514000
chr17	8191081	8198170	SLC25A35	7089	0.553675
chr17	8191968	8193409	RANGRF	1441	0.586398
chr17	8213555	8225834	ARHGEF15	12279	0.552732
chr17	8243187	8249363	ODF4	6176	0.473284
chr17	8261730	8263859	LOC100128288	2129	0.435885
chr17	8271972	8274858	KRBA2	2886	0.447678
chr17	8280833	8286565	RPL26	5732	0.437893
chr17	8294022	8301144	RNF222	7122	0.521202
chr17	8339169	8371495	NDEL1	32326	0.422477
chr17	8377522	8534079	MYH10	156557	0.419968
chr17	8633245	8648154	CCDC42	14909	0.499363
chr17	8656423	8661877	SPDYE4	5454	0.516502
chr17	8700427	8702667	MFSD6L	2240	0.597768
chr17	8706054	8770994	PIK3R6	64940	0.466138
chr17	8782232	8815834	PIK3R5	33602	0.513035
chr17	8924858	9147317	NTN1	222459	0.497656
chr17	9153787	9479275	STX8	325488	0.434354
chr17	9479943	9546776	WDR16	66833	0.424042
chr17	9548853	9633003	USP43	84150	0.448841
chr17	9674750	9694614	DHRS7C	19864	0.476792
chr17	9729380	9793022	GLP2R	63642	0.445806
chr17	9801026	9808684	RCVRN	7658	0.495168
chr17	9813925	10101868	GAS7	287943	0.479661
chr17	10204182	10276322	MYH13	72140	0.458719
chr17	10286460	10527200	AK097500	240740	0.394799
chr17	10293641	10325267	MYH8	31626	0.389110
chr17	10346607	10372876	MYH4	26269	0.384217
chr17	10395626	10421859	MYH1	26233	0.396905
chr17	10424464	10452940	MYH2	28476	0.393033
chr17	10531842	10560626	MYH3	28784	0.486277
chr17	10583648	10600885	SCO1	17237	0.393398
chr17	10600926	10614875	ADPRM	13949	0.404473
chr17	10616638	10633646	TMEM220	17008	0.403516
chr17	10619259	10619899	MAGOH2	640	0.395312
chr17	10633093	10718481	TMEM220-AS1	85388	0.470453
chr17	10698229	10707416	LINC00675	9187	0.497660
chr17	10725791	10741418	PIRT	15627	0.479235
chr17	11144739	11467380	SHISA6	322641	0.436625
chr17	11501747	11873065	DNAH9	371318	0.426260
chr17	11880761	11900689	ZNF18	19928	0.414141
chr17	11924134	12047051	MAP2K4	122917	0.370958
chr17	11939812	11939954	U11	142	0.429577
chr17	11985215	11985313	MIR744	98	0.540816
chr17	12453284	12540504	LINC00670	87220	0.400378
chr17	12569206	12670651	MYOCD	101445	0.417960
chr17	12692828	12894960	ARHGAP44	202132	0.426870
chr17	12894928	12921381	ELAC2	26453	0.480210
chr17	13399005	13505244	HS3ST3A1	106239	0.409435
chr17	13680148	13695867	AK123263	15719	0.367517
chr17	13927814	13928915	CDRT15P1	1101	0.584015
chr17	13932608	13972775	COX10-AS1	40167	0.395723
chr17	13972718	14111996	COX10	139278	0.384906
chr17	14080447	14080627	SNORA74	180	0.538889
chr17	14139172	14140150	CDRT15	978	0.584867
chr17	14204505	14249492	HS3ST3B1	44987	0.462756
chr17	14207056	14209062	MGC12916	2006	0.509970
chr17	14934291	14935274	CDRT7	983	0.441506
chr17	15133095	15164093	PMP22	30998	0.442545
chr17	15154943	15155013	MIR4731	70	0.642857
chr17	15207128	15244958	TEKT3	37830	0.408062
chr17	15332289	15333318	BC037357	1029	0.479106
chr17	15339331	15370925	CDRT4	31594	0.461543
chr17	15405577	15466945	TVP23C	61368	0.426493
chr17	15474804	15555260	TRIM16	80456	0.451414
chr17	15602890	15624100	ZNF286A	21210	0.399764
chr17	15635590	15648098	TBC1D26	12508	0.581548
chr17	15668016	15669003	CDRT15P2	987	0.573455
chr17	15690163	15693019	MEIS3P1	2856	0.449230
chr17	15848230	15879210	ADORA2B	30980	0.498580
chr17	15879874	15903006	ZSWIM7	23132	0.440602
chr17	15902693	15932723	TTC19	30030	0.409324
chr17	15933407	16118874	NCOR1	185467	0.395375
chr17	16041081	16041186	U6	105	0.409524
chr17	16120508	16229573	PIGL	109065	0.448797
chr17	16185327	16185402	MIR1288	75	0.533333
chr17	16245847	16256812	CENPV	10965	0.475148
chr17	16284366	16286054	UBB	1688	0.521327
chr17	16318855	16340317	TRPV2	21462	0.532429
chr17	16342300	16345340	C17orf76-AS1	3040	0.471711
chr17	16342822	16342870	SNORD49B	48	0.437500
chr17	16343349	16343420	SNORD49A	71	0.436620
chr17	16344539	16344612	SNORD65	73	0.397260
chr17	16345318	16395505	FAM211A	50187	0.535338
chr17	16453630	16472520	ZNF287	18890	0.400212
chr17	16524047	16557167	ZNF624	33120	0.376721
chr17	16593638	16678311	CCDC144A	84673	0.381562
chr17	16690205	16707819	USP32P1	17614	0.429545
chr17	16692056	16693815	FAM106CP	1759	0.440591
chr17	16733796	16736147	KRT16P2	2351	0.589962
chr17	16826228	16838153	FLJ00050	11925	0.603774
chr17	16842397	16875402	TNFRSF13B	33005	0.462294
chr17	17067973	17095962	MPRIP	27989	0.521669
chr17	17104308	17109646	PLD6	5338	0.559573
chr17	17115526	17140502	FLCN	24976	0.532952
chr17	17149937	17184617	COPS3	34680	0.447030
chr17	17206679	17250977	NT5M	44298	0.491512
chr17	17322657	17326728	SMCR9	4071	0.535741
chr17	17380299	17396534	MED9	16235	0.479150
chr17	17397752	17399709	RASD1	1957	0.629535
chr17	17408876	17495017	PEMT	86141	0.552222
chr17	17584786	17714765	RAI1	129979	0.564476
chr17	17679999	17682843	SMCR5	2844	0.548172
chr17	17714662	17740325	SREBF1	25663	0.580213
chr17	17717149	17717245	MIR33B	96	0.729167
chr17	17746821	17875784	TOM1L2	128963	0.482673
chr17	17876126	17920189	LRRC48	44063	0.502599
chr17	17921333	17942480	ATPAF2	21147	0.479359
chr17	17942610	17971718	GID4	29108	0.459702
chr17	17991180	18011299	DRG2	20119	0.535663
chr17	18012019	18083116	MYO15A	71097	0.551922
chr17	18079875	18088067	BC038464	8192	0.553589
chr17	18086866	18113267	ALKBH5	26401	0.500625
chr17	18128935	18148188	LLGL1	19253	0.598452
chr17	18148130	18162230	FLII	14100	0.595957
chr17	18157226	18157253	DQ596932	27	0.370370
chr17	18164423	18169095	SMCR7	4672	0.597817
chr17	18177234	18218321	TOP3A	41087	0.483024
chr17	18218593	18231370	SMCR8	12777	0.526728
chr17	18231186	18266856	SHMT1	35670	0.498879
chr17	18281078	18292960	EVPLL	11882	0.570106
chr17	18291820	18292148	DQ571055	328	0.597561
chr17	18294080	18294124	DQ570768	44	0.454545
chr17	18294620	18294651	DQ576083	31	0.516129
chr17	18296010	18296074	DQ585755	64	0.515625
chr17	18296162	18296218	DQ595911	56	0.517857
chr17	18296351	18296411	DQ578124	60	0.566667
chr17	18296427	18296486	DQ579248	59	0.559322
chr17	18296769	18296804	DQ592713	35	0.428571
chr17	18297051	18297085	DQ586114	34	0.529412
chr17	18299430	18301432	DQ595299	2002	0.523976
chr17	18301635	18301666	DQ585853	31	0.548387
chr17	18302461	18302489	DQ593368	28	0.607143
chr17	18302581	18302624	DQ578661	43	0.534884
chr17	18302687	18302737	DQ573130	50	0.540000
chr17	18303100	18303171	DQ579174	71	0.549296
chr17	18304080	18304183	DQ572309	103	0.533981
chr17	18304190	18304227	DQ592578	37	0.567568
chr17	18304607	18304642	DQ586004	35	0.600000
chr17	18304748	18304785	DQ584883	37	0.459459
chr17	18314472	18317694	AX748015	3222	0.513967
chr17	18325494	18328647	LOC339240	3153	0.569299
chr17	18330174	18333941	AK296148	3767	0.591983
chr17	18343221	18346208	KRT16P1	2987	0.593907
chr17	18380098	18398259	LGALS9C	18161	0.530257
chr17	18414575	18445234	USP32P2	30659	0.404971
chr17	18427879	18430160	FAM106A	2281	0.471285
chr17	18506601	18528930	CCDC144B	22329	0.397823
chr17	18538841	18547740	TBC1D28	8899	0.576245
chr17	18561741	18585572	ZNF286B	23831	0.424028
chr17	18625401	18639431	TRIM16L	14030	0.463649
chr17	18647325	18682662	FBXW10	35337	0.454113
chr17	18684581	18710026	TVP23B	25445	0.408764
chr17	18761380	18834599	PRPSAP2	73219	0.447534
chr17	18855477	18924004	SLC5A10	68527	0.568331
chr17	18854937	18857462	BC029877	2525	0.542178
chr17	18874380	18908060	FAM83G	33680	0.580493
chr17	18923989	18950336	GRAP	26347	0.567503
chr17	19015583	19015656	DL490867	73	0.561644
chr17	19030781	19062148	GRAPL	31367	0.547136
chr17	19059039	19062424	BC058012	3385	0.545052
chr17	19091621	19091693	DL490867	72	0.569444
chr17	19093193	19093265	DL490867	72	0.569444
chr17	19122455	19125840	BC058012	3385	0.545052
chr17	19140689	19240028	EPN2	99339	0.482670
chr17	19174705	19177701	EPN2-IT1	2996	0.472296
chr17	19192082	19194013	AX748411	1931	0.537027
chr17	19199908	19209574	EPN2-AS1	9666	0.497517
chr17	19246482	19266046	B9D1	19564	0.514363
chr17	19246482	19266046	B9D1	19564	0.514363
chr17	19247818	19247887	MIR1180	69	0.695652
chr17	19281773	19286857	MAPK7	5084	0.582415
chr17	19285244	19285304	DM110819	60	0.700000
chr17	19286754	19290532	MFAP4	3778	0.569084
chr17	19314490	19320589	RNF112	6099	0.599443
chr17	19437166	19482346	SLC47A1	45180	0.476073
chr17	19460872	19461024	SNORA59A	152	0.539474
chr17	19552063	19580908	ALDH3A2	28845	0.437199
chr17	19581627	19620043	SLC47A2	38416	0.468034
chr17	19641297	19648772	ALDH3A1	7475	0.602676
chr17	19674142	19771239	ULK2	97097	0.414410
chr17	19751381	19751437	U6	56	0.357143
chr17	19807764	19881169	AKAP10	73405	0.411007
chr17	19912648	20218072	SPECC1	305424	0.424168
chr17	20224486	20305504	CCDC144CP	81018	0.381730
chr17	20319421	20320585	BC019672	1164	0.531787
chr17	20328041	20334521	AK310665	6480	0.434414
chr17	20340136	20350557	BC044655	10421	0.505614
chr17	20353175	20370848	LGALS9B	17673	0.528320
chr17	20404826	20407811	KRT16P3	2985	0.594640
chr17	20422624	20432000	AK127974	9376	0.490828
chr17	20446281	20446318	DQ600835	37	0.459459
chr17	20446424	20446459	DQ577610	35	0.600000
chr17	20446834	20446878	DQ586256	44	0.545455
chr17	20446884	20446987	DQ592701	103	0.533981
chr17	20447897	20447968	DQ581854	71	0.549296
chr17	20448331	20448381	DQ576593	50	0.540000
chr17	20448444	20448487	DQ571776	43	0.534884
chr17	20448577	20448607	DQ593368	30	0.600000
chr17	20448629	20448669	DQ583069	40	0.550000
chr17	20449194	20449238	DQ587527	44	0.500000
chr17	20449402	20449433	DQ571391	31	0.548387
chr17	20449411	20449451	DQ577541	40	0.500000
chr17	20449528	20449558	DQ577743	30	0.633333
chr17	20449636	20449667	DQ597161	31	0.548387
chr17	20449790	20449837	DQ598304	47	0.468085
chr17	20450011	20450046	DQ579754	35	0.514286
chr17	20451126	20451208	DQ581615	82	0.524390
chr17	20451478	20451514	DQ586142	36	0.527778
chr17	20451593	20451639	DQ595999	46	0.478261
chr17	20451734	20451807	DQ586800	73	0.520548
chr17	20451896	20451966	DQ578310	70	0.571429
chr17	20452161	20452196	DQ580819	35	0.514286
chr17	20452945	20453000	DQ580080	55	0.545455
chr17	20453984	20454018	DQ601084	34	0.529412
chr17	20454265	20454300	DQ591451	35	0.428571
chr17	20454583	20454642	DQ598579	59	0.559322
chr17	20454658	20454718	DQ597254	60	0.566667
chr17	20454851	20454907	DQ585724	56	0.517857
chr17	20454995	20455059	DQ572047	64	0.515625
chr17	20456945	20456989	DQ574249	44	0.454545
chr17	20459145	20459184	DQ584223	39	0.589744
chr17	20483036	20484224	CDRT15L2	1188	0.555556
chr17	20615758	20641178	LOC100287072	25420	0.400865
chr17	20744340	20747794	BC067347	3454	0.672843
chr17	20766707	20799453	CCDC144NL	32746	0.386765
chr17	20771745	20807221	AK057473	35476	0.398833
chr17	20833067	20841832	BC072410	8765	0.380262
chr17	20841850	20885670	BC043529	43820	0.439708
chr17	20902905	20946352	USP22	43447	0.475660
chr17	20978902	20993823	HP08942	14921	0.445815
chr17	21030240	21095285	DHRS7B	65045	0.441233
chr17	21101262	21117908	TMEM11	16646	0.518323
chr17	21101262	21117908	TMEM11	16646	0.518323
chr17	21142183	21156578	C17orf103	14395	0.582702
chr17	21187967	21218551	MAP2K3	30584	0.569873
chr17	21308447	21323179	KCNJ12	14732	0.581252
chr17	21431570	21454941	C17orf51	23371	0.436310
chr17	21729872	21731760	UBBP4	1888	0.507415
chr17	21825369	21826499	FAM27L	1130	0.567257
chr17	21904061	21913070	FLJ36000	9009	0.574759
chr17	22021364	22021435	TRNA	71	0.436620
chr17	22021439	22021460	JB137816	21	0.476190
chr17	22022355	22022424	TRNA	69	0.420290
chr17	22022436	22023991	MTRNR2L1	1555	0.410932
chr17	22025083	22025155	TRNA	72	0.486111
chr17	22026336	22026405	TRNA	69	0.420290
chr17	22026406	22026479	TRNA	73	0.342466
chr17	22026511	22026577	TRNA	66	0.469697
chr17	22028250	22028318	TRNA	68	0.294118
chr17	22029025	22029095	TRNA	70	0.385714
chr17	22030720	22030788	TRNA	68	0.338235
chr17	25620935	25621022	MIR4522	87	0.712644
chr17	25621105	25640645	WSB1	19540	0.395343
chr17	25745030	25758649	TBC1D3P5	13619	0.555547
chr17	25748617	25748649	DQ584119	32	0.500000
chr17	25750963	25750990	DQ571187	27	0.481481
chr17	25904517	25950718	KSR1	46201	0.509275
chr17	25958173	25976586	LGALS9	18413	0.525498
chr17	25994303	25994329	DQ586005	26	0.615385
chr17	26083791	26127555	NOS2	43764	0.513550
chr17	26205339	26220409	LYRM9	15070	0.484738
chr17	26369687	26523404	NLK	153717	0.371611
chr17	26553588	26555085	PYY2	1497	0.639279
chr17	26574469	26575315	PPY2	846	0.618203
chr17	26592388	26593130	DQ585914	742	0.504043
chr17	26593206	26593609	DQ600693	403	0.558313
chr17	26593703	26593769	DQ585914	66	0.393939
chr17	26593778	26593810	DQ592978	32	0.500000
chr17	26593855	26593892	DQ585914	37	0.405405
chr17	26593944	26594349	DQ600693	405	0.555556
chr17	26594453	26594508	DQ585914	55	0.400000
chr17	26594560	26594965	DQ581055	405	0.548148
chr17	26595059	26595101	DQ576370	42	0.357143
chr17	26595136	26595167	DQ575512	31	0.451613
chr17	26595172	26595223	DQ590016	51	0.392157
chr17	26595300	26595705	DQ581055	405	0.548148
chr17	26598272	26598315	DQ599370	43	0.534884
chr17	26598640	26598673	DQ592825	33	0.424242
chr17	26600040	26600077	DQ598642	37	0.486486
chr17	26603011	26634408	KRT18P55	31397	0.414116
chr17	26646120	26655711	TMEM97	9591	0.445209
chr17	26655350	26662515	IFT20	7165	0.477879
chr17	26662547	26674035	TNFAIP1	11488	0.527246
chr17	26673658	26684603	POLDIP2	10945	0.500046
chr17	26684686	26689089	TMEM199	4403	0.470815
chr17	26687676	26687757	MIR4723	81	0.530864
chr17	26691289	26692265	SEBOX	976	0.602459
chr17	26694298	26697373	VTN	3075	0.594472
chr17	26698986	26728065	SARM1	29079	0.504694
chr17	26721660	26733230	SLC46A1	11570	0.523163
chr17	26800663	26824798	SLC13A2	24135	0.525254
chr17	26850958	26865175	FOXN1	14217	0.564254
chr17	26873724	26879646	UNC119	5922	0.574130
chr17	26880405	26898887	PIGS	18482	0.472730
chr17	26900132	26903951	ALDOC	3819	0.554857
chr17	26904582	26926056	SPAG5	21474	0.462187
chr17	26926150	26944395	SPAG5-AS1	18245	0.483859
chr17	26941457	26972177	KIAA0100	30720	0.464909
chr17	26975373	26989190	SDF2	13817	0.470724
chr17	26989301	27029249	SUPT6H	39948	0.478722
chr17	27030533	27038872	PROCA1	8339	0.557021
chr17	27041298	27045286	RAB34	3988	0.582247
chr17	27043010	27044908	NARR	1898	0.593783
chr17	27046999	27051374	RPL23A	4375	0.495771
chr17	27047567	27047634	SNORD42B	67	0.402985
chr17	27049599	27049671	SNORD4A	72	0.472222
chr17	27050446	27050509	SNORD42A	63	0.365079
chr17	27050698	27050772	SNORD4B	74	0.432432
chr17	27051365	27053230	TLCD1	1865	0.566756
chr17	27055831	27069784	NEK8	13953	0.516233
chr17	27071022	27077976	TRAF4	6954	0.595772
chr17	27082995	27169841	FAM222B	86846	0.450360
chr17	27182042	27188072	ERAL1	6030	0.505804
chr17	27188386	27188458	MIR451A	72	0.416667
chr17	27188388	27188456	MIR451B	68	0.411765
chr17	27188550	27188636	MIR144	86	0.500000
chr17	27188672	27188748	MIR4732	76	0.644737
chr17	27206356	27224715	FLOT2	18359	0.543712
chr17	27224798	27230089	DHRS13	5291	0.549613
chr17	27224849	27225789	AX795351	940	0.554255
chr17	27232270	27278508	PHF12	46238	0.460552
chr17	27253292	27271766	BC033997	18474	0.434286
chr17	27281946	27333081	SEZ6	51135	0.541684
chr17	27369917	27384236	PIPOX	14319	0.489140
chr17	27400527	27507407	MYO18A	106880	0.538557
chr17	27400538	27402627	TIAF1	2089	0.542843
chr17	27573874	27581502	CRYBA1	7628	0.451494
chr17	27582853	27621166	NUFIP2	38313	0.416412
chr17	27717679	27717748	MIR4523	69	0.768116
chr17	27717942	27878921	TAOK1	160979	0.409289
chr17	27887688	27894042	ABHD15	6354	0.529115
chr17	27895738	27900175	TP53I13	4437	0.591616
chr17	27900486	27916610	GIT1	16124	0.596750
chr17	27920526	27941779	ANKRD13B	21253	0.543829
chr17	27941773	27948441	CORO6	6668	0.603029
chr17	27952964	28257018	SSH2	304054	0.406296
chr17	27968628	27968720	U6	92	0.413043
chr17	28210023	28210127	SnoU13	104	0.403846
chr17	28268622	28435470	EFCAB5	166848	0.391398
chr17	28443824	28513493	NSRP1	69669	0.383729
chr17	28444096	28444190	MIR423	94	0.521277
chr17	28444103	28444178	MIR3184	75	0.506667
chr17	28521336	28562986	SLC6A4	41650	0.468379
chr17	28575212	28619184	BLMH	43972	0.402893
chr17	28615088	28615195	U6	107	0.411215
chr17	28643365	28661065	TMIGD1	17700	0.415480
chr17	28687480	28687584	U6	104	0.432692
chr17	28705941	28796675	CPD	90734	0.385467
chr17	28804425	28853832	GOSR1	49407	0.396401
chr17	28882883	28882913	DQ584119	30	0.466667
chr17	28886041	28890509	TBC1D29	4468	0.528424
chr17	28886586	28886627	DQ578661	41	0.536585
chr17	28887107	28887136	DQ575791	29	0.586207
chr17	28935447	28992716	LRRC37BP1	57269	0.457717
chr17	28935447	28964484	LRRC37BP1	29037	0.423391
chr17	28951335	28953825	SH3GL1P2	2490	0.608434
chr17	29061080	29097068	SUZ12P1	35988	0.418501
chr17	29109701	29151778	CRLF3	42077	0.432184
chr17	29159022	29222295	ATAD5	63273	0.410380
chr17	29226000	29233286	TEFM	7286	0.412572
chr17	29248753	29286211	ADAP2	37458	0.489695
chr17	29297955	29326929	RNF135	28974	0.461621
chr17	29302352	29303017	DPRXP4	665	0.457143
chr17	29351202	29351444	AF086476	242	0.347107
chr17	29421367	29421443	MIR4733	76	0.526316
chr17	29421944	29704695	NF1	282751	0.375454
chr17	29621667	29624380	OMG	2713	0.370807
chr17	29630787	29641130	EVI2B	10343	0.371072
chr17	29643427	29648767	EVI2A	5340	0.328277
chr17	29718641	29865232	RAB11FIP4	146591	0.513749
chr17	29877092	29877164	TRNA	72	0.652778
chr17	29887014	29887102	MIR193A	88	0.636364
chr17	29890786	29890913	U6atac	127	0.464567
chr17	29902287	29902377	MIR4725	90	0.633333
chr17	29902429	29902540	MIR365B	111	0.450450
chr17	29902442	29902532	mir-108-1	90	0.422222
chr17	30178883	30186326	COPRS	7443	0.489184
chr17	30190189	30228729	UTP6	38540	0.442086
chr17	30264043	30328057	SUZ12	64014	0.410035
chr17	30318433	30318456	JB074907	23	0.478261
chr17	30348154	30380519	LRRC37B	32365	0.430527
chr17	30367354	30369851	SH3GL1P1	2497	0.612335
chr17	30469472	30552746	RHOT1	83274	0.414151
chr17	30477386	30478590	ARGFXP2	1204	0.468439
chr17	30593194	30651680	RHBDL3	58486	0.511593
chr17	30655459	30669228	C17orf75	13769	0.434164
chr17	30677156	30697468	ZNF207	20312	0.402521
chr17	30771480	30810337	PSMD11	38857	0.429524
chr17	30814104	30818271	CDK5R1	4167	0.554596
chr17	30819627	31203902	MYO1D	384275	0.408007
chr17	31254927	31268667	TMEM98	13740	0.488792
chr17	31318881	31324892	SPACA3	6011	0.531193
chr17	31340105	32483825	ASIC2	1143720	0.444077
chr17	31856805	31860779	AA06	3974	0.460493
chr17	31890356	31899364	AK057317	9008	0.463366
chr17	32496394	32510651	BC062794	14257	0.424774
chr17	32582295	32584220	CCL2	1925	0.456104
chr17	32597234	32599261	CCL7	2027	0.450419
chr17	32612686	32615199	CCL11	2513	0.435336
chr17	32646065	32648421	CCL8	2356	0.448217
chr17	32683470	32685629	CCL13	2159	0.489579
chr17	32687398	32690252	CCL1	2854	0.496847
chr17	32901141	32906388	C17orf102	5247	0.493997
chr17	32907767	32966337	TMEM132E	58570	0.530015
chr17	33254877	33288528	CCT6B	33651	0.377998
chr17	33288548	33290205	ZNF830	1657	0.459264
chr17	33307516	33332088	LIG3	24572	0.477088
chr17	33336130	33390759	RFFL	54629	0.437423
chr17	33426810	33433500	RAD51D	6690	0.464873
chr17	33448630	33457751	FNDC8	9121	0.483500
chr17	33458367	33469322	NLE1	10955	0.520219
chr17	33474835	33516364	UNC45B	41529	0.472224
chr17	33519538	33521412	SLC35G3	1874	0.553362
chr17	33570085	33594761	SLFN5	24676	0.428595
chr17	33677328	33700720	SLFN11	23392	0.392698
chr17	33738080	33759543	SLFN12	21463	0.375064
chr17	33762114	33775856	SLFN13	13742	0.417115
chr17	33801941	33814758	SLFN12L	12817	0.421081
chr17	33818381	33818403	DD413671	22	0.363636
chr17	33875143	33885110	SLFN14	9967	0.425003
chr17	33900675	33900772	SNORD7	97	0.463918
chr17	33901813	33905656	PEX12	3843	0.416602
chr17	33914281	34053436	AP2B1	139155	0.397427
chr17	34058678	34070540	RASL10B	11862	0.549570
chr17	34071529	34079897	GAS2L2	8368	0.565488
chr17	34087915	34092098	C17orf50	4183	0.548649
chr17	34092875	34122640	MMP28	29765	0.491584
chr17	34136458	34174246	TAF15	37788	0.404679
chr17	34181959	34195895	C17orf66	13936	0.472230
chr17	34198495	34207377	CCL5	8882	0.459581
chr17	34242761	34242791	DQ592711	30	0.500000
chr17	34245084	34257780	RDM1	12696	0.433129
chr17	34261522	34266560	LYZL6	5038	0.491663
chr17	34303534	34308523	CCL16	4989	0.484867
chr17	34310691	34313764	CCL14	3073	0.519362
chr17	34312625	34317306	BC070118	4681	0.436232
chr17	34324617	34329084	CCL15	4467	0.477054
chr17	34340096	34345005	CCL23	4909	0.414341
chr17	34391642	34398841	CCL18	7199	0.447701
chr17	34415602	34417506	CCL3	1904	0.522584
chr17	34431219	34433014	CCL4	1795	0.484680
chr17	34493060	34503988	TBC1D3B	10928	0.599469
chr17	34496554	34496597	DQ571776	43	0.534884
chr17	34497536	34497567	DQ571391	31	0.548387
chr17	34497545	34497574	DQ574804	29	0.517241
chr17	34498252	34498289	DQ573965	37	0.594595
chr17	34499312	34499341	DQ593188	29	0.551724
chr17	34499617	34499646	DQ586142	29	0.551724
chr17	34499866	34499925	DQ575686	59	0.542373
chr17	34501105	34501138	DQ580080	33	0.575758
chr17	34522267	34524156	CCL3L1	1889	0.527263
chr17	34538467	34540274	CCL4L2	1807	0.489762
chr17	34575459	34577063	AX747639	1604	0.495012
chr17	34578079	34578960	DQ580766	881	0.493757
chr17	34581084	34592032	TBC1D3C	10948	0.599653
chr17	34584598	34584641	DQ571776	43	0.534884
chr17	34585580	34585611	DQ571391	31	0.548387
chr17	34585589	34585618	DQ574805	29	0.517241
chr17	34587356	34587385	DQ593188	29	0.551724
chr17	34587661	34587690	DQ586142	29	0.551724
chr17	34587910	34587969	DQ575686	59	0.542373
chr17	34589150	34589183	DQ580080	33	0.575758
chr17	34591424	34591451	DQ579850	27	0.592593
chr17	34610748	34611354	D63785	606	0.597360
chr17	34623841	34625730	CCL3L1	1889	0.526734
chr17	34640033	34641840	CCL4L2	1807	0.489209
chr17	34749618	34749661	DQ571776	43	0.534884
chr17	34750597	34750628	DQ571391	31	0.548387
chr17	34750606	34750635	DQ574805	29	0.517241
chr17	34752369	34752398	DQ593188	29	0.551724
chr17	34752674	34752703	DQ586142	29	0.551724
chr17	34752923	34752982	DQ575686	59	0.542373
chr17	34754162	34754195	DQ580080	33	0.575758
chr17	34791544	34793149	AX747639	1605	0.494081
chr17	34794165	34795046	DQ580766	881	0.494892
chr17	34800669	34800712	DQ571776	43	0.534884
chr17	34801648	34801679	DQ571391	31	0.548387
chr17	34801657	34801686	DQ574804	29	0.517241
chr17	34803420	34803450	DQ581615	30	0.533333
chr17	34803725	34803754	DQ586142	29	0.551724
chr17	34803974	34804033	DQ575686	59	0.542373
chr17	34805213	34805246	DQ580080	33	0.575758
chr17	34842472	34851662	ZNHIT3	9190	0.449837
chr17	34851598	34891305	MYO19	39707	0.486917
chr17	34891402	34895150	PIGW	3748	0.414088
chr17	34900736	34946276	GGNBP2	45540	0.421651
chr17	34948225	34957233	DHRS11	9008	0.544960
chr17	34958024	34965407	MRM1	7383	0.524990
chr17	35038648	35038961	7SK	313	0.539936
chr17	35289408	35293921	BC084573	4513	0.615333
chr17	35294771	35301915	LHX1	7144	0.571669
chr17	35306174	35414171	AATF	107997	0.405122
chr17	35391041	35391110	MIR2909	69	0.521739
chr17	35441926	35766902	ACACA	324976	0.412778
chr17	35732984	35749662	C17orf78	16678	0.429368
chr17	35766976	35837226	TADA2A	70250	0.427986
chr17	35849950	35873588	DUSP14	23638	0.462730
chr17	35874899	35969486	SYNRG	94587	0.407910
chr17	35972362	36003493	DDX52	31131	0.394269
chr17	36046433	36105096	HNF1B	58663	0.480644
chr17	36202572	36244363	LOC284100	41791	0.423752
chr17	36283959	36295098	TBC1D3	11139	0.598617
chr17	36286815	36286848	DQ586040	33	0.575758
chr17	36288028	36288087	DQ587906	59	0.542373
chr17	36288307	36288336	DQ570124	29	0.551724
chr17	36288611	36288641	DQ576627	30	0.533333
chr17	36290380	36290409	DQ583226	29	0.517241
chr17	36290387	36290418	DQ585853	31	0.548387
chr17	36291354	36291397	DQ578661	43	0.534884
chr17	36332085	36333689	AL832615	1604	0.493766
chr17	36334705	36335586	DQ580766	881	0.493757
chr17	36337527	36348666	TBC1D3	11139	0.598707
chr17	36341228	36341271	DQ571776	43	0.534884
chr17	36342207	36342238	DQ571391	31	0.548387
chr17	36342216	36342245	DQ574805	29	0.517241
chr17	36343984	36344014	DQ581615	30	0.533333
chr17	36344289	36344318	DQ586142	29	0.551724
chr17	36344538	36344597	DQ575686	59	0.542373
chr17	36345777	36345810	DQ580080	33	0.575758
chr17	36364602	36421858	LOC440434	57256	0.424567
chr17	36452988	36479101	MRPL45	26113	0.452916
chr17	36481492	36499693	GPR179	18201	0.547882
chr17	36508006	36561846	SOCS7	53840	0.448087
chr17	36584719	36668628	ARHGAP23	83909	0.553063
chr17	36686258	36762183	SRCIN1	75925	0.566743
chr17	36827958	36831187	C17orf96	3229	0.641994
chr17	36858514	36858584	MIR4734	70	0.842857
chr17	36861872	36886056	MLLT6	24184	0.561239
chr17	36875943	36876001	MIR4726	58	0.672414
chr17	36886509	36891858	CISD3	5349	0.572630
chr17	36890149	36904561	PCGF2	14412	0.561130
chr17	36909001	36920478	PSMB3	11477	0.490372
chr17	36921943	36956158	PIP4K2B	34215	0.492299
chr17	36956686	36981603	CWC25	24917	0.476903
chr17	36982090	36982145	MIR4727	55	0.509091
chr17	36991340	36997642	C17orf98	6302	0.502063
chr17	37006320	37010053	RPL23	3733	0.449504
chr17	37009115	37009248	SNORA21	133	0.481203
chr17	37023897	37023969	TRNA	72	0.569444
chr17	37026111	37078023	LASP1	51912	0.536851
chr17	37026111	37078023	LASP1	51912	0.536851
chr17	37081420	37085637	LINC00672	4217	0.413090
chr17	37092684	37123655	FBXO47	30971	0.394756
chr17	37186158	37209458	LRRC37A11P	23300	0.434378
chr17	37217342	37264608	LOC100131347	47266	0.507870
chr17	37219555	37307902	PLXDC1	88347	0.506922
chr17	37313146	37322414	ARL5C	9268	0.522119
chr17	37329708	37353956	CACNB1	24248	0.543921
chr17	37356535	37360980	RPL19	4445	0.496513
chr17	37366788	37382040	STAC2	15252	0.576056
chr17	37408896	37557909	FBXL20	149013	0.431164
chr17	37560537	37607527	MED1	46990	0.450096
chr17	37617738	37690800	CDK12	73062	0.432961
chr17	37760020	37764175	NEUROD2	4155	0.634416
chr17	37783176	37792878	PPP1R1B	9702	0.577613
chr17	37793332	37820454	STARD3	27122	0.550586
chr17	37821598	37822807	TCAP	1209	0.638544
chr17	37824705	37826728	PNMT	2023	0.593673
chr17	37827374	37844310	PGAP3	16936	0.543162
chr17	37856253	37884915	ERBB2	28662	0.538518
chr17	37882747	37882814	MIR4728	67	0.671642
chr17	37885408	37886788	MIEN1	1380	0.576812
chr17	37895023	37903538	GRB7	8515	0.588021
chr17	37913967	38020441	IKZF3	106474	0.404803
chr17	38024454	38034149	ZPBP2	9695	0.387932
chr17	38060847	38074903	GSDMB	14056	0.483921
chr17	38077295	38083884	ORMDL3	6589	0.571862
chr17	38097726	38100987	LRRC3C	3261	0.562711
chr17	38119225	38134019	GSDMA	14794	0.504394
chr17	38137020	38154213	PSMD3	17193	0.497877
chr17	38171613	38174066	CSF3	2453	0.602120
chr17	38175349	38210889	MED24	35540	0.507316
chr17	38183795	38183898	SNORD124	103	0.495146
chr17	38219067	38250120	THRA	31053	0.551412
chr17	38249036	38256978	NR1D1	7942	0.567741
chr17	38278789	38293045	MSL1	14256	0.450196
chr17	38296506	38328431	CASC3	31925	0.455662
chr17	38334241	38351906	RAPGEFL1	17665	0.535069
chr17	38375573	38438439	WIPF2	62866	0.456686
chr17	38444145	38459413	CDC6	15268	0.433259
chr17	38465422	38513895	RARA	48473	0.569884
chr17	38516904	38520945	GJD3	4041	0.630042
chr17	38516906	38520945	GJD3	4039	0.630354
chr17	38544772	38574202	TOP2A	29430	0.398335
chr17	38599675	38613982	IGFBP4	14307	0.530579
chr17	38632079	38657854	TNS4	25775	0.528652
chr17	38710021	38721736	CCR7	11715	0.533077
chr17	38783975	38804103	SMARCE1	20128	0.365064
chr17	38811871	38821416	KRT222	9545	0.365846
chr17	38854242	38860002	KRT24	5760	0.428819
chr17	38904272	38911584	KRT25	7312	0.398523
chr17	38922489	38928411	KRT26	5922	0.386018
chr17	38933059	38938786	KRT27	5727	0.417671
chr17	38948447	38956211	KRT28	7764	0.416795
chr17	38974368	38978863	KRT10	4495	0.426919
chr17	38975343	38992526	TMEM99	17183	0.375953
chr17	39017429	39023462	KRT12	6033	0.431129
chr17	39032140	39041495	KRT20	9355	0.405345
chr17	39078951	39093836	KRT23	14885	0.415721
chr17	39114668	39123144	KRT39	8476	0.423785
chr17	39133967	39143387	KRT40	9420	0.417091
chr17	39149681	39150385	KRTAP3-3	704	0.485795
chr17	39155444	39156138	KRTAP3-2	694	0.488473
chr17	39164773	39165366	KRTAP3-1	593	0.526138
chr17	39182278	39183454	KRTAP1-5	1176	0.489796
chr17	39185928	39186377	KRTAP1-4	449	0.621381
chr17	39190136	39191107	KRTAP1-3	971	0.529351
chr17	39196810	39197713	KRTAP1-1	903	0.524917
chr17	39202795	39203568	KRTAP2-1	773	0.628719
chr17	39210750	39211463	KRTAP2-2	713	0.629734
chr17	39215492	39216344	KRTAP2-3	852	0.557512
chr17	39221367	39222131	KRTAP2-4	764	0.571990
chr17	39240458	39241396	KRTAP4-7	938	0.534115
chr17	39253233	39254375	KRTAP4-8	1142	0.527145
chr17	39261640	39262740	KRTAP4-9	1100	0.552727
chr17	39273433	39274606	KRTAP4-11	1173	0.530264
chr17	39279344	39280419	KRTAP4-12	1075	0.553488
chr17	39295684	39296739	KRTAP4-6	1055	0.540284
chr17	39305175	39306054	KRTAP4-5	879	0.554039
chr17	39315905	39316983	KRTAP4-4	1078	0.549165
chr17	39323482	39324424	KRTAP4-3	942	0.513800
chr17	39333697	39334460	KRTAP4-2	763	0.534731
chr17	39340351	39341147	KRTAP4-1	796	0.517588
chr17	39346138	39346891	KRTAP9-1	753	0.608234
chr17	39382899	39383904	KRTAP9-2	1005	0.517413
chr17	39388714	39389706	KRTAP9-3	992	0.497984
chr17	39394269	39395256	KRTAP9-8	987	0.508612
chr17	39405938	39406905	KRTAP9-4	967	0.503619
chr17	39411635	39412616	KRTAP9-9	981	0.497452
chr17	39421629	39422112	KRTAP9-6	483	0.619048
chr17	39431949	39432459	KRTAP9-7	510	0.631373
chr17	39458077	39459103	KRTAP29-1	1026	0.520468
chr17	39463951	39465505	KRTAP16-1	1554	0.581725
chr17	39471168	39471947	KRTAP17-1	779	0.560976
chr17	39502344	39507064	KRT33A	4720	0.483686
chr17	39519745	39526052	KRT33B	6307	0.461234
chr17	39533920	39538636	KRT34	4716	0.498940
chr17	39549976	39553844	KRT31	3868	0.498190
chr17	39558667	39568840	LOC100505782	10173	0.477932
chr17	39576808	39580822	KRT37	4014	0.513702
chr17	39592620	39597596	KRT38	4976	0.513666
chr17	39615764	39623638	KRT32	7874	0.513208
chr17	39632940	39637392	KRT35	4452	0.536613
chr17	39642387	39646116	KRT36	3729	0.561008
chr17	39657232	39661865	KRT13	4633	0.540902
chr17	39669996	39675270	KRT15	5274	0.547971
chr17	39910858	39942964	JUP	32106	0.548838
chr17	39705857	39710747	LOC147093	4890	0.506339
chr17	39722093	39728310	KRT9	6217	0.501689
chr17	39738530	39743147	KRT14	4617	0.552307
chr17	39766030	39769079	KRT16	3049	0.598557
chr17	39775691	39780882	KRT17	5191	0.585822
chr17	39782578	39796451	KRT42P	13873	0.573488
chr17	39845126	39847898	EIF1	2772	0.507937
chr17	39868577	39872221	GAST	3644	0.497256
chr17	39878890	39890898	HAP1	12008	0.567622
chr17	39958204	39968451	LEPREL4	10247	0.564068
chr17	39968961	39979469	FKBP10	10508	0.562143
chr17	39981333	39992523	NT5C3B	11190	0.489276
chr17	39994042	40004599	KLHL10	10557	0.474567
chr17	40009798	40021629	KLHL11	11831	0.475868
chr17	40023178	40075272	ACLY	52094	0.502265
chr17	40086887	40117668	TTC25	30781	0.504272
chr17	40118758	40129754	CNP	10996	0.546199
chr17	40128438	40169715	DNAJC7	41277	0.454079
chr17	40172086	40177656	NKIRAS2	5570	0.527110
chr17	40177593	40190044	ZNF385C	12451	0.522368
chr17	40253421	40264751	DHX58	11330	0.554899
chr17	40265128	40273382	KAT2A	8254	0.586867
chr17	40274755	40275371	HSPB9	616	0.637987
chr17	40276993	40307062	RAB5C	30069	0.493798
chr17	40308909	40333296	KCNH4	24387	0.550129
chr17	40336077	40337470	HCRT	1393	0.610912
chr17	40341104	40346550	GHDC	5446	0.582813
chr17	40351194	40428424	STAT5B	77230	0.434935
chr17	40439564	40463960	STAT5A	24396	0.546319
chr17	40465342	40540513	STAT3	75171	0.450054
chr17	40466889	40468869	AK092965	1980	0.475758
chr17	40554466	40575338	PTRF	20872	0.525345
chr17	40610861	40674597	ATP6V0A1	63736	0.454610
chr17	40666205	40666325	MIR5010	120	0.541667
chr17	40672352	40674597	ATP6V0A1	2245	0.552339
chr17	40687950	40696466	NAGLU	8516	0.570338
chr17	40703983	40707232	HSD17B1	3249	0.618036
chr17	40704453	40706728	BC043620	2275	0.633407
chr17	40714091	40718299	COASY	4208	0.576996
chr17	40719077	40725221	MLX	6144	0.530273
chr17	40724327	40729849	PSMC3IP	5522	0.486418
chr17	40731525	40761445	FAM134C	29920	0.456852
chr17	40761357	40767256	TUBG1	5899	0.537888
chr17	40811265	40819024	TUBG2	7759	0.520041
chr17	40819931	40829048	PLEKHH3	9117	0.620709
chr17	40831419	40833845	CCR10	2426	0.606348
chr17	40834631	40852011	CNTNAP1	17380	0.546663
chr17	40852292	40897071	EZH1	44779	0.454432
chr17	40894171	40895176	BC047651	1005	0.452736
chr17	40905946	40913275	RAMP2-AS1	7329	0.498977
chr17	40913211	40915060	RAMP2	1849	0.606815
chr17	40925453	40931617	VPS25	6164	0.492537
chr17	40932648	40949084	WNK4	16436	0.539365
chr17	40947164	40950743	COA3	3579	0.549874
chr17	40949635	40950743	COA3	1108	0.519856
chr17	40950853	40963605	CNTD1	12752	0.444715
chr17	40962149	40976310	BECN1	14161	0.454417
chr17	40985158	40995777	PSME3	10619	0.481307
chr17	40996608	41002724	AOC2	6116	0.524526
chr17	41003200	41010147	AOC3	6947	0.543544
chr17	41019161	41021234	AOC4	2073	0.572600
chr17	41019959	41021364	AF047486	1405	0.526690
chr17	41030543	41050751	LINC00671	20208	0.487134
chr17	41052813	41066450	G6PC	13637	0.468065
chr17	41102542	41132545	PTGES3L-AARSD1	30003	0.480785
chr17	41132581	41145707	RUNDC1	13126	0.474707
chr17	41150445	41154971	RPL27	4526	0.496023
chr17	41158741	41166476	IFI35	7735	0.509632
chr17	41166621	41174459	VAT1	7838	0.549502
chr17	41177257	41184058	RND2	6801	0.537715
chr17	41196311	41277500	BRCA1	81189	0.429295
chr17	41277599	41292342	NBR2	14743	0.485383
chr17	41300387	41316185	AK093551	15798	0.440879
chr17	41323245	41363707	NBR1	40462	0.440389
chr17	41363893	41371589	TMEM106A	7696	0.508706
chr17	41373436	41381062	LINC00854	7626	0.486231
chr17	41381731	41382576	AK027091	845	0.538462
chr17	41453295	41466266	LINC00910	12971	0.489245
chr17	41476352	41478504	ARL4D	2152	0.560409
chr17	41522173	41522253	MIR2117	80	0.487500
chr17	41561333	41601680	DHX8	40347	0.438372
chr17	41605210	41623305	ETV4	18095	0.523238
chr17	41717757	41738931	MEOX1	21174	0.517569
chr17	41831098	41836156	SOST	5058	0.553578
chr17	41843488	41856368	DUSP3	12880	0.509472
chr17	41857802	41862054	C17orf105	4252	0.430856
chr17	41878166	41910547	MPP3	32381	0.489546
chr17	41924515	41940997	CD300LG	16482	0.527060
chr17	41952726	41985113	MPP2	32387	0.524223
chr17	41994575	41995355	FAM215A	780	0.612821
chr17	42002519	42002547	DQ592711	28	0.500000
chr17	42018171	42019833	PPY	1662	0.606498
chr17	42030106	42081837	PYY	51731	0.484912
chr17	42082031	42086436	NAGS	4405	0.634960
chr17	42088555	42092345	TMEM101	3790	0.546702
chr17	42112002	42144987	LSM12	32985	0.467637
chr17	42148097	42153712	G6PC3	5615	0.531790
chr17	42154120	42201014	HDAC5	46894	0.556553
chr17	42219273	42239844	C17orf53	20571	0.502260
chr17	42248073	42256451	ASB16	8378	0.539747
chr17	42253341	42264085	ASB16-AS1	10744	0.561895
chr17	42253341	42264085	ASB16-AS1	10744	0.561895
chr17	42264353	42269099	TMUB2	4746	0.529709
chr17	42269172	42275529	ATXN7L3	6357	0.557181
chr17	42282400	42297041	UBTF	14641	0.579742
chr17	42325757	42345502	SLC4A1	19745	0.557913
chr17	42376939	42385761	AK055254	8822	0.470642
chr17	42385926	42396038	RUNDC3A	10112	0.588212
chr17	42396992	42402217	SLC25A39	5225	0.610526
chr17	42422490	42430470	GRN	7980	0.576942
chr17	42431100	42441235	FAM171A2	10135	0.602467
chr17	42449549	42466873	ITGA2B	17324	0.548314
chr17	42472644	42580957	GPATCH8	108313	0.410006
chr17	42634811	42638630	FZD2	3819	0.559571
chr17	42733761	42753165	C17orf104	19404	0.386261
chr17	42754804	42767165	CCDC43	12361	0.423752
chr17	42785975	42829636	DBF4B	43661	0.478894
chr17	42836567	42859214	ADAM11	22647	0.590939
chr17	42854839	42859214	ADAM11	4375	0.598171
chr17	42875815	42908179	GJC1	32364	0.447812
chr17	42923720	42927848	HIGD1B	4128	0.524225
chr17	42927654	42976993	EFTUD2	49339	0.462170
chr17	42977079	42981047	CCDC103	3968	0.497480
chr17	42980126	42982758	FAM187A	2632	0.544073
chr17	42982993	42992920	GFAP	9927	0.563715
chr17	43002078	43025079	KIF18B	23001	0.492500
chr17	43037060	43045644	C1QL1	8584	0.571878
chr17	43100705	43128978	DCAKD	28273	0.511301
chr17	43138679	43186382	NMT1	47703	0.481458
chr17	43189007	43209891	PLCD3	20884	0.574603
chr17	43213013	43221543	ACBD4	8530	0.542907
chr17	43224683	43229468	HEXIM1	4785	0.499687
chr17	43238263	43247406	HEXIM2	9143	0.534070
chr17	43246171	43248852	HEXIM2	2681	0.586721
chr17	43295636	43299132	BC045769	3496	0.554062
chr17	43299291	43324683	FMNL1	25392	0.584397
chr17	43339557	43345997	MAP3K14-AS1	6440	0.559938
chr17	43331759	43339479	SPATA32	7720	0.539896
chr17	43340487	43394414	MAP3K14	53927	0.499750
chr17	43471267	43503012	ARHGAP27	31745	0.526729
chr17	43506717	43511112	ARHGAP27	4395	0.666667
chr17	43513265	43568146	PLEKHM1	54881	0.505311
chr17	43550252	43550274	JA429848	22	0.590909
chr17	43580624	43623697	ARL17A	43073	0.426508
chr17	43596707	43625261	LRRC37A3	28554	0.409190
chr17	43593072	43593494	DQ588732	422	0.511848
chr17	43596759	43596794	DQ578599	35	0.485714
chr17	43627369	43664137	LRRc37A	36768	0.434182
chr17	43677490	43679748	LOC644172	2258	0.608060
chr17	43861645	43913194	CRHR1	51549	0.547305
chr17	43716340	43719671	CRHR1-IT1	3331	0.477634
chr17	43920721	43972879	MAPT-AS1	52158	0.489033
chr17	43922255	43924438	SPPL2C	2183	0.612460
chr17	43971747	44105699	MAPT	133952	0.497014
chr17	43973148	43976164	MAPT-IT1	3016	0.554377
chr17	44076615	44077060	STH	445	0.561798
chr17	44107281	44270272	KANSL1	162991	0.403446
chr17	44270938	44274089	KANSL1-AS1	3151	0.456363
chr17	44372496	44415160	LRRC37A	42664	0.421151
chr17	44412267	44439163	ARL17A	26896	0.461593
chr17	44450178	44500463	NSFP1	50285	0.395227
chr17	44590075	44633014	LRRC37A2	42939	0.423880
chr17	44630121	44657088	ARL17A	26967	0.461379
chr17	44668034	44834828	NSF	166794	0.386201
chr17	44839871	44896126	WNT3	56255	0.536966
chr17	44928967	44954437	WNT9B	25470	0.514841
chr17	45000485	45018733	GOSR2	18248	0.441144
chr17	45050382	45050466	MIR5089	84	0.464286
chr17	45055521	45056614	RPRML	1093	0.685270
chr17	45098945	45099089	LOC51326	144	0.423611
chr17	45110625	45137515	ARL17	26890	0.440312
chr17	45126237	45127789	DQ597730	1552	0.466495
chr17	45195310	45266665	CDC27	71355	0.386714
chr17	45286427	45301045	MYL4	14618	0.470653
chr17	45331207	45390077	ITGB3	58870	0.465042
chr17	45400563	45401497	AX748120	934	0.615632
chr17	45401326	45518677	EFCAB13	117351	0.376767
chr17	45401615	45402367	AX748120	752	0.493351
chr17	45532473	45569986	MRPL45P2	37513	0.433077
chr17	45608443	45700642	NPEPPS	92199	0.408638
chr17	45727203	45761004	KPNB1	33801	0.430254
chr17	45772629	45789429	TBKBP1	16800	0.577857
chr17	45810609	45823485	TBX21	12876	0.532230
chr17	45884732	45899147	OSBPL7	14415	0.578495
chr17	45900637	45908907	MRPL10	8270	0.491898
chr17	45908992	45915079	LRRC46	6087	0.527682
chr17	45915046	45918699	SCRN2	3653	0.592116
chr17	45922279	45928516	SP6	6237	0.581690
chr17	45940707	45942556	BC031827	1849	0.505679
chr17	45956837	45959764	AX746787	2927	0.508029
chr17	45973515	46006323	SP2	32808	0.476012
chr17	45976150	45995938	BC038442	19788	0.471397
chr17	46018888	46026674	PNPO	7786	0.506936
chr17	46029333	46035243	PRR15L	5910	0.520135
chr17	46047893	46059152	CDK5RAP3	11259	0.516120
chr17	46103532	46115152	COPZ2	11620	0.522806
chr17	46114526	46114613	MIR152	87	0.632184
chr17	46125685	46138907	NFE2L1	13222	0.542505
chr17	46147413	46178560	CBX1	31147	0.456577
chr17	46184919	46200105	SNX11	15186	0.482023
chr17	46210801	46507594	SKAP1	296793	0.391185
chr17	46233788	46233873	MIR1203	85	0.623529
chr17	46606806	46608272	HOXB1	1466	0.611869
chr17	46620018	46622393	HOXB2	2375	0.565895
chr17	46621712	46628603	HOXB-AS1	6891	0.496880
chr17	46626231	46651810	HOXB3	25579	0.515462
chr17	46652868	46655743	HOXB4	2875	0.563478
chr17	46657199	46657309	MIR10A	110	0.390909
chr17	46673319	46679703	HOXB-AS3	6384	0.552005
chr17	46668618	46671103	HOXB5	2485	0.550503
chr17	46669653	46683774	HOXB-AS3	14121	0.543800
chr17	46673098	46682334	HOXB6	9236	0.541252
chr17	46684594	46688383	HOXB7	3789	0.536817
chr17	46689707	46692301	HOXB8	2594	0.571704
chr17	46698518	46703835	HOXB9	5317	0.560278
chr17	46709851	46709921	MIR196A1	70	0.428571
chr17	46799081	46799882	PRAC	801	0.498127
chr17	46800541	46802119	HOXB-AS5	1578	0.525349
chr17	46801769	46801837	MIR3185	68	0.632353
chr17	46802126	46806111	HOXB13	3985	0.565370
chr17	46839592	46894469	TTLL6	54877	0.464530
chr17	46908349	46942607	CALCOCO2	34258	0.438671
chr17	46970147	46973232	ATP5G1	3085	0.501135
chr17	46985730	47006422	UBE2Z	20692	0.474483
chr17	47007458	47022154	SNF8	14696	0.468631
chr17	47035917	47045955	GIP	10038	0.525304
chr17	47074773	47133507	IGF2BP1	58734	0.473014
chr17	47210328	47247351	B4GALNT2	37023	0.463307
chr17	47283595	47287936	GNGT2	4341	0.522691
chr17	47287588	47300587	ABI3	12999	0.541349
chr17	47300731	47308128	PHOSPHO1	7397	0.566716
chr17	47325604	47336027	FLJ40194	10423	0.497937
chr17	47366567	47439835	ZNF652	73268	0.415161
chr17	47481419	47492242	PHB	10823	0.483323
chr17	47535222	47539111	AK097622	3889	0.512471
chr17	47572654	47592382	NGFR	19728	0.567366
chr17	47653297	47661171	NXPH3	7874	0.596647
chr17	47676245	47755525	SPOP	79280	0.404226
chr17	47778689	47785282	SLC35B1	6593	0.467769
chr17	47787686	47841518	FAM117A	53832	0.471634
chr17	47865980	47906458	KAT7	40478	0.420154
chr17	47915670	47925379	TAC4	9709	0.508703
chr17	47923271	47926199	FLJ45513	2928	0.517076
chr17	48046561	48052323	DLX4	5762	0.586775
chr17	48067368	48072588	DLX3	5220	0.574138
chr17	48127712	48133103	LOC284080	5391	0.511779
chr17	48133339	48167849	ITGA3	34510	0.526514
chr17	48172638	48188733	PDK2	16095	0.564585
chr17	48188672	48207246	SAMD14	18574	0.549801
chr17	48211100	48227877	PPP1R9B	16777	0.593670
chr17	48243365	48253293	SGCA	9928	0.558723
chr17	48248788	48249837	HILS1	1049	0.599619
chr17	48248788	48258539	BC033456	9751	0.540252
chr17	48248806	48249823	BC126901	1017	0.604720
chr17	48261456	48279000	COL1A1	17544	0.584644
chr17	48264089	48264112	DD181999	23	0.565217
chr17	48267739	48267765	HV555657	26	0.461538
chr17	48348766	48358846	TMEM92	10080	0.555060
chr17	48423392	48438512	XYLT2	15120	0.575198
chr17	48445227	48450562	MRPL27	5335	0.471228
chr17	48450580	48458820	EME1	8240	0.478884
chr17	48458593	48474914	LRRC59	16321	0.471724
chr17	48459606	48459641	DQ599569	35	0.457143
chr17	48503518	48552200	ACSF2	48682	0.499630
chr17	48541852	48546227	CHAD	4375	0.576686
chr17	48556189	48563336	RSAD1	7147	0.502449
chr17	48585744	48608862	MYCBPAP	23118	0.507051
chr17	48610047	48621111	EPN3	11064	0.586497
chr17	48624428	48633213	SPATA20	8785	0.586910
chr17	48633567	48639469	CACNA1G-AS1	5902	0.621484
chr17	48638428	48704832	CACNA1G	66404	0.568309
chr17	48712217	48769063	ABCC3	56846	0.519491
chr17	48770550	48785270	ANKRD40	14720	0.444565
chr17	48796925	48830072	LUC7L3	33147	0.400519
chr17	48830416	48833574	AK090674	3158	0.362571
chr17	48838394	48844876	LINC00483	6482	0.461740
chr17	48843919	48844879	LINC00483	960	0.515625
chr17	48912604	48919709	WFIKKN2	7105	0.578325
chr17	48939586	48943715	TOB1	4129	0.452168
chr17	48944039	48945732	TOB1-AS1	1693	0.538689
chr17	49039534	49198226	SPAG9	158692	0.400033
chr17	49230896	49249105	NME1-NME2	18209	0.489209
chr17	49254785	49337427	MBTD1	82642	0.394642
chr17	49337896	49375292	UTP18	37396	0.403760
chr17	49414075	49419932	AK124832	5857	0.442206
chr17	49707673	50237161	CA10	529488	0.398345
chr17	51062879	51065012	C17orf112	2133	0.403188
chr17	51900238	51902573	KIF2B	2335	0.514347
chr17	51900670	51902553	KIF2B	1883	0.496017
chr17	52848309	52848638	7SK	329	0.440729
chr17	52978051	53039328	TOM1L1	61277	0.408914
chr17	52980464	52980534	TRNA	70	0.357143
chr17	53038479	53046064	COX11	7585	0.382861
chr17	53046125	53241449	STXBP4	195324	0.361016
chr17	53342320	53402426	HLF	60106	0.433235
chr17	53469973	53499341	MMD	29368	0.410413
chr17	53796987	53800225	TMEM100	3238	0.391600
chr17	53828339	53854748	PCTP	26409	0.422356
chr17	54230835	54560007	ANKFN1	329172	0.391175
chr17	54305682	54307024	BC037494	1342	0.336811
chr17	54671059	54672951	NOG	1892	0.594609
chr17	54869273	54911256	C17orf67	41983	0.446419
chr17	54911459	54946036	DGKE	34577	0.384244
chr17	54961462	54962274	MTVR2	812	0.554187
chr17	54965269	54991409	TRIM25	26140	0.491852
chr17	54967933	54968852	BC114339	919	0.505985
chr17	55015560	55038411	COIL	22851	0.429959
chr17	55055467	55084129	SCPEP1	28662	0.453074
chr17	55122838	55124156	RNF126P1	1318	0.643399
chr17	55162552	55198710	AKAP1	36158	0.498728
chr17	55333930	55757299	MSI2	423369	0.475713
chr17	55866809	55867093	7SK	284	0.545775
chr17	55916286	55927433	MRPS23	11147	0.444783
chr17	55938603	56032684	CUEDC1	94081	0.513770
chr17	56048909	56065615	VEZF1	16706	0.409434
chr17	56066404	56072211	AK126318	5807	0.409161
chr17	56078279	56084707	SRSF1	6428	0.401369
chr17	56160779	56167618	DYNLL2	6839	0.511186
chr17	56232514	56233447	OR4D1	933	0.504823
chr17	56234319	56236480	MSX2P1	2161	0.466451
chr17	56247016	56247940	OR4D2	924	0.528139
chr17	56270088	56282535	EPX	12447	0.518197
chr17	56282796	56296666	MKS1	13870	0.471810
chr17	56315786	56345879	LPO	30093	0.460506
chr17	56347216	56358296	MPO	11080	0.551264
chr17	56378587	56406152	BZRAP1	27565	0.578487
chr17	56402810	56431088	BZRAP1-AS1	28278	0.524648
chr17	56408592	56408679	MIR142	87	0.448276
chr17	56408605	56408628	JB025504	23	0.347826
chr17	56413336	56413383	MIR4736	47	0.617021
chr17	56422535	56429599	SUPT4H1	7064	0.456116
chr17	56431037	56494931	RNF43	63894	0.430103
chr17	56497528	56565759	HSF5	68231	0.401064
chr17	56566892	56595251	MTMR4	28359	0.478437
chr17	56597610	56606778	SEPT4	9168	0.515489
chr17	56618947	56621733	C17orf47	2786	0.494616
chr17	56634037	56769416	TEX14	135379	0.452530
chr17	56769962	56811692	RAD51C	41730	0.417278
chr17	56833229	57062540	PPM1E	229311	0.396108
chr17	57059999	57184266	TRIM37	124267	0.397089
chr17	57183958	57195629	BC017255	11671	0.421815
chr17	57187307	57232800	SKA2	45493	0.412855
chr17	57187307	57232800	SKA2	45493	0.412855
chr17	57215118	57215233	MIR454	115	0.391304
chr17	57228496	57228582	MIR301A	86	0.406977
chr17	57232859	57284070	PRR11	51211	0.444026
chr17	57287370	57292611	SMG8	5241	0.434077
chr17	57297827	57353330	GDPD1	55503	0.408843
chr17	57409052	57479095	YPEL2	70043	0.466128
chr17	57443443	57443515	MIR4729	72	0.430556
chr17	57642885	57685713	DHX40	42828	0.396400
chr17	57697049	57774317	CLTC	77268	0.385425
chr17	57774666	57784856	PTRH2	10190	0.428656
chr17	57784862	57917952	VMP1	133090	0.397551
chr17	57918623	57918701	DM119512	78	0.474359
chr17	57918626	57918698	MIR21	72	0.486111
chr17	57924798	57924905	U6	107	0.373832
chr17	57936840	57970306	TUBD1	33466	0.452878
chr17	57970406	58027786	RPS6KB1	57380	0.417236
chr17	58029722	58042117	RNFT1	12395	0.381283
chr17	58042456	58074333	AK097658	31877	0.414845
chr17	58053384	58096336	TBC1D3P1-DHX40P1	42952	0.457650
chr17	58089047	58089090	DQ571776	43	0.534884
chr17	58090027	58090058	DQ571391	31	0.548387
chr17	58090036	58090065	DQ574805	29	0.517241
chr17	58091759	58091789	DQ581615	30	0.533333
chr17	58092314	58092373	DQ575686	59	0.542373
chr17	58093553	58093586	DQ580080	33	0.575758
chr17	58120385	58120466	MIR4737	81	0.629630
chr17	58120551	58156292	HEATR6	35741	0.404046
chr17	58160926	58165828	LOC645638	4902	0.440024
chr17	58179120	58180280	LOC653653	1160	0.408621
chr17	58227301	58236906	CA4	9605	0.570016
chr17	58254690	58469586	USP32	214896	0.394986
chr17	58308876	58309006	SCARNA20	130	0.615385
chr17	58499864	58508787	C17orf64	8923	0.484927
chr17	58511038	58513357	L32131	2319	0.470030
chr17	58520519	58603580	APPBP2	83061	0.396961
chr17	58677543	58743640	PPM1D	66097	0.409973
chr17	58755171	59470199	BCAS3	715028	0.398417
chr17	59477256	59486827	TBX2	9571	0.613207
chr17	59489111	59490641	C17orf82	1530	0.708497
chr17	59533806	59561664	TBX4	27858	0.530763
chr17	59667793	59668563	NACA2	770	0.453247
chr17	59756546	59940920	BRIP1	184374	0.359671
chr17	59942727	60005377	INTS2	62650	0.396792
chr17	60019965	60142643	MED13	122678	0.387331
chr17	60345505	60353016	TBC1D3P2	7511	0.588337
chr17	60346601	60346632	DQ571391	31	0.548387
chr17	60346610	60346639	DQ574804	29	0.517241
chr17	60347316	60347353	DQ573965	37	0.594595
chr17	60348376	60348406	DQ581615	30	0.533333
chr17	60348960	60348990	DQ575686	30	0.533333
chr17	60350170	60350203	DQ580080	33	0.575758
chr17	60447578	60493839	EFCAB3	46261	0.405395
chr17	60501245	60527454	METTL2A	26209	0.452707
chr17	60556385	60692841	TLK2	136456	0.408447
chr17	60704761	60770962	MRC2	66201	0.522364
chr17	60778674	60885705	MARCH10	107031	0.461623
chr17	60783566	60815276	BC037347	31710	0.454778
chr17	61086897	61505067	TANC2	418170	0.376837
chr17	61268699	61268734	MIR548W	35	0.342857
chr17	61509664	61523545	CYB561	13881	0.571068
chr17	61554421	61575741	ACE	21320	0.583490
chr17	61600694	61623602	KCNH6	22908	0.569932
chr17	61627795	61671642	DCAF7	43847	0.439756
chr17	61670005	61671628	BC024682	1623	0.446704
chr17	61678230	61685725	TACO1	7495	0.493262
chr17	61699800	61773670	MAP3K3	73870	0.452078
chr17	61773248	61777519	LIMD2	4271	0.636853
chr17	61777697	61780045	LOC729683	2348	0.633305
chr17	61780191	61819330	STRADA	39139	0.456092
chr17	61822609	61851088	CCDC47	28479	0.413322
chr17	61851566	61896677	DDX42	45111	0.417681
chr17	61896792	61905031	FTSJ3	8239	0.512926
chr17	61904769	61909387	PSMC5	4618	0.509744
chr17	61909440	61920351	SMARCD2	10911	0.559069
chr17	61934375	61941739	TCAM1P	7364	0.480581
chr17	61949371	61951089	CSH2	1718	0.569267
chr17	61957571	61959302	GH2	1731	0.564414
chr17	61972267	61974021	CSH1	1754	0.562714
chr17	61986964	61988618	CSHL1	1654	0.568319
chr17	61994562	61996198	GH1	1636	0.567237
chr17	62006097	62009704	CD79B	3607	0.606598
chr17	62015913	62050278	SCN4A	34365	0.561036
chr17	62075710	62081644	C17orf72	5934	0.597573
chr17	62075814	62081644	C17orf72	5830	0.595026
chr17	62079954	62097994	ICAM2	18040	0.463470
chr17	62116509	62119203	DQ572107	2694	0.452116
chr17	62120389	62207502	ERN1	87113	0.449623
chr17	62223437	62223517	SNORD104	80	0.550000
chr17	62223698	62223831	SNORA76	133	0.669173
chr17	62224794	62340653	TEX2	115859	0.435762
chr17	62396776	62407083	PECAM1	10307	0.488600
chr17	62461568	62464760	MILR1	3192	0.454261
chr17	62473901	62493184	POLG2	19283	0.413732
chr17	62494373	62502484	DDX5	8111	0.415115
chr17	62496891	62496957	MIR3064	66	0.484848
chr17	62497331	62497431	MIR5047	100	0.480000
chr17	62503157	62534062	CEP95	30905	0.401391
chr17	62540734	62658386	SMURF2	117652	0.394893
chr17	62774256	62777622	LOC146880	3366	0.675579
chr17	62780958	62833302	PLEKHM1P	52344	0.500458
chr17	62850487	62914988	LRRC37A3	64501	0.421699
chr17	62857118	62857150	DQ578599	32	0.437500
chr17	62962667	62971703	AMZ2P1	9036	0.413789
chr17	63005406	63052920	GNA13	47514	0.401124
chr17	63133455	63223821	RGS9	90366	0.477082
chr17	63524682	63557740	AXIN2	33058	0.513038
chr17	63631657	64187987	CEP112	556330	0.379487
chr17	64208146	64225556	APOH	17410	0.428145
chr17	64298925	64806862	PRKCA	507937	0.438507
chr17	64394188	64412972	BC033554	18784	0.424031
chr17	64783189	64783286	MIR634	97	0.525773
chr17	64873347	64881395	CACNG5	8048	0.502237
chr17	64960979	65029518	CACNG4	68539	0.523906
chr17	65040651	65052911	CACNG1	12260	0.503834
chr17	65066553	65241319	HELZ	174766	0.380320
chr17	65336618	65362721	PSMD12	26103	0.404015
chr17	65373396	65693379	PITPNC1	319983	0.446174
chr17	65714060	65740266	NOL11	26206	0.404297
chr17	65736785	65736917	SNORA38B	132	0.469697
chr17	65821779	65980494	BPTF	158715	0.408342
chr17	65987216	65989765	C17orf58	2549	0.495881
chr17	66016012	66016085	TRNA	73	0.602740
chr17	66031847	66042970	KPNA2	11123	0.435584
chr17	66097695	66132070	LINC00674	34375	0.436451
chr17	66194800	66196443	LOC440461	1643	0.615946
chr17	66244144	66253305	AMZ2	9161	0.424735
chr17	66255322	66417000	ARSG	161678	0.459698
chr17	66263166	66287405	SLC16A6	24239	0.440571
chr17	66417421	66453653	WIPI1	36232	0.466218
chr17	66420591	66420689	MIR635	98	0.438776
chr17	66507920	66529570	PRKAR1A	21650	0.393303
chr17	66531256	66597095	FAM20A	65839	0.446119
chr17	66863430	66951533	ABCA8	88103	0.368103
chr17	66970772	67057136	ABCA9	86364	0.376928
chr17	67074846	67138015	ABCA6	63169	0.362979
chr17	67095682	67095797	MIR4524B	115	0.443478
chr17	67095704	67095773	MIR4524A	69	0.434783
chr17	67144147	67240956	ABCA10	96809	0.360741
chr17	67209852	67210159	BC150503	307	0.400651
chr17	67240575	67323323	ABCA5	82748	0.345954
chr17	67410837	67538470	MAP2K6	127633	0.410121
chr17	67586135	67624479	BC094791	38344	0.403531
chr17	68047417	68064236	BX647864	16819	0.380700
chr17	68071365	68131746	KCNJ16	60381	0.386976
chr17	68163101	68165543	KCNJ2-AS1	2442	0.473792
chr17	68165675	68176183	KCNJ2	10508	0.398363
chr17	69093914	69198318	BC039327	104404	0.374133
chr17	70026956	70035822	D43770	8866	0.412475
chr17	70067183	70112157	AK094963	44974	0.431516
chr17	70117160	70122560	SOX9	5400	0.533518
chr17	70399462	70588943	LINC00673	189481	0.474591
chr17	70594179	70636611	LINC00511	42432	0.467548
chr17	70642084	71088853	SLC39A11	446769	0.459143
chr17	71161159	71168062	SSTR2	6903	0.495002
chr17	71189172	71204645	COG1	15473	0.484845
chr17	71203491	71228533	FAM104A	25042	0.435828
chr17	71228775	71245095	C17orf80	16320	0.437377
chr17	71244587	71258019	CPSF4L	13432	0.501638
chr17	71279762	71308143	CDC42EP4	28381	0.528840
chr17	71330522	71640227	SDK2	309705	0.523030
chr17	71745408	71824676	LINC00469	79268	0.488886
chr17	71782960	71796934	LOC400620	13974	0.475097
chr17	72199794	72206019	RPL38	6225	0.486426
chr17	72206134	72209460	MGC16275	3326	0.564943
chr17	72209695	72258157	TTYH2	48462	0.544468
chr17	72257679	72258159	Z49982	480	0.504167
chr17	72270385	72311023	DNAI2	40638	0.504183
chr17	72299777	72305929	BX648926	6152	0.517230
chr17	72322350	72325605	KIF19	3255	0.565284
chr17	72322350	72351959	KIF19	29609	0.570570
chr17	72352554	72357958	BTBD17	5404	0.584012
chr17	72363644	72368739	GPR142	5095	0.593131
chr17	72429835	72443568	GPRC5C	13733	0.528362
chr17	72462521	72480937	CD300A	18416	0.520580
chr17	72517312	72527613	CD300LB	10301	0.515969
chr17	72537204	72542310	CD300C	5106	0.585390
chr17	72576110	72588370	CD300LD	12260	0.452529
chr17	72581056	72590348	C17orf77	9292	0.432200
chr17	72606021	72619897	CD300E	13876	0.507711
chr17	72733355	72743474	RAB37	10119	0.552130
chr17	72690451	72709108	CD300LF	18657	0.486788
chr17	72744750	72765499	SLC9A3R1	20749	0.562340
chr17	72766685	72772470	NAT9	5785	0.539153
chr17	72772621	72835922	TMEM104	63301	0.543562
chr17	72838167	72856007	GRIN2C	17840	0.588341
chr17	72858618	72869156	FDXR	10538	0.581135
chr17	72873472	72889705	FADS6	16233	0.537054
chr17	72912175	72919351	USH1G	7176	0.610368
chr17	72920369	72930006	OTOP2	9637	0.540210
chr17	72931896	72946087	OTOP3	14191	0.536326
chr17	72946838	72968900	HID1	22062	0.578914
chr17	72983726	73001892	CDR2L	18166	0.538093
chr17	73008779	73017356	ICT1	8577	0.486534
chr17	73030033	73030103	JB153618	70	0.485714
chr17	73034954	73043074	ATP5H	8120	0.475862
chr17	73043278	73061981	KCTD2	18703	0.485002
chr17	73083821	73102255	SLC16A5	18434	0.562276
chr17	73106081	73126360	ARMC7	20279	0.519503
chr17	73126319	73127890	NT5C	1571	0.656906
chr17	73131343	73150775	HN1	19432	0.465469
chr17	73163824	73179098	SUMO2	15274	0.464384
chr17	73201596	73231854	NUP85	30258	0.482253
chr17	73232693	73257707	GGA3	25014	0.515271
chr17	73257748	73262457	MRPS7	4709	0.504778
chr17	73262309	73267311	MIF4GD	5002	0.557777
chr17	73267379	73269976	LOC100287042	2597	0.613015
chr17	73269060	73285530	SLC25A19	16470	0.506072
chr17	73314156	73401790	GRB2	87634	0.442237
chr17	73402149	73402243	MIR3678	94	0.446809
chr17	73452663	73496533	KIAA0195	43870	0.531890
chr17	73496340	73511664	CASKIN2	15324	0.611916
chr17	73512608	73520820	TSEN54	8212	0.538359
chr17	73521782	73571290	LLGL2	49508	0.558172
chr17	73561173	73563547	AF289551	2374	0.564027
chr17	73584138	73611965	MYO15B	27827	0.576850
chr17	73609054	73622308	MYO15B	13254	0.624264
chr17	73615717	73617256	MYO15B	1539	0.642625
chr17	73622924	73663269	RECQL5	40345	0.531788
chr17	73629513	73637486	SMIM5	7973	0.600025
chr17	73642645	73644057	SMIM6	1412	0.541785
chr17	73663398	73704139	SAP30BP	40741	0.485604
chr17	73717515	73753899	ITGB4	36384	0.579403
chr17	73754017	73761280	GALK1	7263	0.574005
chr17	73772514	73775860	H3F3B	3346	0.485057
chr17	73780601	73780688	MIR4738	87	0.540230
chr17	73780919	73821886	UNK	40967	0.508263
chr17	73823307	73840798	UNC13D	17491	0.596764
chr17	73841779	73851501	WBP2	9722	0.544024
chr17	73870244	73874656	TRIM47	4412	0.651632
chr17	73885040	73893084	TRIM65	8044	0.595351
chr17	73894723	73901181	MRPL38	6458	0.572159
chr17	73905654	73937119	FBF1	31465	0.533927
chr17	73937588	73975515	ACOX1	37927	0.443484
chr17	73996986	74002080	CDK3	5094	0.570082
chr17	74002926	74023507	EVPL	20581	0.599825
chr17	74034855	74068607	SRP68	33752	0.459232
chr17	74070891	74073573	GALR2	2682	0.649888
chr17	74075262	74078885	ZACN	3623	0.594535
chr17	74077085	74099868	EXOC7	22783	0.545714
chr17	74132414	74137380	FOXJ1	4966	0.638542
chr17	74136636	74150729	RNF157-AS1	14093	0.526148
chr17	74138533	74236390	RNF157	97857	0.449564
chr17	74151728	74151758	DQ570973	30	0.600000
chr17	74261285	74267379	UBALD2	6094	0.584345
chr17	74270129	74303761	QRICH2	33632	0.529496
chr17	74306867	74350230	PRPSAP1	43363	0.458017
chr17	74333396	74333503	U6	107	0.429907
chr17	74380689	74383941	SPHK1	3252	0.655904
chr17	74385612	74449288	UBE2O	63676	0.498854
chr17	74463629	74466199	AANAT	2570	0.615175
chr17	74466974	74497509	RHBDF2	30535	0.576683
chr17	74492855	74494871	AX747521	2016	0.591270
chr17	74523429	74533987	CYGB	10558	0.586096
chr17	74523667	74541458	PRCD	17791	0.586926
chr17	74536120	74541458	PRCD	5338	0.578119
chr17	74553859	74561430	SNHG16	7571	0.452252
chr17	74557189	74557275	SNORD1B	86	0.406977
chr17	74557714	74557788	SNORD1A	74	0.405405
chr17	74561460	74582145	ST6GALNAC2	20685	0.537249
chr17	74620844	74639894	ST6GALNAC1	19050	0.486247
chr17	74671808	74707056	MXRA7	35248	0.526952
chr17	74708913	74722881	JMJD6	13968	0.488259
chr17	74722911	74729962	METTL23	7051	0.479648
chr17	74730196	74733493	SRSF2	3297	0.493176
chr17	74733582	74775336	MFSD11	41754	0.433970
chr17	74732531	74732630	MIR636	99	0.787879
chr17	74846257	74857916	BC038218	11659	0.486577
chr17	74864797	74946471	MGAT5B	81674	0.540380
chr17	75137004	75213181	SEC14L1	76177	0.456148
chr17	75085388	75085575	SCARNA16	187	0.486631
chr17	75277491	75496678	SEPT9	219187	0.546894
chr17	75393065	75393136	MIR4316	71	0.647887
chr17	75524206	75532674	BC040189	8468	0.519013
chr17	75543022	75561103	LOC100507351	18081	0.530280
chr17	75875082	75880169	FLJ45079	5087	0.557500
chr17	76000250	76000291	septin 9/TNRC6C fusion	41	0.439024
chr17	76000317	76104916	TNRC6C	104599	0.429096
chr17	76103482	76107880	TNRC6C-AS1	4398	0.529786
chr17	76108998	76124861	TMC6	15863	0.616277
chr17	76126858	76139049	TMC8	12191	0.604544
chr17	76133918	76135809	TMC8	1891	0.618191
chr17	76142433	76162364	C17orf99	19931	0.521650
chr17	76154362	76154383	JA425978	21	0.523810
chr17	76164670	76169009	SYNGR2	4339	0.628255
chr17	76170159	76183285	TK1	13126	0.531693
chr17	76183397	76203782	AFMID	20385	0.510817
chr17	76210276	76221716	BIRC5	11440	0.492570
chr17	76220156	76220780	EPR-1	624	0.506410
chr17	76227390	76237068	TMEM235	9678	0.603224
chr17	76257429	76274573	LOC100996291	17144	0.545964
chr17	76352858	76356158	SOCS3	3300	0.622424
chr17	76374734	76420639	PGS1	45905	0.520052
chr17	76419777	76573476	DNAH17	153699	0.523556
chr17	76480991	76499138	DNAH17-AS1	18147	0.567366
chr17	76670129	76778376	CYTH1	108247	0.452576
chr17	76692775	76692879	U6	104	0.365385
chr17	76792398	76836969	USP36	44571	0.495905
chr17	76849058	76921472	TIMP2	72414	0.526017
chr17	76886661	76899299	LOC100653515	12638	0.544548
chr17	76967334	76976061	LGALS3BP	8727	0.589091
chr17	76987797	77005899	CANT1	18102	0.570710
chr17	77015290	77023737	C1QTNF1-AS1	8447	0.535575
chr17	77020157	77045870	C1QTNF1	25713	0.539960
chr17	77071018	77084685	ENGASE	13667	0.584035
chr17	77085426	77512230	RBFOX3	426804	0.552781
chr17	77230811	77420202	RBFOX3	189391	0.535875
chr17	77680984	77681058	MIR4739	74	0.689189
chr17	77681074	77686081	HP09025	5007	0.567006
chr17	77704881	77716021	ENPP7	11140	0.573250
chr17	77751976	77761449	CBX2	9473	0.585876
chr17	77768175	77770915	CBX8	2740	0.577372
chr17	77806954	77813213	CBX4	6259	0.624700
chr17	77893155	77897770	BC044939	4615	0.593933
chr17	77906141	78009657	TBC1D16	103516	0.524885
chr17	78010430	78074412	CCDC40	63982	0.506674
chr17	78075354	78093679	GAA	18325	0.583301
chr17	78109012	78120982	EIF4A3	11970	0.462322
chr17	78152306	78183130	CARD14	30824	0.551226
chr17	78183078	78194199	SGSH	11121	0.586278
chr17	78194199	78227308	SLC26A11	33109	0.531547
chr17	78234659	78372581	RNF213	137922	0.499318
chr17	78325630	78388968	LOC100294362	63338	0.481386
chr17	78388966	78411884	ENDOV	22918	0.564665
chr17	78393217	78393293	MIR4730	76	0.657895
chr17	78437250	78439393	AX746631	2143	0.577228
chr17	78440632	78450404	NPTX1	9772	0.581560
chr17	78518624	78940173	RPTOR	421549	0.491177
chr17	78940038	78945013	AK127919	4975	0.609447
chr17	78965640	78973933	CHMP6	8293	0.631376
chr17	78977134	78978830	AF258550	1696	0.629717
chr17	79002932	79008519	BAIAP2-AS1	5587	0.584929
chr17	79008946	79091232	BAIAP2	82286	0.606823
chr17	79091095	79139872	AATK	48777	0.614203
chr17	79099075	79099173	MIR657	98	0.622449
chr17	79099676	79099755	MIR3065	79	0.506329
chr17	79099682	79099749	MIR338	67	0.462687
chr17	79106995	79107108	MIR1250	113	0.575221
chr17	79139306	79155778	AATK-AS1	16472	0.563441
chr17	79163392	79196751	AZI1	33359	0.597020
chr17	79202076	79212891	ENTHD2	10815	0.629311
chr17	79202506	79207783	AL832593	5277	0.645822
chr17	79213110	79215098	C17orf89	1988	0.588531
chr17	79218798	79269096	SLC38A10	50298	0.566603
chr17	79276623	79283048	LINC00482	6425	0.620856
chr17	79285071	79304474	TMEM105	19403	0.587641
chr17	79349698	79359160	LOC100130370	9462	0.595223
chr17	79373539	79433358	BAHCC1	59819	0.629616
chr17	79374515	79374578	MIR4740	63	0.682540
chr17	79418129	79418214	MIR3186	85	0.564706
chr17	79476996	79479892	ACTG1	2896	0.587362
chr17	79495416	79504156	FSCN2	8740	0.598970
chr17	79506910	79519429	C17orf70	12519	0.614586
chr17	79523912	79536137	NPLOC4	12225	0.517628
chr17	79523912	79604138	NPLOC4	80226	0.492546
chr17	79609332	79615779	TSPAN10	6447	0.595781
chr17	79617488	79623607	PDE6G	6119	0.603530
chr17	79632065	79633618	OXLD1	1553	0.617514
chr17	79633760	79640936	CCDC137	7176	0.570234
chr17	79648223	79650954	ARL16	2731	0.569755
chr17	79650961	79669151	HGS	18190	0.602254
chr17	79679265	79688046	SLC25A10	8781	0.633869
chr17	79762009	79771889	GCGR	9880	0.659919
chr17	79780292	79791167	FAM195B	10875	0.597425
chr17	79791367	79792926	PPP1R27	1559	0.611931
chr17	79801033	79818544	P4HB	17511	0.557821
chr17	79825596	79826845	AK293147	1249	0.656525
chr17	79825596	79829282	ARHGDIA	3686	0.681226
chr17	79845710	79849462	ALYREF	3752	0.575426
chr17	79849598	79858363	ANAPC11	8765	0.532230
chr17	79860071	79860781	NPB	710	0.746479
chr17	79860776	79869340	PCYT2	8564	0.640121
chr17	79869814	79876058	SIRT7	6244	0.577354
chr17	79876144	79881444	MAFG	5300	0.569434
chr17	79885704	79888629	MAFG-AS1	2925	0.655385
chr17	79890268	79894968	PYCR1	4700	0.616596
chr17	79897520	79905109	MYADML2	7589	0.554750
chr17	79910382	79919057	NOTUM	8675	0.630548
chr17	79935425	79975282	ASPSCR1	39857	0.606192
chr17	79976578	79980785	STRA13	4207	0.640361
chr17	79981279	79989027	LRRC45	7748	0.648038
chr17	79989531	79992080	RAC3	2549	0.685367
chr17	79993756	79995573	DCXR	1817	0.669785
chr17	80005777	80009650	RFNG	3873	0.668990
chr17	80009762	80015346	GPS1	5584	0.651862
chr17	80015747	80023697	DUS1L	7950	0.644025
chr17	80036213	80056106	FASN	19893	0.666365
chr17	80059345	80170689	CCDC57	111344	0.518160
chr17	80186281	80197375	SLC16A3	11094	0.665044
chr17	80200536	80231594	CSNK1D	31058	0.543435
chr17	80247921	80250690	BC033560	2769	0.533406
chr17	80272745	80275480	CD7	2735	0.658135
chr17	80278899	80291921	SECTM1	13022	0.633159
chr17	80317122	80321652	TEX19	4530	0.563797
chr17	80332200	80333370	UTS2R	1170	0.723932
chr17	80338986	80340511	AF075112	1525	0.495738
chr17	80347085	80376513	OGFOD3	29428	0.543258
chr17	80376251	80400516	HEXDC	24265	0.550752
chr17	80400462	80408707	C17orf62	8245	0.604245
chr17	80400462	80408707	C17orf62	8245	0.604245
chr17	80416539	80446143	NARF	29604	0.513410
chr17	80477593	80562483	FOXK2	84890	0.500636
chr17	80572437	80606411	WDR45B	33974	0.493289
chr17	80614942	80656598	RAB40B	41656	0.530824
chr17	80674581	80685893	FN3KRP	11312	0.529880
chr17	80693451	80709073	FN3K	15622	0.513251
chr17	80709939	80901062	TBCD	191123	0.529120
chr17	80787309	80797931	ZNF750	10622	0.490962
chr17	80901666	81009686	B3GNTL1	108020	0.502342
chr17	80905007	80907404	B3GNTL1	2397	0.508970
chr17	81037566	81052591	METRNL	15025	0.633078
chr17	81174665	81188573	FLJ43681	13908	0.417529
chr18	102908	112287	DUX4	9379	0.481608
chr18	109064	122222	ROCK1P1	13158	0.407433
chr18	158482	213739	USP14	55257	0.380241
chr18	214519	268059	THOC1	53540	0.373142
chr18	319354	500729	COLEC12	181375	0.430677
chr18	580368	581524	CETN1	1156	0.496540
chr18	616699	650293	CLUL1	33594	0.407245
chr18	649619	658340	C18orf56	8721	0.445362
chr18	657603	673499	TYMS	15896	0.458103
chr18	670323	712662	ENOSF1	42339	0.460875
chr18	721591	812327	YES1	90736	0.399125
chr18	905196	912173	ADCYAP1	6977	0.526301
chr18	1268311	1359630	LINC00470	91319	0.370197
chr18	1323794	1324086	7SK	292	0.537671
chr18	2537523	2571489	METTL4	33966	0.367632
chr18	2571509	2616634	NDC80	45125	0.363568
chr18	2652168	2655394	CBX3P2	3226	0.408246
chr18	2655885	2805015	SMCHD1	149130	0.367632
chr18	2847027	2914090	EMILIN2	67063	0.473659
chr18	2916991	3011945	LPIN2	94954	0.413484
chr18	2943212	2946621	LOC727896	3409	0.361396
chr18	3066804	3220106	MYOM1	153302	0.405546
chr18	3247527	3256234	MYL12A	8707	0.386356
chr18	3262110	3278282	MYL12B	16172	0.399580
chr18	3451590	3458406	TGIF1	6816	0.445129
chr18	3473959	3478974	AX721193	5015	0.456231
chr18	3496029	4455266	DLGAP1	959237	0.396651
chr18	3594111	3597377	DLGAP1-AS1	3266	0.473362
chr18	3603735	3608323	BC094703	4588	0.428945
chr18	3878179	3897069	DLGAP1-AS3	18890	0.431286
chr18	3962352	4013943	DLGAP1-AS4	51591	0.393828
chr18	4264601	4296000	DLGAP1-AS5	31399	0.372846
chr18	5143671	5197255	C18orf42	53584	0.391665
chr18	5232874	5238525	LOC339290	5651	0.405769
chr18	5236722	5238028	LINC00526	1306	0.493874
chr18	5238098	5246505	LINC00667	8407	0.409540
chr18	5289017	5296194	ZBTB14	7177	0.465654
chr18	5392387	5543986	EPB41L3	151599	0.396790
chr18	5579412	5579484	SNORD112	72	0.319444
chr18	5748817	5795900	LOC645355	47083	0.405943
chr18	5840693	5840832	MIR3976	139	0.402878
chr18	5890183	5892103	TMEM200C	1920	0.703646
chr18	5954704	6414910	L3MBTL4	460206	0.399378
chr18	6017721	6017838	U5	117	0.427350
chr18	6256745	6260933	BC040631	4188	0.443171
chr18	6374359	6374424	MIR4317	65	0.369231
chr18	6511414	6590652	LOC100130480	79238	0.400136
chr18	6834431	6915712	ARHGAP28	81281	0.396575
chr18	6925476	6928551	LINC00668	3075	0.449756
chr18	6941742	7117813	LAMA1	176071	0.431360
chr18	7231136	7232042	LRRC30	906	0.581678
chr18	7567313	8406859	PTPRM	839546	0.400758
chr18	8253936	8253967	SNORD5	31	0.354839
chr18	8360817	8367032	LOC100192426	6215	0.454706
chr18	8609442	8639380	RAB12	29938	0.422239
chr18	8717368	8832775	SOGA2	115407	0.452832
chr18	9102627	9134343	NDUFV2	31716	0.373534
chr18	9136750	9285983	ANKRD12	149233	0.372190
chr18	9334764	9402418	TWSG1	67654	0.384530
chr18	9475529	9538106	RALBP1	62577	0.411589
chr18	9518116	9518258	U2	142	0.478873
chr18	9546788	9614605	PPP4R1	67817	0.387676
chr18	9708227	9862553	RAB31	154326	0.436103
chr18	9885722	9888156	TXNDC2	2434	0.509860
chr18	9913954	9960018	VAPA	46064	0.371657
chr18	10244400	10247598	AX747048	3198	0.515322
chr18	10454624	10488698	APCDD1	34074	0.461496
chr18	10525872	10552766	NAPG	26894	0.393545
chr18	10670243	11148761	PIEZO2	478518	0.409855
chr18	11653952	11653986	DQ594439	34	0.382353
chr18	11653987	11654031	DQ585728	44	0.545455
chr18	11654627	11654658	DQ586209	31	0.451613
chr18	11654683	11654715	DQ584035	32	0.468750
chr18	11654903	11654975	DQ576414	72	0.513889
chr18	11655824	11655865	DQ572814	41	0.317073
chr18	11656346	11656375	DQ578665	29	0.413793
chr18	11656509	11656546	DQ588121	37	0.486486
chr18	11656639	11656677	DQ582047	38	0.526316
chr18	11656888	11656922	DQ596967	34	0.470588
chr18	11657097	11657127	DQ583379	30	0.533333
chr18	11659556	11659590	DQ577739	34	0.617647
chr18	11659651	11659693	DQ586641	42	0.500000
chr18	11660051	11660108	DQ584777	57	0.438596
chr18	11660550	11660595	DQ596015	45	0.600000
chr18	11660683	11660726	DQ591120	43	0.511628
chr18	11660801	11660840	DQ584752	39	0.589744
chr18	11660916	11661053	DQ599577	137	0.562044
chr18	11661091	11661121	DQ594388	30	0.533333
chr18	11661164	11661195	DQ576785	31	0.451613
chr18	11661897	11661927	DQ571750	30	0.433333
chr18	11662268	11662298	DQ595824	30	0.400000
chr18	11662566	11662596	DQ587169	30	0.433333
chr18	11662623	11662660	DQ590893	37	0.459459
chr18	11662671	11662710	DQ589220	39	0.435897
chr18	11662761	11662792	DQ577471	31	0.451613
chr18	11663265	11663305	DQ600032	40	0.425000
chr18	11663317	11663348	DQ575585	31	0.548387
chr18	11663396	11663431	DQ594539	35	0.542857
chr18	11663676	11663715	DQ597648	39	0.538462
chr18	11663724	11663763	DQ588286	39	0.487179
chr18	11663871	11663927	DQ579207	56	0.482143
chr18	11664049	11664097	DQ578037	48	0.479167
chr18	11664164	11664207	DQ591184	43	0.418605
chr18	11664378	11664427	DQ599038	49	0.510204
chr18	11664473	11664506	DQ587882	33	0.545455
chr18	11664546	11664579	DQ590984	33	0.454545
chr18	11664671	11664718	DQ581117	47	0.553191
chr18	11664753	11664799	DQ570920	46	0.478261
chr18	11664903	11664941	DQ600844	38	0.473684
chr18	11665143	11665207	DQ588090	64	0.546875
chr18	11665326	11665356	DQ570262	30	0.500000
chr18	11665944	11665975	DQ573573	31	0.419355
chr18	11667621	11668372	DQ575348	751	0.467377
chr18	11670978	11671031	DQ577323	53	0.452830
chr18	11671618	11671648	DQ589620	30	0.566667
chr18	11672275	11672326	DQ579650	51	0.627451
chr18	11672358	11672424	DQ582489	66	0.590909
chr18	11672614	11672644	DQ600527	30	0.400000
chr18	11689013	11885683	GNAL	196670	0.441409
chr18	11851388	11854448	CHMP1B	3060	0.415033
chr18	11883471	11908796	MPPE1	25325	0.458243
chr18	11981426	12030885	IMPA2	49459	0.490548
chr18	12093847	12129748	ANKRD62	35901	0.364196
chr18	12200777	12224709	C18orf61	23932	0.415302
chr18	12254317	12277594	CIDEA	23277	0.491429
chr18	12308256	12326568	TUBB6	18312	0.456804
chr18	12328942	12377275	AFG3L2	48333	0.446755
chr18	12407894	12432236	SLMO1	24342	0.505916
chr18	12446510	12657912	SPIRE1	211402	0.406174
chr18	12702986	12725739	PSMG2	22753	0.427724
chr18	12672625	12702776	CEP76	30151	0.401081
chr18	12792300	12884334	PTPN2	92034	0.410794
chr18	12947982	12987536	SEH1L	39554	0.431309
chr18	12991360	13125051	CEP192	133691	0.404373
chr18	13203772	13216366	BC041855	12594	0.446403
chr18	13218728	13652753	LDLRAD4	434025	0.463499
chr18	13419497	13427533	LDLRAD4-AS1	8036	0.481956
chr18	13457207	13459158	AX748268	1951	0.507945
chr18	13459945	13460025	MIR5190	80	0.612500
chr18	13611112	13611199	MIR4526	87	0.655172
chr18	13663345	13726591	FAM210A	63246	0.406128
chr18	13726703	13764554	RNMT	37851	0.389924
chr18	13825542	13826861	MC5R	1319	0.510993
chr18	13882042	13915535	MC2R	33493	0.427671
chr18	14089933	14091018	BC034578	1085	0.465438
chr18	14099941	14132489	ZNF519	32548	0.383833
chr18	14179095	14185386	ANKRD20A5P	6291	0.370529
chr18	14183927	14189106	ANKRD20A5P	5179	0.354702
chr18	14252124	14252151	DQ593719	27	0.555556
chr18	14252894	14252924	DQ587539	30	0.566667
chr18	14253150	14253180	DQ590589	30	0.566667
chr18	14254168	14254198	DQ590126	30	0.433333
chr18	14335120	14335148	DQ596206	28	0.500000
chr18	14337421	14342523	CYP4F35P	5102	0.507840
chr18	14477953	14498705	CXADRP3	20752	0.389119
chr18	14501705	14501737	DQ573684	32	0.468750
chr18	14502348	14502376	DQ583164	28	0.464286
chr18	14502661	14502696	DQ582260	35	0.571429
chr18	14504308	14504348	DQ595048	40	0.575000
chr18	14511736	14543599	POTEC	31863	0.367480
chr18	14748238	14852737	ANKRD30B	104499	0.352501
chr18	14830164	14830241	MIR3156-2	77	0.428571
chr18	15313554	15325918	LOC644669	12364	0.362261
chr18	18529702	18691812	ROCK1	162110	0.368676
chr18	18822202	19102791	GREB1L	280589	0.405932
chr18	19109261	19180693	ESCO1	71432	0.410656
chr18	19192259	19210208	SNRPD1	17949	0.425650
chr18	19230857	19284766	ABHD3	53909	0.424530
chr18	19263470	19263558	MIR320C1	88	0.420455
chr18	19321544	19450912	MIB1	129368	0.369612
chr18	19405447	19411359	mir-133b	5912	0.319689
chr18	19746858	19748929	LOC100128893	2071	0.500241
chr18	19749403	19782491	GATA6	33088	0.447564
chr18	19993563	19997878	CTAGE1	4315	0.381460
chr18	20513294	20606449	RBBP8	93155	0.380742
chr18	20715726	20840434	CABLES1	124708	0.481886
chr18	20875978	21017925	TMEM241	141947	0.435874
chr18	21032786	21063099	RIOK3	30313	0.416059
chr18	21083433	21111771	C18orf8	28338	0.451373
chr18	21111462	21166581	NPC1	55119	0.447994
chr18	21179977	21242849	ANKRD29	62872	0.444761
chr18	21269561	21535029	LAMA3	265468	0.424465
chr18	21594383	21715574	TTC39C	121191	0.413752
chr18	21718954	21741564	CABYR	22610	0.433348
chr18	21742010	21977833	OSBPL1A	235823	0.408654
chr18	21901649	21901699	MIR320C2	50	0.480000
chr18	22006608	22033494	IMPACT	26886	0.383136
chr18	22040592	22059921	HRH4	19329	0.424233
chr18	22208145	22242162	LOC729950	34017	0.412117
chr18	22641887	22932214	ZNF521	290327	0.380757
chr18	23596216	23670611	SS18	74395	0.349728
chr18	23713815	23773319	PSMA8	59504	0.379874
chr18	23806408	23971650	TAF4B	165242	0.386161
chr18	24034873	24128500	KCTD1	93627	0.426138
chr18	24267584	24283602	LOC728606	16018	0.405669
chr18	24432007	24445716	AQP4	13709	0.400029
chr18	24445271	24515910	AQP4-AS1	70639	0.403516
chr18	24495594	24765302	CHST9	269708	0.383348
chr18	24916342	25175128	AK127888	258786	0.374043
chr18	25530929	25757445	CDH2	226516	0.372256
chr18	27878875	27878926	MIR302F	51	0.313726
chr18	28570051	28622781	DSC3	52730	0.362033
chr18	28645941	28682388	DSC2	36447	0.367794
chr18	28709213	28742819	DSC1	33606	0.352110
chr18	28711418	28712454	BC042382	1036	0.410232
chr18	28898051	28937393	DSG1	39342	0.361065
chr18	28925324	28925430	U6	106	0.377358
chr18	28956739	28993880	DSG4	37141	0.370722
chr18	29027731	29058665	DSG3	30934	0.374701
chr18	29078026	29128814	DSG2	50788	0.392829
chr18	29122108	29136874	LOC100652770	14766	0.401801
chr18	29171729	29178986	TTR	7257	0.417941
chr18	29202208	29264686	B4GALT6	62478	0.384871
chr18	29339658	29340843	SLC25A52	1185	0.439662
chr18	29409135	29523091	TRAPPC8	113956	0.378506
chr18	29598444	29653154	RNF125	54710	0.424639
chr18	29672568	29711524	RNF138	38956	0.394907
chr18	29769986	29800366	MEP1B	30380	0.396379
chr18	29843483	30050447	GAREM	206964	0.389261
chr18	30091625	30094597	WBP11P1	2972	0.446164
chr18	30252633	30352974	KLHL14	100341	0.389910
chr18	30517365	31020045	CCDC178	502680	0.348508
chr18	31158540	31327399	ASXL3	168859	0.360751
chr18	31431063	31803515	NOL4	372452	0.347997
chr18	32335939	32471808	DTNA	135869	0.385577
chr18	32558207	32723432	MAPRE2	165225	0.392888
chr18	32820993	32827153	ZNF397	6160	0.408766
chr18	32831022	32870196	ZSCAN30	39174	0.423419
chr18	32870235	32890730	ZNF271	20495	0.389656
chr18	32912177	32924426	ZNF24	12249	0.391052
chr18	32946660	32957301	ZNF396	10641	0.426840
chr18	33048290	33077955	INO80C	29665	0.417900
chr18	33234532	33291798	GALNT1	57266	0.375336
chr18	33171700	33171770	MIR3975	70	0.400000
chr18	33484780	33484889	MIR187	109	0.651376
chr18	33552587	33559250	C18orf21	6663	0.411676
chr18	33569791	33647373	RPRD1A	77582	0.383813
chr18	33688493	33709357	SLC39A6	20864	0.394555
chr18	33709836	33754688	ELP2	44852	0.399826
chr18	33759963	33767398	BC009735	7435	0.520646
chr18	33767479	33848685	MOCOS	81206	0.427197
chr18	33877701	34360018	FHOD3	482317	0.430541
chr18	34366446	34409179	TPGS2	42733	0.425760
chr18	34409079	34805288	KIAA1328	396209	0.370211
chr18	34481907	34503777	BC037214	21870	0.354275
chr18	34823007	35146000	CELF4	322993	0.523541
chr18	34851240	34854641	CELF4	3401	0.541899
chr18	35237097	35237178	MIR4318	81	0.456790
chr18	36613970	36614074	U6	104	0.384615
chr18	36786887	36920602	LINC00669	133715	0.370848
chr18	37256682	37256741	MIR5583-2	59	0.338983
chr18	37256684	37256743	MIR5583-1	59	0.338983
chr18	37421137	37504804	AK309717	83667	0.372417
chr18	37646249	37679197	BC045816	32948	0.376502
chr18	39060235	39100561	KC6	40326	0.360809
chr18	39535198	39661446	PIK3C3	126248	0.352346
chr18	39766632	40098918	LINC00907	332286	0.382854
chr18	40323182	40695657	RIT2	372475	0.356781
chr18	40847856	40857615	SYT4	9759	0.348089
chr18	41903399	42111662	BC051727	208263	0.370844
chr18	42260862	42648475	SETBP1	387613	0.421609
chr18	42550046	42550131	MIR4319	85	0.529412
chr18	42792946	43263060	SLC14A2	470114	0.428805
chr18	43018150	43083789	AK126075	65639	0.422173
chr18	43063309	43109820	BC038429	46511	0.431597
chr18	43304091	43332485	SLC14A1	28394	0.430901
chr18	43405544	43422521	SIGLEC15	16977	0.537963
chr18	43427573	43547305	EPG5	119732	0.408755
chr18	43563501	43652250	PSTPIP2	88749	0.427509
chr18	43569618	43569911	7SK	293	0.501706
chr18	43664109	43678319	ATP5A1	14210	0.429134
chr18	43684297	43708299	HAUS1	24002	0.413216
chr18	43753987	43846955	C18orf25	92968	0.404623
chr18	43914186	44040783	RNF165	126597	0.490833
chr18	43914642	43917090	C18orf23	2448	0.478758
chr18	44057216	44236996	LOXHD1	179780	0.453777
chr18	44247784	44250252	AK095045	2468	0.528768
chr18	44259080	44337039	ST8SIA5	77959	0.472402
chr18	44390022	44497495	PIAS2	107473	0.382096
chr18	44526786	44628614	KATNAL2	101828	0.442806
chr18	44542730	44544607	TCEB3CL2	1877	0.647842
chr18	44548657	44550534	TCEB3CL2	1877	0.647842
chr18	44554572	44556449	TCEB3C	1877	0.647842
chr18	44558942	44561988	TCEB3B	3046	0.571898
chr18	44633780	44676871	HDHD2	43091	0.386554
chr18	44681389	44702745	IER3IP1	21356	0.387760
chr18	44738459	44775554	SKOR2	37095	0.406955
chr18	44760812	44760919	U6	107	0.373832
chr18	44812094	45120918	BC040860	308824	0.443777
chr18	45251677	45251903	7SK	226	0.469027
chr18	45359465	45457517	SMAD2	98052	0.366204
chr18	45553638	45663680	ZBTB7C	110042	0.488968
chr18	45918961	45919021	U7	60	0.400000
chr18	46065426	46389586	CTIF	324160	0.503430
chr18	46196970	46197039	MIR4743	69	0.536232
chr18	46446222	46477081	SMAD7	30859	0.520594
chr18	46570171	46987079	DYM	416908	0.385044
chr18	46576056	46576138	MIR4744	82	0.365854
chr18	47007547	47013644	C18orf32	6097	0.431524
chr18	47007547	47017954	RPL17-C18orf32	10407	0.423753
chr18	47013742	47013792	MIR1539	50	0.700000
chr18	47015604	47015694	SNORD58C	90	0.377778
chr18	47017652	47017717	SNORD58A	65	0.384615
chr18	47088426	47119278	LIPG	30852	0.483858
chr18	47309873	47340251	ACAA2	30378	0.394364
chr18	47340392	47340813	SCARNA17	421	0.629454
chr18	47349155	47721451	MYO5B	372296	0.444947
chr18	47652868	47652933	MIR4320	65	0.461538
chr18	47753562	47792865	CCDC11	39303	0.411801
chr18	47795215	47808144	MBD1	12929	0.490138
chr18	47808712	47814692	CXXC1	5980	0.592977
chr18	47901391	47920538	SKA1	19147	0.393795
chr18	48086483	48258196	MAPK4	171713	0.457473
chr18	48321489	48346434	MRO	24945	0.440930
chr18	48405431	48476162	ME2	70731	0.386450
chr18	48494386	48514490	ELAC1	20104	0.417131
chr18	48556582	48611411	SMAD4	54829	0.376170
chr18	48700919	48724051	MEX3C	23132	0.400787
chr18	48918411	48994748	LOC100287225	76337	0.398889
chr18	49866541	51062273	DCC	1195732	0.370151
chr18	51105992	51107426	BC034434	1434	0.336123
chr18	51677970	51751158	MBD2	73188	0.392359
chr18	51748653	51748782	SNORA37	129	0.542636
chr18	51795848	51824604	POLI	28756	0.356621
chr18	51851061	51880943	STARD6	29882	0.375778
chr18	51885143	51908404	C18orf54	23261	0.331069
chr18	52258389	52266724	DYNAP	8335	0.369766
chr18	52495707	52562747	RAB27B	67040	0.374553
chr18	52568739	52626739	CCDC68	58000	0.397655
chr18	52773134	52791537	AK093940	18403	0.402163
chr18	52889561	53303188	TCF4	413627	0.376844
chr18	52942849	53068756	TCF4	125907	0.373133
chr18	53146451	53146529	MIR4529	78	0.512821
chr18	53443957	53448952	AK127787	4995	0.430230
chr18	53746624	53746825	SNORA73	201	0.507463
chr18	53750586	53804767	LOC100505474	54181	0.388346
chr18	54270052	54306270	TXNL1	36218	0.374565
chr18	54318615	54697036	WDR7	378421	0.362379
chr18	54624500	54624700	U3	200	0.460000
chr18	54721803	54739350	LINC-ROR	17547	0.473813
chr18	54814292	54817639	BOD1L2	3347	0.456229
chr18	55019720	55036161	ST8SIA3	16441	0.420716
chr18	55102916	55158530	ONECUT2	55614	0.440752
chr18	55212072	55253969	FECH	41897	0.428002
chr18	55267893	55289177	NARS	21284	0.425484
chr18	55297533	55336508	LOC100505549	38975	0.444208
chr18	55313658	55470327	ATP8B1	156669	0.429913
chr18	55711609	56068772	NEDD4L	357163	0.433600
chr18	56118305	56118390	MIR122	85	0.435294
chr18	56118311	56118384	MIR3591	73	0.410959
chr18	56148481	56296189	ALPK2	147708	0.443761
chr18	56338617	56417370	MALT1	78753	0.389991
chr18	56472499	56472606	U6	107	0.392523
chr18	56530060	56653709	ZNF532	123649	0.433453
chr18	56593428	56593528	U2	100	0.360000
chr18	56702970	56720446	OACYLP	17476	0.460403
chr18	56807124	56826063	SEC11C	18939	0.429748
chr18	56887399	56898002	GRP	10603	0.422428
chr18	56934266	56940625	RAX	6359	0.548828
chr18	56962635	56985881	CPLX4	23246	0.433064
chr18	56995055	57026508	LMAN1	31453	0.369154
chr18	57098170	57364644	CCBE1	266474	0.427757
chr18	57567191	57571538	PMAIP1	4347	0.397976
chr18	57685856	57685963	U6	107	0.401869
chr18	58038563	58040001	MC4R	1438	0.450626
chr18	59157634	59222365	CDH20	64731	0.414546
chr18	59415408	59421928	LOC100996669	6520	0.473773
chr18	59482303	59560304	RNF152	78001	0.424751
chr18	59711457	59828618	PIGN	117161	0.356262
chr18	59854523	59974355	KIAA1468	119832	0.346627
chr18	59992519	60054943	TNFRSF11A	62424	0.448001
chr18	60190657	60245818	ZCCHC2	55161	0.407752
chr18	60249037	60253962	DKFZp451A185	4925	0.478173
chr18	60382671	60647676	PHLPP1	265005	0.394740
chr18	60790578	60986613	BCL2	196035	0.426485
chr18	60994970	61034506	KDSR	39536	0.420857
chr18	61056424	61089752	VPS4B	33328	0.392223
chr18	61144143	61172318	SERPINB5	28175	0.417498
chr18	61223392	61234244	SERPINB12	10852	0.423332
chr18	61254533	61266433	SERPINB13	11900	0.398992
chr18	61322430	61329197	SERPINB3	6767	0.380523
chr18	61370084	61391122	SERPINB11	21038	0.377602
chr18	61420280	61472610	SERPINB7	52330	0.372922
chr18	61554938	61571124	SERPINB2	16186	0.384344
chr18	61616587	61627645	HMSD	11058	0.374570
chr18	61637262	61656608	SERPINB8	19346	0.424894
chr18	61747242	61765874	LINC00305	18632	0.376449
chr18	61771324	62090827	LOC284294	319503	0.382040
chr18	61880317	61927290	LOC400654	46973	0.380027
chr18	63417487	63548175	CDH7	130688	0.354485
chr18	64168423	64271375	CDH19	102952	0.323063
chr18	64748820	64748923	MIR5011	103	0.398058
chr18	65173818	65183967	DSEL	10149	0.405951
chr18	65183782	65566856	LOC643542	383074	0.353464
chr18	66340924	66382353	TMX3	41429	0.360472
chr18	66382490	66722426	CCDC102B	339936	0.350484
chr18	67068283	67516322	DOK6	448039	0.361727
chr18	67530192	67624232	CD226	94040	0.403499
chr18	67671042	67872962	RTTN	201920	0.367542
chr18	67956136	67997434	SOCS6	41298	0.392029
chr18	69187199	69246192	LOC100505776	58993	0.341447
chr18	70203914	70211723	CBLN2	7809	0.494301
chr18	70409548	70534810	NETO1	125262	0.366663
chr18	70821292	70931733	LOC400655	110441	0.356018
chr18	70992175	71017124	LOC100505817	24949	0.378853
chr18	71740587	71815100	FBXO15	74513	0.405433
chr18	71815745	71826204	TIMM21	10459	0.424324
chr18	71920526	71959251	CYB5A	38725	0.444209
chr18	71983109	72026422	C18orf63	43313	0.366126
chr18	72102962	72124503	FAM69C	21541	0.492503
chr18	72163499	72190689	CNDP2	27190	0.509268
chr18	72163499	72168707	CNDP2	5208	0.476382
chr18	72201691	72252261	CNDP1	50570	0.462507
chr18	72225645	72227303	BC047599	1658	0.525935
chr18	72259009	72265071	LINC00909	6062	0.402507
chr18	72342922	72777628	ZNF407	434706	0.377085
chr18	72909277	72921281	ZADH2	12004	0.474342
chr18	72922709	73001905	TSHZ1	79196	0.445793
chr18	73121826	73139589	SMIM21	17763	0.415470
chr18	73408033	73424340	BC037384	16307	0.390384
chr18	73834952	73857210	LOC339298	22258	0.428879
chr18	74069636	74207146	ZNF516	137510	0.475907
chr18	74207476	74210045	FLJ44313	2569	0.476061
chr18	74240611	74271784	LINC00908	31173	0.457415
chr18	74401985	74405592	FLJ44881	3607	0.431661
chr18	74411558	74412561	BC070490	1003	0.474576
chr18	74506687	74534251	LOC100131655	27564	0.462415
chr18	74536115	74682682	ZNF236	146567	0.421637
chr18	74690788	74844774	MBP	153986	0.481940
chr18	74962007	74982096	GALR1	20089	0.456718
chr18	76740274	76758969	SALL3	18695	0.473817
chr18	76829396	77138282	ATP9B	308886	0.418141
chr18	77160325	77289323	NFATC1	128998	0.566714
chr18	77439800	77514510	CTDP1	74710	0.533757
chr18	77623667	77659816	KCNG2	36149	0.537027
chr18	77662419	77711653	PQLC1	49234	0.529329
chr18	77674211	77676055	AX746671	1844	0.614425
chr18	77724581	77730822	HSBP1L1	6241	0.504567
chr18	77732866	77748532	TXNL4A	15666	0.459913
chr18	77794345	77810652	RBFA	16307	0.485681
chr18	77827255	77839206	RBFADN	11951	0.491005
chr18	77866914	77898228	ADNP2	31314	0.423996
chr18	77905806	77929616	PARD6G-AS1	23810	0.483914
chr18	77915116	78005397	PARD6G	90281	0.474928
chr19	60950	70966	WASH5P	10016	0.511781
chr19	76219	77690	FAM138F	1471	0.508498
chr19	110678	111596	OR4F17	918	0.430283
chr19	197015	202209	FLJ45445	5194	0.640932
chr19	204884	204945	DQ600587	61	0.557377
chr19	205024	205055	DQ574670	31	0.580645
chr19	209328	209356	DQ593908	28	0.535714
chr19	281043	291169	PPAP2C	10126	0.542366
chr19	305574	344791	MIER2	39217	0.536655
chr19	362056	376013	THEG	13957	0.544100
chr19	405442	409170	C2CD4C	3728	0.684013
chr19	416582	460996	SHC2	44414	0.586910
chr19	463345	474983	ODF3L2	11638	0.585840
chr19	496489	505343	MADCAM1	8854	0.590016
chr19	507496	519654	TPGS1	12158	0.617207
chr19	531732	542087	CDC34	10355	0.646934
chr19	544033	549920	GZMM	5887	0.607270
chr19	572453	583493	BSG	11040	0.634873
chr19	589892	617159	HCN2	27267	0.631459
chr19	617222	633568	POLRMT	16346	0.611465
chr19	639925	643604	FGF22	3679	0.677630
chr19	647525	663233	RNF126	15708	0.634899
chr19	676388	683392	FSTL3	7004	0.649486
chr19	685545	695461	PRSS57	9916	0.568778
chr19	708952	748330	PALM	39378	0.596399
chr19	751145	764318	MISP	13173	0.566158
chr19	797391	812327	PTBP1	14936	0.609936
chr19	804939	805001	MIR4745	62	0.806452
chr19	812487	821952	LPPR3	9465	0.614052
chr19	813583	813653	MIR3187	70	0.700000
chr19	827830	832017	AZU1	4187	0.607356
chr19	840984	848175	PRTN3	7191	0.580448
chr19	852290	856246	ELANE	3956	0.587968
chr19	859664	863610	CFD	3946	0.663963
chr19	867961	893218	MED16	25257	0.627232
chr19	893483	893590	U6	107	0.457944
chr19	896502	913225	R3HDM4	16723	0.588949
chr19	917341	921015	KISS1R	3674	0.695700
chr19	926036	972803	ARID3A	46767	0.589668
chr19	984327	994569	WDR18	10242	0.629955
chr19	1000436	1009723	GRIN3B	9287	0.649187
chr19	1006167	1009551	FLJ00277	3384	0.667553
chr19	1009649	1021141	TMEM259	11492	0.656718
chr19	1026297	1039064	CNN2	12767	0.600141
chr19	1040101	1065570	ABCA7	25469	0.604853
chr19	1065921	1086627	HMHA1	20706	0.616295
chr19	1086577	1095391	POLR2E	8814	0.614817
chr19	1104648	1106787	GPX4	2139	0.670407
chr19	1107632	1174282	SBNO2	66650	0.631748
chr19	1205797	1228434	STK11	22637	0.621946
chr19	1229946	1237990	C19orf26	8044	0.688215
chr19	1241748	1244824	ATP5D	3076	0.629389
chr19	1248551	1259142	MIDN	10591	0.659617
chr19	1267469	1270259	CIRBP-AS1	2790	0.652330
chr19	1269266	1273171	CIRBP	3905	0.581818
chr19	1275519	1279243	C19orf24	3724	0.634533
chr19	1276019	1279243	C19orf24	3224	0.617556
chr19	1286152	1301429	EFNA2	15277	0.633567
chr19	1354975	1378430	MUM1	23455	0.527009
chr19	1383706	1395588	NDUFS7	11882	0.595943
chr19	1392168	1396466	AK126693	4298	0.630293
chr19	1397809	1401569	GAMT	3760	0.638830
chr19	1407583	1435682	DAZAP1	28099	0.587281
chr19	1438362	1440492	RPS15	2130	0.627230
chr19	1450147	1473243	APC2	23096	0.635478
chr19	1473199	1479228	C19orf25	6029	0.587991
chr19	1481426	1490407	PCSK4	8981	0.623093
chr19	1491164	1497924	REEP6	6760	0.608432
chr19	1505016	1513188	ADAMTSL5	8172	0.600832
chr19	1524072	1535455	PLK5	11383	0.605552
chr19	1554667	1568057	MEX3D	13390	0.604780
chr19	1573594	1575474	AX747577	1880	0.555851
chr19	1576677	1592652	MBD3	15975	0.577465
chr19	1597153	1605483	UQCR11	8330	0.563145
chr19	1609288	1650286	TCF3	40998	0.591541
chr19	1753661	1775444	ONECUT3	21783	0.592480
chr19	1782073	1812275	ATP8B3	30202	0.580789
chr19	1815244	1848452	REXO1	33208	0.609251
chr19	1822087	1824542	LOC100288123	2455	0.645214
chr19	1852397	1863564	KLF16	11167	0.654249
chr19	1876974	1885518	ABHD17A	8544	0.651919
chr19	1905370	1926012	SCAMP4	20642	0.600765
chr19	1905370	1913446	ADAT3	8076	0.603021
chr19	1941160	1981336	CSNK1G2	40176	0.610240
chr19	1952525	1954548	CSNK1G2-AS1	2023	0.628275
chr19	1985446	2015702	BTBD2	30256	0.567854
chr19	2037469	2051243	MKNK2	13774	0.642370
chr19	2071034	2096269	MOB3A	25235	0.553636
chr19	2096867	2099583	IZUMO4	2716	0.645066
chr19	2100986	2151556	AP3D1	50570	0.572790
chr19	2164147	2232577	DOT1L	68430	0.594549
chr19	2212027	2215564	AX746733	3537	0.590896
chr19	2233154	2236951	PLEKHJ1	3797	0.620490
chr19	2234060	2234148	MIR1227	88	0.693182
chr19	2236815	2248678	SF3A2	11863	0.584338
chr19	2249112	2252072	AMH	2960	0.710135
chr19	2252249	2256422	JSRP1	4173	0.639827
chr19	2328628	2355100	SPPL2B	26472	0.610230
chr19	2269519	2273487	OAZ1	3968	0.640373
chr19	2274630	2282181	C19orf35	7551	0.599788
chr19	2289773	2308156	LINGO3	18383	0.592069
chr19	2289998	2292023	AX747191	2025	0.707160
chr19	2321519	2328614	LSM7	7095	0.577026
chr19	2389783	2426086	TMPRSS9	36303	0.531526
chr19	2425621	2427875	TIMM13	2254	0.649068
chr19	2428162	2456966	LMNB2	28804	0.596688
chr19	2476122	2478257	GADD45B	2135	0.602342
chr19	2511217	2702746	GNG7	191529	0.522438
chr19	2641835	2643849	BC022568	2014	0.575968
chr19	2714564	2721390	DIRAS1	6826	0.610753
chr19	2732522	2740074	SLC39A3	7552	0.576006
chr19	2754711	2783354	SGTA	28643	0.577977
chr19	2785505	2813599	THOP1	28094	0.588417
chr19	2819871	2836733	ZNF554	16862	0.507769
chr19	2841432	2860472	ZNF555	19040	0.459611
chr19	2867332	2878501	ZNF556	11169	0.479810
chr19	2900895	2918474	ZNF57	17579	0.462597
chr19	2933215	2944969	ZNF77	11754	0.497363
chr19	2977535	2995182	TLE6	17647	0.540432
chr19	2997635	3029165	TLE2	31530	0.539645
chr19	3052907	3056766	AES	3859	0.592641
chr19	3052907	3062964	AES	10057	0.603460
chr19	3094407	3121454	GNA11	27047	0.616261
chr19	3121806	3123996	DKFZp434J194	2190	0.627854
chr19	3136190	3163766	GNA15	27576	0.525529
chr19	3178735	3180330	S1PR4	1595	0.680878
chr19	3185874	3209573	NCLN	23699	0.610490
chr19	3224700	3297073	CELF5	72373	0.534315
chr19	3366564	3469215	NFIC	102651	0.556673
chr19	3474404	3480540	C19orf77	6136	0.552151
chr19	3490818	3500621	DOHH	9803	0.563909
chr19	3522953	3536755	FZR1	13802	0.625996
chr19	3538262	3557571	MFSD12	19309	0.592522
chr19	3539154	3544028	C19orf71	4874	0.562372
chr19	3572942	3579081	HMG20B	6139	0.650920
chr19	3585568	3593539	GIPC3	7971	0.576088
chr19	3594503	3606831	TBXA2R	12328	0.557511
chr19	3607244	3613928	CACTIN-AS1	6684	0.631209
chr19	3610626	3626813	CACTIN	16187	0.615679
chr19	3630178	3700477	PIP5K1C	70299	0.605514
chr19	3721696	3750811	TJP3	29115	0.538279
chr19	3750770	3761673	APBA3	10903	0.565991
chr19	3762664	3767563	MRPL54	4899	0.550929
chr19	3769088	3772219	RAX2	3131	0.643564
chr19	3777966	3786415	MATK	8449	0.611197
chr19	3781793	3781853	JA611290	60	0.600000
chr19	3804021	3869027	ZFR2	65006	0.543611
chr19	3880617	3928080	ATCAY	47463	0.515602
chr19	3933100	3942414	NMRK2	9314	0.577947
chr19	3958451	3969827	DAPK3	11376	0.582630
chr19	3976053	3985461	EEF2	9408	0.595344
chr19	3982504	3982570	SNORD37	66	0.439394
chr19	4007748	4038067	PIAS4	30319	0.592269
chr19	4045215	4066816	ZBTB7A	21601	0.625017
chr19	4090319	4124126	MAP2K2	33807	0.574171
chr19	4153597	4173051	CREB3L3	19454	0.527141
chr19	4174105	4182596	SIRT6	8491	0.578848
chr19	4183350	4224811	ANKRD24	41461	0.536022
chr19	4229539	4237524	EBI3	7985	0.536631
chr19	4247110	4269085	CCDC94	21975	0.528100
chr19	4278597	4290720	SHD	12123	0.547554
chr19	4292224	4302428	TMIGD2	10204	0.539592
chr19	4292224	4302428	TMIGD2	10204	0.539592
chr19	4304590	4323843	FSD1	19253	0.547291
chr19	4324039	4338941	STAP2	14902	0.553080
chr19	4343523	4360083	MPND	16560	0.559541
chr19	4360363	4400565	SH3GL1	40202	0.571738
chr19	4402659	4443394	CHAF1A	40735	0.507181
chr19	4445002	4457791	UBXN6	12789	0.600125
chr19	4445974	4446045	MIR4746	71	0.676056
chr19	4472254	4502222	HDGFRP2	29968	0.571109
chr19	4502191	4517716	PLIN4	15525	0.592142
chr19	4522543	4535208	PLIN5	12665	0.552704
chr19	4537226	4540036	LRG1	2810	0.562278
chr19	4542599	4559771	SEMA6B	17172	0.578500
chr19	4639526	4655580	TNFAIP8L1	16054	0.555625
chr19	4657556	4670415	C19orf10	12859	0.546388
chr19	4675243	4723855	DPP9	48612	0.566979
chr19	4679293	4685960	LOC100131094	6667	0.592620
chr19	4769116	4772568	MIR7-3HG	3452	0.516512
chr19	4770681	4770791	MIR7-3	110	0.490909
chr19	4791727	4795571	FEM1A	3844	0.594953
chr19	4791756	4794948	AK126532	3192	0.611842
chr19	4815935	4831754	TICAM1	15819	0.525065
chr19	4838345	4867780	PLIN3	29435	0.523730
chr19	4890448	4902879	ARRDC5	12431	0.502534
chr19	4907741	4910019	C19orf31	2278	0.617208
chr19	4909509	4962165	UHRF1	52656	0.531658
chr19	4932698	4932752	MIR4747	54	0.629630
chr19	4969123	5153608	KDM4B	184485	0.572626
chr19	5113892	5116253	BC032415	2361	0.601017
chr19	5205518	5340814	PTPRS	135296	0.540556
chr19	5455425	5456867	ZNRF4	1442	0.649098
chr19	5558177	5568005	TINCR	9828	0.554640
chr19	5587009	5622938	SAFB2	35929	0.488992
chr19	5623045	5668489	SAFB	45444	0.473484
chr19	5678432	5680911	C19orf70	2479	0.611134
chr19	5680775	5688534	HSD11B1L	7759	0.581132
chr19	5690271	5691678	RPL36	1407	0.628998
chr19	5691844	5720269	LONP1	28425	0.577801
chr19	5720687	5778742	CATSPERD	58055	0.494824
chr19	5782970	5784776	PRR22	1806	0.667220
chr19	5785152	5791249	DUS3L	6097	0.618173
chr19	5823817	5828335	NRTN	4518	0.619743
chr19	5830636	5839742	FUT6	9106	0.537558
chr19	5842898	5851485	FUT3	8587	0.519040
chr19	5847477	5858250	BC033124	10773	0.495684
chr19	5865836	5870634	FUT5	4798	0.537724
chr19	5891286	5904024	NDUFA11	12738	0.590517
chr19	5904851	5910263	VMAC	5412	0.536216
chr19	5914192	5916222	CAPS	2030	0.637931
chr19	5916151	5978320	RANBP3	62169	0.527948
chr19	5978413	6020374	LOC100128568	41961	0.532042
chr19	5993174	6110664	RFX2	117490	0.485241
chr19	6006493	6008625	AX748210	2132	0.579737
chr19	6135709	6193112	ACSBG2	57403	0.457833
chr19	6189738	6199540	AK056073	9802	0.471740
chr19	6210391	6279959	MLLT1	69568	0.555658
chr19	6306509	6333640	ACER1	27131	0.497770
chr19	6361462	6368915	CLPP	7453	0.541393
chr19	6372443	6375261	ALKBH7	2818	0.643364
chr19	6375304	6375860	PSPN	556	0.697842
chr19	6379579	6393291	GTF2F1	13712	0.543028
chr19	6396355	6412415	BC171868	16060	0.495330
chr19	6413118	6424822	KHSRP	11704	0.585954
chr19	6426047	6433790	SLC25A41	7743	0.508588
chr19	6440074	6459781	SLC25A23	19707	0.525245
chr19	6464259	6467230	CRB3	2971	0.602154
chr19	6467217	6481798	DENND1C	14581	0.555380
chr19	6494329	6502330	TUBB4A	8001	0.552181
chr19	6495968	6495989	JB175242	21	0.571429
chr19	6531009	6535939	TNFSF9	4930	0.592089
chr19	6585849	6591163	CD70	5314	0.539518
chr19	6663147	6670599	TNFSF14	7452	0.522947
chr19	6677845	6720662	C3	42817	0.510802
chr19	6729924	6737633	GPR108	7709	0.604229
chr19	6739706	6751529	TRIP10	11823	0.532944
chr19	6752172	6767523	SH2D3A	15351	0.518012
chr19	6772678	6857377	VAV1	84699	0.473961
chr19	6887559	6940464	EMR1	52905	0.444174
chr19	6952510	6990857	EMR4P	38347	0.432785
chr19	7004963	7006426	FLJ25758	1463	0.537936
chr19	7030593	7033022	MBD3L5	2429	0.477563
chr19	7037754	7040184	MBD3L4	2430	0.476543
chr19	7049350	7051746	MBD3L2	2396	0.472454
chr19	7056215	7058645	MBD3L3	2430	0.476955
chr19	7069470	7087978	ZNF557	18508	0.457910
chr19	7112265	7294011	INSR	181746	0.474371
chr19	7504573	7537371	ARHGEF18	32798	0.539271
chr19	7537722	7538247	LOC100128573	525	0.527619
chr19	7541755	7553924	PEX11G	12169	0.557400
chr19	7562444	7573336	C19orf45	10892	0.551506
chr19	7581003	7585911	ZNF358	4908	0.614099
chr19	7587495	7598895	MCOLN1	11400	0.570263
chr19	7599590	7626653	PNPLA6	27063	0.558068
chr19	7660787	7683196	CAMSAP3	22409	0.586505
chr19	7684410	7694439	XAB2	10029	0.608037
chr19	7694670	7696510	PET100	1840	0.554891
chr19	7696500	7697898	PCP2	1398	0.608727
chr19	7701986	7712760	STXBP2	10774	0.609337
chr19	7733971	7735340	RETN	1369	0.631848
chr19	7741942	7744719	C19orf59	2777	0.546633
chr19	7745706	7747748	TRAPPC5	2042	0.668952
chr19	7753642	7767032	FCER2	13390	0.535101
chr19	7793842	7797057	CLEC4G	3215	0.636081
chr19	7804880	7812464	CD209	7584	0.531118
chr19	7828034	7834491	CLEC4M	6457	0.526715
chr19	7852369	7855898	CLEC4GP1	3529	0.623689
chr19	7911381	7929862	EVI5L	18481	0.619934
chr19	7933604	7939326	FLJ22184	5722	0.678434
chr19	7943516	7945117	LOC388499	1601	0.600250
chr19	7953389	7966908	LRRC8E	13519	0.546564
chr19	7968764	7979363	MAP2K7	10599	0.630909
chr19	7981031	7983980	TGFBR3L	2949	0.670058
chr19	7985193	7988136	SNAPC2	2943	0.641862
chr19	7989380	7991051	CTXN1	1671	0.749252
chr19	7991602	8008708	TIMM44	17106	0.563837
chr19	8023456	8070529	ELAVL1	47073	0.521955
chr19	8117645	8127547	CCL25	9902	0.495960
chr19	8130286	8212381	FBN3	82095	0.524977
chr19	8274216	8327304	CERS4	53088	0.525957
chr19	8367010	8373240	CD320	6230	0.583467
chr19	8376183	8386280	NDUFA7	10097	0.518768
chr19	8386383	8387280	RPS28	897	0.583055
chr19	8387467	8408146	KANK3	20679	0.551913
chr19	8397659	8399314	KANK3	1655	0.632024
chr19	8429010	8439257	ANGPTL4	10247	0.555577
chr19	8439259	8455575	RAB11B-AS1	16316	0.485720
chr19	8454173	8454264	MIR4999	91	0.285714
chr19	8454195	8454215	JA429850	20	0.400000
chr19	8455204	8469317	RAB11B	14113	0.591015
chr19	8478186	8503899	MARCH2	25713	0.510831
chr19	8509802	8554002	HNRNPM	44200	0.465973
chr19	8554939	8567538	PRAM1	12599	0.570760
chr19	8575461	8579048	ZNF414	3587	0.653750
chr19	8585673	8642331	MYO1F	56658	0.525557
chr19	8645125	8675588	ADAMTS10	30463	0.545514
chr19	8807750	8809172	ACTL9	1422	0.660338
chr19	8841390	8842335	OR2Z1	945	0.552381
chr19	8920381	8933565	ZNF558	13184	0.416945
chr19	8953268	8954016	MBD3L1	748	0.474599
chr19	8959519	9092018	MUC16	132499	0.459120
chr19	9203920	9204862	OR1M1	942	0.545648
chr19	9212944	9213982	OR7G2	1038	0.471098
chr19	9225503	9226439	OR7G1	936	0.455128
chr19	9236687	9237626	OR7G3	939	0.481363
chr19	9251055	9274091	ZNF317	23036	0.444912
chr19	9251055	9268386	ZNF317	17331	0.431770
chr19	9296269	9299493	OR7D2	3224	0.441377
chr19	9324525	9325547	OR7D4	1022	0.520548
chr19	9361719	9362739	OR7E24	1020	0.477451
chr19	9405985	9415795	ZNF699	9810	0.424771
chr19	9434447	9454521	ZNF559	20074	0.409037
chr19	9486991	9493293	ZNF177	6302	0.397175
chr19	9523101	9546254	ZNF266	23153	0.449315
chr19	9577030	9609279	ZNF560	32249	0.424943
chr19	9638680	9649303	ZNF426	10623	0.446578
chr19	9649408	9650404	OR7D2	996	0.495984
chr19	9671009	9673124	AK297919	2115	0.391962
chr19	9676291	9695209	ZNF121	18918	0.424675
chr19	9718001	9731916	ZNF561	13915	0.440676
chr19	9732157	9745538	LOC284385	13381	0.435169
chr19	9759337	9785776	ZNF562	26439	0.430425
chr19	9800813	9811493	ZNF812	10680	0.433614
chr19	9868150	9879410	ZNF846	11260	0.440941
chr19	9920942	9929731	FBXL12	8789	0.495278
chr19	9938555	9940797	UBL5	2242	0.523194
chr19	9945882	9960365	PIN1	14483	0.563764
chr19	9964393	10047070	OLFM2	82677	0.504566
chr19	10070236	10121147	COL5A3	50911	0.523364
chr19	10123924	10132954	RDH8	9030	0.509967
chr19	10152031	10184813	C3P1	32782	0.508389
chr19	10196805	10203928	C19orf66	7123	0.566615
chr19	10203012	10213425	ANGPTL6	10413	0.535484
chr19	10216898	10226064	PPAN-P2RY11	9166	0.602662
chr19	10218326	10218411	SNORD105	85	0.470588
chr19	10220424	10220516	SNORD105B	92	0.586957
chr19	10225689	10230599	EIF3G	4910	0.592261
chr19	10244021	10305755	DNMT1	61734	0.503823
chr19	10332108	10341948	S1PR2	9840	0.567683
chr19	10341088	10341161	MIR4322	73	0.753425
chr19	10362639	10370721	MRPL4	8082	0.560876
chr19	10381516	10397291	ICAM1	15775	0.520887
chr19	10397642	10399260	ICAM4	1618	0.603832
chr19	10400654	10407454	ICAM5	6800	0.639559
chr19	10415478	10420233	ZGLP1	4755	0.549317
chr19	10420890	10426691	FDX1L	5801	0.528357
chr19	10426888	10444314	RAVER1	17426	0.568633
chr19	10444451	10450345	ICAM3	5894	0.558704
chr19	10461203	10491248	TYK2	30045	0.543318
chr19	10501808	10514271	CDC37	12463	0.547701
chr19	10531332	10580307	PDE4A	48975	0.538785
chr19	10596795	10614054	KEAP1	17259	0.538849
chr19	10623417	10628668	S1PR5	5251	0.583698
chr19	10654646	10664094	ATG4D	9448	0.551757
chr19	10662797	10662880	MIR1238	83	0.686747
chr19	10663760	10676702	KRI1	12942	0.550919
chr19	10677137	10679631	CDKN2D	2494	0.577386
chr19	10683346	10697991	AP1M2	14645	0.519631
chr19	10736170	10755235	SLC44A2	19065	0.531707
chr19	10762537	10764548	ILF3-AS1	2011	0.517156
chr19	10764936	10803095	ILF3	38159	0.509002
chr19	10796603	10803095	ILF3	6492	0.584720
chr19	10812111	10824043	QTRT1	11932	0.527824
chr19	10828728	10942586	DNM2	113858	0.530002
chr19	10829079	10829179	MIR638	100	0.810000
chr19	10890929	10891011	MIR4748	82	0.585366
chr19	10928101	10928172	MIR199A1	71	0.507042
chr19	10943113	10946983	TMED1	3870	0.562274
chr19	10959105	10980360	C19orf38	21255	0.512585
chr19	10982252	11033448	CARM1	51196	0.542503
chr19	11033289	11033320	DQ597473	31	0.548387
chr19	11033443	11039357	YIPF2	5914	0.588096
chr19	11039423	11040916	C19orf52	1493	0.622907
chr19	11071597	11172958	SMARCA4	101361	0.527737
chr19	11200037	11244505	LDLR	44468	0.510727
chr19	11238683	11244505	LDLR	5822	0.522329
chr19	11257830	11266484	SPC24	8654	0.525075
chr19	11274942	11305266	KANK2	30324	0.520083
chr19	11309968	11373168	DOCK6	63200	0.537737
chr19	11350294	11352619	C19orf80	2325	0.557419
chr19	11406823	11437672	TSPAN16	30849	0.486693
chr19	11411544	11431999	AF161365	20455	0.477585
chr19	11432721	11450344	RAB3D	17623	0.507973
chr19	11453451	11456981	TMEM205	3530	0.538810
chr19	11457180	11465620	CCDC159	8440	0.546090
chr19	11466061	11476374	LPPR2	10313	0.573063
chr19	11485382	11487627	SWSAP1	2245	0.535857
chr19	11487880	11495018	EPOR	7138	0.570748
chr19	11504731	11530018	RGL3	25287	0.513307
chr19	11531271	11545980	CCDC151	14709	0.520974
chr19	11546268	11561782	PRKCSH	15514	0.568196
chr19	11562142	11591803	ELAVL3	29661	0.530461
chr19	11594241	11616738	ZNF653	22497	0.556696
chr19	11616730	11639987	ECSIT	23257	0.508793
chr19	11649578	11661138	CNN1	11560	0.548875
chr19	11663857	11670051	ELOF1	6194	0.544236
chr19	11670275	11686376	BC039523	16101	0.487796
chr19	11685474	11689801	ACP5	4327	0.584470
chr19	11708234	11729974	ZNF627	21740	0.452208
chr19	11784812	11797384	ZNF833P	12572	0.462297
chr19	11832079	11849760	ZNF823	17681	0.447373
chr19	11877814	11894893	ZNF441	17079	0.417823
chr19	11909390	11919306	ZNF491	9916	0.437273
chr19	11925106	11946016	ZNF440	20910	0.441033
chr19	11976843	11980306	ZNF439	3463	0.389258
chr19	11998669	12025365	ZNF69	26696	0.431001
chr19	12035882	12061588	ZNF700	25706	0.446044
chr19	12098431	12138553	AX747405	40122	0.438014
chr19	12125531	12146525	ZNF433	20994	0.432314
chr19	12154619	12163782	ZNF878	9163	0.461421
chr19	12175545	12188626	ZNF844	13081	0.443468
chr19	12203077	12225494	ZNF788	22417	0.418120
chr19	12203077	12210475	ZNF788	7398	0.428494
chr19	12242167	12251222	ZNF20	9055	0.454887
chr19	12255708	12267546	ZNF625	11838	0.453962
chr19	12273871	12300064	ZNF136	26193	0.445004
chr19	12305829	12349077	AK023304	43248	0.424413
chr19	12382624	12405714	ZNF44	23090	0.432655
chr19	12428303	12444534	ZNF563	16231	0.426345
chr19	12460184	12476475	ZNF442	16291	0.457185
chr19	12490002	12512088	ZNF799	22086	0.419632
chr19	12500827	12512088	ZNF799	11261	0.418613
chr19	12540519	12551926	ZNF443	11407	0.416148
chr19	12571997	12595632	ZNF709	23635	0.430209
chr19	12686919	12721623	ZNF490	34704	0.453608
chr19	12721731	12740676	ZNF791	18945	0.458749
chr19	12757321	12777591	MAN2B1	20270	0.540355
chr19	12780516	12786646	WDR83	6130	0.552202
chr19	12778880	12780465	WDR83OS	1585	0.569085
chr19	12786530	12792701	DHPS	6171	0.547075
chr19	12798811	12799236	BC171856	425	0.616471
chr19	12799614	12801435	AX747991	1821	0.619989
chr19	12799729	12807455	FBXW9	7726	0.560963
chr19	12810007	12833462	TNPO2	23455	0.541676
chr19	12817262	12817332	SNORD41	70	0.471429
chr19	12841453	12845529	C19orf43	4076	0.546369
chr19	12848305	12859137	ASNA1	10832	0.536189
chr19	12863406	12869271	BEST2	5865	0.570503
chr19	12873816	12886434	HOOK2	12618	0.561182
chr19	12902309	12904125	JUNB	1816	0.650330
chr19	12907633	12912724	PRDX2	5091	0.547437
chr19	12917427	12924462	RNASEH2A	7035	0.515991
chr19	12936290	12946242	RTBDN	9952	0.552653
chr19	12949258	12985766	MAST1	36508	0.519585
chr19	12986024	12992335	DNASE2	6311	0.526858
chr19	12995236	12998017	KLF1	2781	0.615965
chr19	13001942	13010813	GCDH	8871	0.550445
chr19	13009893	13030086	SYCE2	20193	0.500173
chr19	13033283	13044558	FARSA	11275	0.539246
chr19	13049413	13055304	CALR	5891	0.530131
chr19	13056627	13064457	RAD23A	7830	0.545466
chr19	13064969	13068068	GADD45GIP1	3099	0.549855
chr19	13080323	13085567	DAND5	5244	0.524981
chr19	13135394	13209610	NFIX	74216	0.550164
chr19	13209841	13213974	LYL1	4133	0.620857
chr19	13215713	13227563	TRMT1	11850	0.541519
chr19	13229101	13251961	NACC1	22860	0.555862
chr19	13254871	13261188	STX10	6317	0.553427
chr19	13261281	13265718	IER2	4437	0.623394
chr19	13317255	13617274	CACNA1A	300019	0.481779
chr19	13629788	13631071	BC042451	1283	0.405300
chr19	13858752	13874106	CCDC130	15354	0.524163
chr19	13875336	13885096	MRI1	9760	0.521926
chr19	13885256	13889586	C19orf53	4330	0.558199
chr19	13906273	13943044	ZSWIM4	36771	0.535340
chr19	13945329	13947473	LOC284454	2144	0.569496
chr19	13947102	13947125	hsa-miR-3074-5p	23	0.565217
chr19	13947408	13947429	FW420894	21	0.476190
chr19	13985512	13985622	MIR181C	110	0.545455
chr19	13985688	13985825	MIR181D	137	0.598540
chr19	13988062	13991571	NANOS3	3509	0.553434
chr19	13993167	14016909	C19orf57	23742	0.523039
chr19	14016955	14041693	CC2D1A	24738	0.539211
chr19	14041999	14064204	PODNL1	22205	0.541365
chr19	14063318	14072256	DCAF15	8938	0.598792
chr19	14072341	14117134	RFX1	44793	0.562320
chr19	14139016	14141783	RLN3	2767	0.505602
chr19	14142551	14163717	IL27RA	21166	0.518898
chr19	14164178	14169971	PALM3	5793	0.595028
chr19	14183820	14185874	LOC113230	2054	0.672347
chr19	14192443	14196607	C19orf67	4164	0.555716
chr19	14199228	14201232	SAMD1	2004	0.653693
chr19	14202506	14228559	PRKACA	26053	0.531148
chr19	14230320	14247440	ASF1B	17120	0.507886
chr19	14247963	14282075	LOC100507373	34112	0.559774
chr19	14258548	14316997	LPHN1	58449	0.564201
chr19	14282480	14282837	BC141944	357	0.565826
chr19	14300569	14302568	AX746734	1999	0.502251
chr19	14302745	14305062	AX746734	2317	0.524817
chr19	14444554	14454726	BC011648	10172	0.496461
chr19	14491955	14519537	CD97	27582	0.546335
chr19	14519609	14530195	DDX39A	10586	0.555451
chr19	14551085	14582679	PKN1	31594	0.522536
chr19	14583277	14586174	PTGER1	2897	0.679669
chr19	14588570	14606961	GIPC1	18391	0.537002
chr19	14625581	14629201	DNAJB1	3620	0.561878
chr19	14640378	14676792	TECR	36414	0.540699
chr19	14676889	14682889	NDUFB7	6000	0.574833
chr19	14693895	14721956	CLEC17A	28061	0.491216
chr19	14730050	14785730	EMR3	55680	0.437967
chr19	14800869	14831772	ZNF333	30903	0.484840
chr19	14843508	14889353	EMR2	45845	0.467728
chr19	14909985	14910948	OR7C1	963	0.477674
chr19	14937138	14939276	OR7A5	2138	0.409729
chr19	14951759	14952689	OR7A10	930	0.466667
chr19	14991237	14992167	OR7A17	930	0.481720
chr19	15052300	15053260	OR7C2	960	0.498958
chr19	15060844	15083729	SLC1A6	22885	0.469653
chr19	15121538	15134083	CCDC105	12545	0.504026
chr19	15160290	15169103	CASP14	8813	0.476682
chr19	15197876	15198944	OR1I1	1068	0.533708
chr19	15218213	15225789	SYDE1	7576	0.602693
chr19	15225784	15236577	ILVBL	10793	0.572130
chr19	15270443	15311792	NOTCH3	41349	0.550388
chr19	15337729	15343231	EPHX3	5502	0.549255
chr19	15348300	15391262	BRD4	42962	0.542689
chr19	15464331	15490612	AKAP8	26281	0.532856
chr19	15490858	15529833	AKAP8L	38975	0.488339
chr19	15532317	15560762	WIZ	28445	0.587063
chr19	15560358	15560419	MIR1470	61	0.819672
chr19	15562437	15575382	RASAL3	12945	0.571881
chr19	15579456	15590315	PGLYRP2	10859	0.515609
chr19	15619335	15663128	CYP4F22	43793	0.492476
chr19	15726028	15740447	CYP4F8	14419	0.481517
chr19	15751706	15771570	CYP4F3	19864	0.463351
chr19	15783827	15807984	CYP4F12	24157	0.458294
chr19	15838833	15839862	OR10H2	1029	0.571429
chr19	15852202	15853153	OR10H3	951	0.496320
chr19	15880825	15885174	CYP4F24P	4349	0.461715
chr19	15904858	15905806	OR10H5	948	0.583333
chr19	15917816	15918936	OR10H1	1120	0.563393
chr19	15939756	15947131	UCA1	7375	0.477153
chr19	15988833	16008884	CYP4F2	20051	0.461024
chr19	16023179	16045676	CYP4F11	22497	0.460328
chr19	16059817	16060768	OR10H4	951	0.492114
chr19	16126443	16138272	LINC00661	11829	0.598614
chr19	16126728	16126769	DQ581539	41	0.536585
chr19	16126845	16126892	DQ571988	47	0.617021
chr19	16135750	16135794	DQ575954	44	0.545455
chr19	16144522	16152918	LINC00905	8396	0.559076
chr19	16146830	16146881	DQ587284	51	0.607843
chr19	16146912	16146951	DQ592688	39	0.615385
chr19	16147033	16147064	DQ601165	31	0.516129
chr19	16147095	16147133	DQ589586	38	0.552632
chr19	16147183	16147220	DQ597063	37	0.513514
chr19	16147233	16147269	DQ585694	36	0.555556
chr19	16147320	16147366	DQ585402	46	0.565217
chr19	16147485	16147516	DQ598314	31	0.612903
chr19	16147680	16147807	DQ591334	127	0.527559
chr19	16147817	16147931	DQ574353	114	0.552632
chr19	16148018	16148056	DQ583543	38	0.631579
chr19	16148104	16148138	DQ596700	34	0.588235
chr19	16148198	16148308	DQ592376	110	0.554545
chr19	16148358	16148400	DQ579377	42	0.642857
chr19	16148401	16148431	DQ575167	30	0.633333
chr19	16148443	16148504	DQ591916	61	0.557377
chr19	16148655	16148700	DQ575099	45	0.577778
chr19	16148761	16148793	DQ582989	32	0.500000
chr19	16148863	16148895	DQ582228	32	0.500000
chr19	16148924	16149015	DQ588762	91	0.505495
chr19	16149057	16149089	DQ592694	32	0.500000
chr19	16149135	16149193	DQ585389	58	0.534483
chr19	16149233	16149273	DQ580910	40	0.500000
chr19	16149329	16149362	DQ588796	33	0.606061
chr19	16149434	16149466	DQ578085	32	0.531250
chr19	16149642	16149678	DQ570895	36	0.527778
chr19	16149800	16149913	DQ600374	113	0.539823
chr19	16150019	16150103	DQ592014	84	0.571429
chr19	16150627	16150660	DQ577234	33	0.545455
chr19	16151114	16151166	DQ580366	52	0.500000
chr19	16178316	16213813	TPM4	35497	0.507987
chr19	16222489	16244445	RAB8A	21956	0.537120
chr19	16234470	16250702	AK095221	16232	0.536471
chr19	16244837	16269377	HSH2D	24540	0.515648
chr19	16272178	16284286	CIB3	12108	0.493971
chr19	16296234	16302857	FAM32A	6623	0.529518
chr19	16308664	16346156	AP1M1	37492	0.530006
chr19	16435650	16438339	KLF2	2689	0.670509
chr19	16466054	16582823	EPS15L1	116769	0.507729
chr19	16589867	16607003	CALR3	17136	0.475490
chr19	16607204	16632163	C19orf44	24959	0.515846
chr19	16628699	16653263	CHERP	24564	0.572586
chr19	16660647	16683193	SLC35E1	22546	0.501331
chr19	16685717	16739015	MED26	53298	0.522196
chr19	16756958	16770968	SMIM7	14010	0.483226
chr19	16771937	16799816	TMEM38A	27879	0.498332
chr19	16830786	16928774	NWD1	97988	0.480753
chr19	16940208	16991164	SIN3B	50956	0.529751
chr19	16999825	17002830	F2RL3	3005	0.612978
chr19	17003761	17137625	CPAMD8	133864	0.501972
chr19	17160570	17186343	HAUS8	25773	0.495635
chr19	17186590	17324104	MYO9B	137514	0.523249
chr19	17326154	17330638	USE1	4484	0.552632
chr19	17337054	17340028	OCEL1	2974	0.585407
chr19	17342693	17356151	NR2F6	13458	0.580027
chr19	17360848	17375544	USHBP1	14696	0.537629
chr19	17378231	17390162	BABAM1	11931	0.530383
chr19	17392453	17398454	ANKLE1	6001	0.577904
chr19	17402939	17414282	ABHD8	11343	0.545182
chr19	17416476	17417652	MRPL34	1176	0.568027
chr19	17420336	17434106	DDA1	13770	0.561656
chr19	17434031	17445638	ANO8	11607	0.626691
chr19	17445790	17453540	GTPBP3	7750	0.569419
chr19	17462263	17488137	PLVAP	25874	0.517044
chr19	17513754	17516384	BST2	2630	0.584411
chr19	17516502	17526545	AK311380	10043	0.484815
chr19	17530911	17536140	MVB12A	5229	0.566839
chr19	17546317	17559376	TMEM221	13059	0.505322
chr19	17566233	17571725	NXNL1	5492	0.508740
chr19	17581299	17616977	SLC27A1	35678	0.534475
chr19	17622431	17632097	PGLS	9666	0.533313
chr19	17634109	17664648	FAM129C	30539	0.525132
chr19	17666510	17693965	COLGALT1	27455	0.528064
chr19	17712136	17799050	UNC13A	86914	0.521308
chr19	17830302	17845324	MAP1S	15022	0.574624
chr19	17858526	17899377	FCHO1	40851	0.537539
chr19	17905918	17924385	B3GNT3	18467	0.525261
chr19	17927321	17932383	INSL3	5062	0.530620
chr19	17935592	17958841	JAK3	23249	0.549357
chr19	17970686	17974133	RPL18A	3447	0.583406
chr19	17973396	17973529	SNORA68	133	0.496241
chr19	17982781	18005983	SLC5A5	23202	0.526420
chr19	18045904	18054794	CCDC124	8890	0.563442
chr19	18062110	18109930	KCNN1	47820	0.546612
chr19	18118976	18124911	ARRDC2	5935	0.558214
chr19	18170370	18197742	IL12RB1	27372	0.510704
chr19	18208602	18262499	MAST3	53897	0.548695
chr19	18263987	18281343	PIK3R2	17356	0.576976
chr19	18284578	18288927	IFI30	4349	0.555530
chr19	18304039	18307550	MPV17L2	3511	0.596411
chr19	18307610	18314874	RAB3A	7264	0.551074
chr19	18318770	18359010	PDE4C	40240	0.542495
chr19	18367905	18385319	KIAA1683	17414	0.557942
chr19	18390562	18392432	JUND	1870	0.697326
chr19	18392886	18392971	MIR3188	85	0.705882
chr19	18417039	18434001	LSM4	16962	0.563023
chr19	18451407	18480763	PGPEP1	29356	0.513115
chr19	18496967	18499986	GDF15	3019	0.566744
chr19	18497371	18497444	MIR3189	73	0.602740
chr19	18501953	18508415	LRRC25	6462	0.547818
chr19	18530145	18545372	SSBP4	15227	0.645104
chr19	18545197	18549111	ISYNA1	3914	0.665815
chr19	18553472	18632937	ELL	79465	0.555163
chr19	18642567	18654383	FKBP8	11816	0.562712
chr19	18668571	18680197	KXD1	11626	0.534234
chr19	18682613	18688270	UBA52	5657	0.530316
chr19	18699494	18703147	C19orf60	3653	0.602245
chr19	18704034	18717660	CRLF1	13626	0.599075
chr19	18723681	18731849	TMEM59L	8168	0.565622
chr19	18747837	18781302	KLHL26	33465	0.569251
chr19	18794424	18893143	CRTC1	98719	0.560571
chr19	18893582	18902114	COMP	8532	0.628458
chr19	18942743	18979039	UPF1	36296	0.551548
chr19	18988717	19006953	CERS1	18236	0.570301
chr19	19010322	19030199	COPE	19877	0.570559
chr19	19030483	19039442	DDX49	8959	0.571158
chr19	19040009	19052041	HOMER3	12032	0.566988
chr19	19101696	19144380	SUGP2	42684	0.497704
chr19	19144386	19168987	ARMC6	24601	0.508882
chr19	19174802	19223841	SLC25A42	49039	0.525622
chr19	19230424	19249310	TMEM161A	18886	0.514402
chr19	19256375	19281098	MEF2B	24723	0.544513
chr19	19287712	19303400	MEF2BNB	15688	0.543409
chr19	19303007	19312678	RFXANK	9671	0.547203
chr19	19312223	19314238	NR2C2AP	2015	0.567742
chr19	19322781	19363061	NCAN	40280	0.515541
chr19	19350867	19363061	NCAN	12194	0.492947
chr19	19366451	19373651	HAPLN4	7200	0.595000
chr19	19375173	19384074	TM6SF2	8901	0.550051
chr19	19387321	19431321	SUGP1	44000	0.512977
chr19	19431629	19469563	MAU2	37934	0.543549
chr19	19496641	19619741	GATAD2A	123100	0.508668
chr19	19625027	19626469	TSSK6	1442	0.659501
chr19	19639669	19648393	YJEFN3	8724	0.590555
chr19	19649073	19657468	CILP2	8395	0.642168
chr19	19672515	19729725	PBX4	57210	0.498724
chr19	19734465	19739039	LPAR2	4574	0.568212
chr19	19740284	19754455	GMIP	14171	0.561075
chr19	19756009	19774503	ATP13A1	18494	0.579918
chr19	19779662	19791138	ZNF101	11476	0.466887
chr19	19821280	19843921	ZNF14	22641	0.420432
chr19	19853547	19854484	DQ580047	937	0.580576
chr19	19855284	19856046	DQ574239	762	0.551181
chr19	19856125	19856166	DQ584913	41	0.463415
chr19	19856403	19856471	DQ595898	68	0.558824
chr19	19856474	19856507	DQ573935	33	0.515152
chr19	19857608	19857640	DQ573609	32	0.468750
chr19	19857660	19857692	DQ589342	32	0.468750
chr19	19858439	19858470	DQ576386	31	0.645161
chr19	19858474	19858505	DQ590656	31	0.483871
chr19	19858991	19859064	DQ591298	73	0.547945
chr19	19859640	19859678	DQ577486	38	0.473684
chr19	19859874	19859909	DQ597186	35	0.542857
chr19	19860141	19860192	DQ584258	51	0.568627
chr19	19860364	19860399	DQ583759	35	0.542857
chr19	19860544	19860575	DQ582729	31	0.612903
chr19	19860939	19860979	DQ590505	40	0.675000
chr19	19861038	19861108	DQ576637	70	0.571429
chr19	19861422	19861459	DQ579782	37	0.513514
chr19	19861533	19861579	DQ597024	46	0.586957
chr19	19861756	19861787	DQ584847	31	0.548387
chr19	19861830	19861880	DQ577095	50	0.580000
chr19	19862171	19862201	DQ573850	30	0.500000
chr19	19862240	19862276	DQ574199	36	0.638889
chr19	19862346	19862386	DQ575498	40	0.525000
chr19	19862430	19862465	DQ593444	35	0.628571
chr19	19862973	19863012	DQ574711	39	0.512821
chr19	19863048	19863081	DQ596707	33	0.484848
chr19	19863086	19863116	DQ596454	30	0.500000
chr19	19863186	19863228	DQ576791	42	0.476190
chr19	19863251	19863279	DQ589720	28	0.392857
chr19	19867180	19887222	LINC00663	20042	0.446213
chr19	19903519	19932560	ZNF506	29041	0.400399
chr19	19976713	20004293	ZNF253	27580	0.386403
chr19	20011721	20046382	ZNF93	34661	0.400017
chr19	20115226	20150277	ZNF682	35051	0.409204
chr19	20188802	20231977	ZNF90	43175	0.414036
chr19	20278022	20311299	ZNF486	33277	0.409111
chr19	20510080	20510163	MIR1270-1	83	0.397590
chr19	20578625	20607771	ZNF826P	29146	0.418308
chr19	20579239	20579322	MIR1270-1	83	0.397590
chr19	20720797	20748626	ZNF737	27829	0.392971
chr19	20802744	20844402	ZNF626	41658	0.386072
chr19	20959109	20977403	ZNF66	18294	0.398710
chr19	21106058	21133503	ZNF85	27445	0.378320
chr19	21203425	21242852	ZNF430	39427	0.390545
chr19	21264952	21307883	ZNF714	42931	0.387436
chr19	21324839	21368805	ZNF431	43966	0.395328
chr19	21473962	21512212	ZNF708	38250	0.391608
chr19	21541734	21571384	ZNF738	29650	0.394874
chr19	21579920	21610296	ZNF493	30376	0.384547
chr19	21634855	21646686	CR627135	11831	0.413997
chr19	21666175	21682696	LINC00664	16521	0.486290
chr19	21688436	21721079	ZNF429	32643	0.408388
chr19	21763357	21765406	AX748435	2049	0.408004
chr19	21770233	21776808	BC033373	6575	0.494601
chr19	21906842	21950430	ZNF100	43588	0.387263
chr19	21933546	21936240	LOC641367	2694	0.434298
chr19	21987750	22034870	ZNF43	47120	0.417445
chr19	22148896	22193745	ZNF208	44849	0.382216
chr19	22235265	22273903	ZNF257	38638	0.380222
chr19	22361902	22379753	ZNF676	17851	0.379531
chr19	22469251	22499978	ZNF729	30727	0.383929
chr19	22573898	22605148	ZNF98	31250	0.394368
chr19	22779058	22786352	LOC440518	7294	0.541952
chr19	22798358	22806773	BC030765	8415	0.545217
chr19	22817125	22850472	ZNF492	33347	0.390260
chr19	22934984	22966973	ZNF99	31989	0.388634
chr19	23157684	23186010	ZNF728	28326	0.379863
chr19	23237624	23244067	BC037873	6443	0.465156
chr19	23299776	23330017	ZNF730	30241	0.390463
chr19	23406606	23433172	ZNF724P	26566	0.405631
chr19	23441499	23457032	AK023040	15533	0.451619
chr19	23540497	23578269	ZNF91	37772	0.389177
chr19	23582035	23590900	BC043213	8865	0.452453
chr19	23835707	23870017	ZNF675	34310	0.421656
chr19	23921996	23941693	ZNF681	19697	0.381682
chr19	23945815	24010919	RPSAP58	65104	0.421940
chr19	24097683	24116769	ZNF726	19086	0.369590
chr19	24101882	24140732	AK125686	38850	0.379717
chr19	24132381	24135238	BC015383	2857	0.414771
chr19	24269975	24312654	ZNF254	42679	0.375829
chr19	24344994	24346249	HAVCR1P1	1255	0.442231
chr19	28129390	28137384	AK075337	7994	0.410183
chr19	28221180	28237138	AK094188	15958	0.455947
chr19	28281400	28284848	LINC00662	3448	0.400232
chr19	28284401	28297182	BC024732	12781	0.450747
chr19	28288976	28289005	DQ586608	29	0.517241
chr19	28926295	29218587	BC068609	292292	0.427374
chr19	29456037	29460055	LINC00906	4018	0.429069
chr19	29493461	29504862	LOC100505835	11401	0.482677
chr19	29698166	29704136	UQCRFS1	5970	0.424791
chr19	29777917	30016659	LOC284395	238742	0.481968
chr19	30017490	30055226	VSTM2B	37736	0.512534
chr19	30097169	30108162	POP4	10993	0.503957
chr19	30156326	30166383	PLEKHF1	10057	0.561798
chr19	30189792	30205963	C19orf12	16171	0.493290
chr19	30189792	30206452	C19orf12	16660	0.501741
chr19	30302900	30315215	CCNE1	12315	0.472270
chr19	30433145	30507519	URI1	74374	0.360691
chr19	30863327	31048965	ZNF536	185638	0.463332
chr19	31398105	31400062	BC040412	1957	0.419520
chr19	31617484	31619766	AX746504	2282	0.511393
chr19	31640782	31641311	DKFZp566F0947	529	0.465028
chr19	31765850	31840190	TSHZ3	74340	0.467729
chr19	32083186	32083945	THEG5	759	0.498024
chr19	32516767	32531305	AK097493	14538	0.446760
chr19	32836513	32878573	ZNF507	42060	0.398074
chr19	32880955	32896445	LOC400684	15490	0.444351
chr19	32896654	32976799	DPY19L3	80145	0.403618
chr19	33072093	33078358	PDCD5	6265	0.452354
chr19	33087906	33166102	ANKRD27	78196	0.485920
chr19	33166312	33169206	RGS9BP	2894	0.617830
chr19	33182866	33204702	NUDT19	21836	0.461257
chr19	33210678	33312166	TDRD12	101488	0.445619
chr19	33321418	33360683	SLC7A9	39265	0.466293
chr19	33350446	33350468	JB050011	22	0.363636
chr19	33369903	33462869	CEP89	92966	0.452778
chr19	33463147	33467960	C19orf40	4813	0.493040
chr19	33469497	33555824	RHPN2	86327	0.483395
chr19	33571785	33621318	GPATCH1	49533	0.457190
chr19	33622997	33666703	WDR88	43706	0.488079
chr19	33685598	33699773	LRP3	14175	0.612134
chr19	33699569	33716756	SLC7A10	17187	0.577995
chr19	33790839	33793430	CEBPA	2591	0.658819
chr19	33793762	33795963	CEBPA-AS1	2201	0.617901
chr19	33865429	33873592	CEBPG	8163	0.412961
chr19	33877854	34012799	PEPD	134945	0.538968
chr19	34112860	34264414	CHST8	151554	0.506414
chr19	34287750	34306666	KCTD15	18916	0.551649
chr19	34663351	34720420	LSM14A	57069	0.398745
chr19	34745455	34846471	KIAA0355	101016	0.449444
chr19	34856031	34893318	GPI	37287	0.525196
chr19	34895302	34917072	PDCD2L	21770	0.450482
chr19	34919267	34960798	UBA2	41531	0.419783
chr19	34972879	34992085	WTIP	19206	0.560085
chr19	35067637	35068596	SCGB1B2P	959	0.635036
chr19	35084345	35085490	SCGB2B2	1145	0.552838
chr19	35085571	35166604	AX748165	81033	0.421063
chr19	35136777	35136957	SCGB2B3P	180	0.511111
chr19	35168566	35177302	ZNF302	8736	0.398008
chr19	35225479	35233774	ZNF181	8295	0.386980
chr19	35248978	35264134	ZNF599	15156	0.435207
chr19	35253778	35263378	ZNF599	9600	0.444792
chr19	35304687	35305097	DQ583499	410	0.560976
chr19	35305701	35305811	DQ571149	110	0.509091
chr19	35305854	35305927	DQ574292	73	0.506849
chr19	35305958	35305988	DQ600156	30	0.466667
chr19	35306029	35306163	DQ588170	134	0.462687
chr19	35306326	35306381	DQ587139	55	0.490909
chr19	35306418	35306453	DQ588120	35	0.571429
chr19	35306480	35306511	DQ578901	31	0.516129
chr19	35306610	35306733	DQ593116	123	0.544715
chr19	35306897	35306939	DQ591726	42	0.500000
chr19	35307057	35323773	LOC400685	16716	0.387413
chr19	35330085	35346208	AK125858	16123	0.452769
chr19	35378787	35378860	DQ595361	73	0.547945
chr19	35378994	35379032	DQ600292	38	0.500000
chr19	35379147	35379184	DQ589456	37	0.540541
chr19	35379281	35379319	DQ591016	38	0.526316
chr19	35379595	35379641	DQ585741	46	0.478261
chr19	35379730	35379767	DQ589171	37	0.486486
chr19	35379968	35379999	DQ572701	31	0.451613
chr19	35380581	35380617	DQ574380	36	0.500000
chr19	35380664	35380718	DQ585554	54	0.518519
chr19	35380902	35380931	DQ579711	29	0.586207
chr19	35381080	35381112	DQ577683	32	0.500000
chr19	35381121	35381188	DQ571071	67	0.492537
chr19	35381266	35381298	DQ574970	32	0.562500
chr19	35381331	35381422	DQ587495	91	0.527473
chr19	35381552	35381596	DQ595165	44	0.500000
chr19	35381867	35381932	DQ570111	65	0.553846
chr19	35382235	35382276	DQ601812	41	0.439024
chr19	35382307	35382339	DQ577903	32	0.468750
chr19	35382401	35382437	DQ590919	36	0.472222
chr19	35382483	35382527	DQ582882	44	0.409091
chr19	35382782	35382814	DQ595116	32	0.500000
chr19	35382932	35389847	LINC00904	6915	0.386117
chr19	35396221	35399094	BC031235	2873	0.505047
chr19	35417806	35436076	ZNF30	18270	0.426984
chr19	35447257	35454953	ZNF792	7696	0.512864
chr19	35491245	35517373	GRAMD1A	26128	0.560548
chr19	35521591	35525174	SCN1B	3583	0.595869
chr19	35531409	35557477	HPN	26068	0.524053
chr19	35549962	35597208	HPN-AS1	47246	0.524277
chr19	35606731	35615228	FXYD3	8497	0.538661
chr19	35615416	35626178	LGI4	10762	0.549340
chr19	35629731	35633954	FXYD1	4223	0.609519
chr19	35634153	35645205	FXYD7	11052	0.523887
chr19	35645624	35660788	FXYD5	15164	0.498879
chr19	35715703	35719628	FAM187B	3925	0.549299
chr19	35739558	35758867	LSR	19309	0.540266
chr19	35759895	35770718	USF2	10823	0.573224
chr19	35773409	35776045	HAMP	2636	0.539454
chr19	35782988	35804709	MAG	21721	0.544588
chr19	35820071	35838264	CD22	18193	0.531468
chr19	35842444	35843367	FFAR1	923	0.679307
chr19	35849487	35851389	FFAR3	1902	0.606730
chr19	35862256	35863301	FFAR3	1045	0.613397
chr19	35896508	35907742	LOC100128682	11234	0.453356
chr19	35940616	35942669	FFAR2	2053	0.538237
chr19	35978225	35981433	KRTDAP	3208	0.536160
chr19	35988118	36004560	DMKN	16442	0.540445
chr19	36014268	36019253	SBSN	4985	0.576530
chr19	36024313	36036221	GAPDHS	11908	0.544676
chr19	36032483	36036394	AX747325	3911	0.562260
chr19	36036501	36038429	TMEM147	1928	0.585581
chr19	36041094	36054560	ATP4A	13466	0.581167
chr19	36103645	36116251	HAUS5	12606	0.544265
chr19	36119979	36128587	RBM42	8608	0.537175
chr19	36132646	36135773	ETV2	3127	0.648865
chr19	36139124	36149686	COX6B1	10562	0.489680
chr19	36157714	36169367	UPK1A	11653	0.524500
chr19	36158849	36164193	UPK1A-AS1	5344	0.514783
chr19	36203829	36207940	ZBTB32	4111	0.582340
chr19	36208920	36229779	KMT2B	20859	0.597680
chr19	36230150	36233520	IGFLR1	3370	0.584866
chr19	36233427	36236336	U2AF1L4	2909	0.559986
chr19	36233429	36235639	U2AF1L4	2210	0.548869
chr19	36236493	36237903	PSENEN	1410	0.543262
chr19	36238143	36244316	AL137752	6173	0.524218
chr19	36239261	36245420	LIN37	6159	0.546517
chr19	36245466	36247930	HSPB6	2464	0.639610
chr19	36249043	36260077	C19orf55	11034	0.547671
chr19	36266416	36279724	ARHGAP33	13308	0.613015
chr19	36279777	36288787	AK055260	9010	0.580577
chr19	36290891	36304201	PRODH2	13310	0.515702
chr19	36316273	36342895	NPHS1	26622	0.508151
chr19	36347809	36358048	KIRREL2	10239	0.553374
chr19	36359400	36370699	APLP1	11299	0.568988
chr19	36379142	36391552	NFKBID	12410	0.536019
chr19	36393381	36395173	HCST	1792	0.589844
chr19	36395302	36399211	TYROBP	3909	0.514454
chr19	36428021	36436097	LRFN3	8076	0.561293
chr19	36486089	36487220	SDHAF1	1131	0.634836
chr19	36494001	36499672	SYNE4	5671	0.554576
chr19	36500021	36505141	ALKBH6	5120	0.563281
chr19	36505410	36536874	BC071809	31464	0.517353
chr19	36505561	36523797	CLIP3	18236	0.525060
chr19	36525886	36545664	THAP8	19778	0.489938
chr19	36545782	36596012	WDR62	50230	0.514513
chr19	36602104	36604613	OVOL3	2509	0.561977
chr19	36604610	36606206	POLR2I	1596	0.609649
chr19	36605887	36616849	TBCB	10962	0.547163
chr19	36630917	36641255	CAPNS1	10338	0.536951
chr19	36641823	36643771	COX7A1	1948	0.631417
chr19	36673186	36705566	ZNF565	32380	0.461581
chr19	36705503	36729675	ZNF146	24172	0.428388
chr19	36802244	36803570	LOC100134317	1326	0.521116
chr19	36803968	36806639	AX746638	2671	0.426058
chr19	36810617	36822620	LINC00665	12003	0.462384
chr19	36825354	36870105	ZFP14	44751	0.426940
chr19	36882860	36909550	ZFP82	26690	0.412814
chr19	36912075	36913799	LOC644189	1724	0.560325
chr19	36936020	36980463	ZNF566	44443	0.408186
chr19	36980528	36981942	LOC728752	1414	0.576379
chr19	37001588	37019248	ZNF260	17660	0.399094
chr19	37034516	37064197	ZNF529	29681	0.400930
chr19	37063971	37085610	BC039524	21639	0.421970
chr19	37096206	37119499	ZNF382	23293	0.411454
chr19	37128282	37157739	ZNF461	29457	0.402451
chr19	37180302	37212225	ZNF567	31923	0.397237
chr19	37234379	37263716	ZNF850	29337	0.429458
chr19	37264056	37266689	AX747375	2633	0.437524
chr19	37266689	37267980	BC024306	1291	0.500387
chr19	37288451	37319013	ZNF790-AS1	30562	0.404947
chr19	37288451	37294910	ZNF790-AS1	6459	0.438148
chr19	37309223	37341689	ZNF790	32466	0.427278
chr19	37341777	37370477	ZNF345	28700	0.399094
chr19	37379025	37406923	ZNF829	27898	0.391032
chr19	37407230	37443645	ZNF568	36415	0.379843
chr19	37464114	37471219	ZNF568	7105	0.445179
chr19	37488105	37489259	AX747376	1154	0.453206
chr19	37527089	37529549	AX747721	2460	0.450813
chr19	37569381	37620651	ZNF420	51270	0.398869
chr19	37641000	37663615	ZNF585A	22615	0.398320
chr19	37672480	37701451	ZNF585B	28971	0.417245
chr19	37717365	37734574	ZNF383	17209	0.414957
chr19	37742827	37754515	BC041478	11688	0.444473
chr19	37756840	37759912	LOC284412	3072	0.523763
chr19	37825579	37855357	HKR1	29778	0.426422
chr19	37862058	37883966	ZNF527	21908	0.406107
chr19	37902059	37958339	ZNF569	56280	0.387367
chr19	37959981	37976242	ZNF570	16261	0.413874
chr19	37997840	38034239	ZNF793	36399	0.427237
chr19	38039850	38078248	ZNF571-AS1	38398	0.409891
chr19	38042272	38105079	ZNF540	62807	0.395625
chr19	38055154	38085673	ZNF571	30519	0.397818
chr19	38053291	38054681	ZNF571	1390	0.336691
chr19	38123388	38146313	ZFP30	22925	0.391538
chr19	38158649	38183216	ZNF781	24567	0.419547
chr19	38187263	38210691	ZNF607	23428	0.415528
chr19	38229202	38270230	ZNF573	41028	0.401043
chr19	38308050	38317278	LOC644554	9228	0.418942
chr19	38308050	38317278	LOC644554	9228	0.418942
chr19	38314362	38345836	LOC100631378	31474	0.439537
chr19	38322408	38322436	DQ589981	28	0.500000
chr19	38375471	38397317	WDR87	21846	0.469697
chr19	38397867	38699008	SIPA1L3	301141	0.497588
chr19	38684376	38684397	JA429823	21	0.857143
chr19	38701648	38714890	DPF1	13242	0.561698
chr19	38741876	38747231	PPP1R14A	5355	0.583940
chr19	38755097	38783254	SPINT2	28157	0.502681
chr19	38794199	38806606	YIF1B	12407	0.564923
chr19	38794803	38795646	C19orf33	843	0.654804
chr19	38810483	38819649	KCNK6	9166	0.536766
chr19	38826442	38861589	CATSPERG	35147	0.530913
chr19	38865189	38874464	PSMD8	9275	0.536173
chr19	38874991	38878668	GGN	3677	0.653522
chr19	38880839	38890523	SPRED3	9684	0.545229
chr19	38893774	38899728	FAM98C	5954	0.547867
chr19	38899697	38916945	RASGRP4	17248	0.535192
chr19	38924339	39078204	RYR1	153865	0.521386
chr19	39078280	39108643	MAP4K1	30363	0.506175
chr19	39109721	39127595	EIF3K	17874	0.503693
chr19	39138266	39221171	ACTN4	82905	0.529341
chr19	39220831	39235114	CAPN12	14283	0.587412
chr19	39261607	39264157	LGALS7	2550	0.587451
chr19	39279849	39282394	LGALS7B	2545	0.588605
chr19	39292310	39303740	LGALS4	11430	0.521172
chr19	39327027	39340617	HNRNPL	13590	0.521192
chr19	39330735	39334744	HNRNPL	4009	0.527563
chr19	39358471	39368919	RINL	10448	0.532351
chr19	39369194	39390502	SIRT2	21308	0.535480
chr19	39390569	39399534	NFKBIB	8965	0.506191
chr19	39399619	39402798	LOC643669	3179	0.601132
chr19	39405903	39421536	SARS2	15633	0.536621
chr19	39421593	39423659	MRPS12	2066	0.554211
chr19	39514662	39523198	FBXO27	8536	0.528351
chr19	39574944	39602128	PAPL	27184	0.493636
chr19	39616419	39670046	PAK4	53627	0.562235
chr19	39687603	39692522	NCCRP1	4919	0.568205
chr19	39693561	39694906	SYCN	1345	0.636431
chr19	39734271	39735609	IFNL3	1338	0.630792
chr19	39738103	39739496	IFNL4	1393	0.692749
chr19	39759156	39760732	IFNL2	1576	0.607234
chr19	39786964	39789312	IFNL1	2348	0.563032
chr19	39797456	39805976	LRFN1	8520	0.574883
chr19	39805994	39811489	BC110060	5495	0.537034
chr19	39818998	39826726	GMFG	7728	0.501812
chr19	39833107	39875537	SAMD4B	42430	0.496394
chr19	39876269	39881835	PAF1	5566	0.524793
chr19	39881962	39891203	MED29	9241	0.525701
chr19	39881962	39891203	MED29	9241	0.525701
chr19	39897486	39900052	ZFP36	2566	0.590803
chr19	39900262	39900318	MIR4530	56	0.767857
chr19	39903749	39919055	PLEKHG2	15306	0.563374
chr19	39923846	39926618	RPS16	2772	0.510823
chr19	39936185	39967308	SUPT5H	31123	0.516435
chr19	39971051	39981528	TIMM50	10477	0.541758
chr19	39989556	39999121	DLL3	9565	0.568113
chr19	40005752	40011326	SELV	5574	0.554898
chr19	40021629	40023494	EID2B	1865	0.489544
chr19	40029446	40030838	EID2	1392	0.526580
chr19	40093168	40098114	LGALS13	4946	0.450667
chr19	40129324	40133041	LOC100129935	3717	0.442292
chr19	40146557	40151287	LGALS16	4730	0.455603
chr19	40170013	40176058	LGALS17A	6045	0.473780
chr19	40194945	40200088	LGALS14	5143	0.452849
chr19	40221892	40228669	CLC	6777	0.438395
chr19	40267233	40276775	LEUTX	9542	0.411549
chr19	40315989	40324841	DYRK1B	8852	0.571735
chr19	40325092	40337054	FBL	11962	0.483531
chr19	40353962	40440533	FCGBP	86571	0.519516
chr19	40476911	40487671	PSMC4	10760	0.500836
chr19	40502942	40523514	ZNF546	20572	0.398406
chr19	40534166	40562115	ZNF780B	27949	0.396472
chr19	40578898	40596845	ZNF780A	17947	0.390204
chr19	40697650	40721482	MAP3K10	23832	0.529582
chr19	40721964	40724306	TTC9B	2342	0.639197
chr19	40728114	40732597	CNTD2	4483	0.574838
chr19	40736223	40791302	AKT2	55079	0.535903
chr19	40788449	40788548	MIR641	99	0.474747
chr19	40826966	40854434	C19orf47	27468	0.500765
chr19	40854331	40884390	PLD3	30059	0.520743
chr19	40885177	40896094	HIPK4	10917	0.539617
chr19	40899670	40919271	PRX	19601	0.558288
chr19	40928408	40931932	SERTAD1	3524	0.546254
chr19	40946747	40950282	SERTAD3	3535	0.546252
chr19	40953690	40971725	BLVRB	18035	0.497810
chr19	40973125	41082365	SPTBN4	109240	0.509301
chr19	41082756	41097305	SHKBP1	14549	0.535295
chr19	41103140	41135725	LTBP4	32585	0.567930
chr19	41171811	41196556	NUMBL	24745	0.523096
chr19	41197433	41222790	ADCK4	25357	0.520093
chr19	41223007	41246765	ITPKC	23758	0.513175
chr19	41246760	41255828	C19orf54	9068	0.547971
chr19	41256758	41271297	SNRPA	14539	0.506637
chr19	41281081	41283398	MIA	2317	0.511006
chr19	41305333	41314346	EGLN2	9013	0.582603
chr19	41284123	41302849	RAB4B	18726	0.519385
chr19	41314348	41316674	AK097370	2326	0.575236
chr19	41349442	41356352	CYP2A6	6910	0.534153
chr19	41381343	41388657	CYP2A7	7314	0.535412
chr19	41396730	41406413	CYP2G1P	9683	0.448931
chr19	41430169	41447773	CYP2B7P1	17604	0.449841
chr19	41497203	41524301	CYP2B6	27098	0.446306
chr19	41594355	41602100	CYP2A13	7745	0.531440
chr19	41620352	41634281	CYP2F1	13929	0.515184
chr19	41641936	41641962	DQ590318	26	0.500000
chr19	41699114	41713444	CYP2S1	14330	0.531542
chr19	41725107	41767671	AXL	42564	0.508599
chr19	41770119	41813811	HNRNPUL1	43692	0.477616
chr19	41816093	41830788	CCDC97	14695	0.535148
chr19	41836811	41859831	TGFB1	23020	0.524109
chr19	41903693	41930910	BCKDHA	27217	0.523423
chr19	41860321	41870078	B9D2	9757	0.523522
chr19	41892275	41903256	EXOSC5	10981	0.523541
chr19	41931263	41934635	B3GNT8	3372	0.642645
chr19	41937222	41945481	ATP5SL	8259	0.505751
chr19	41949062	41950670	C19orf69	1608	0.503109
chr19	41960073	42006554	LOC100505495	46481	0.437491
chr19	42082530	42093197	CEACAM21	10667	0.502953
chr19	42125343	42133442	CEACAM4	8099	0.541425
chr19	42177234	42192096	CEACAM7	14862	0.430157
chr19	42212529	42234437	CEACAM5	21908	0.469600
chr19	42259397	42276113	CEACAM6	16716	0.459261
chr19	42300521	42315591	CEACAM3	15070	0.509688
chr19	42341149	42348508	LYPD4	7359	0.482674
chr19	42349085	42356397	DMRTC2	7312	0.519967
chr19	42363987	42375484	RPS19	11497	0.532835
chr19	42381189	42385439	CD79A	4250	0.590118
chr19	42388445	42411604	ARHGEF1	23159	0.575284
chr19	42460832	42463528	RABAC1	2696	0.616098
chr19	42470733	42498428	ATP1A3	27695	0.558946
chr19	42502467	42569957	GRIK5	67490	0.511661
chr19	42580289	42585720	ZNF574	5431	0.586816
chr19	42590261	42636625	POU2F2	46364	0.510116
chr19	42636780	42641251	LOC100505622	4471	0.564303
chr19	42637596	42637665	MIR4323	69	0.739130
chr19	42656720	42661675	AK024119	4955	0.571746
chr19	42702744	42721944	DEDD2	19200	0.523854
chr19	42702744	42724304	DEDD2	21560	0.527041
chr19	42724491	42732353	ZNF526	7862	0.543755
chr19	42734337	42746736	GSK3A	12399	0.531736
chr19	42751716	42759309	ERF	7593	0.640853
chr19	42776563	42776591	DQ597999	28	0.678571
chr19	42788816	42799949	CIC	11133	0.618162
chr19	42801184	42806952	PAFAH1B3	5768	0.537968
chr19	42806283	42814973	PRR19	8690	0.541082
chr19	42817476	42829214	TMEM145	11738	0.571392
chr19	42829760	42882921	MEGF8	53161	0.547488
chr19	42891170	42894444	CNFN	3274	0.582773
chr19	42901299	43156507	LIPE-AS1	255208	0.460283
chr19	42905665	42931578	LIPE	25913	0.549570
chr19	42927906	43156507	LIPE-AS1	228601	0.450024
chr19	42932694	42947136	CXCL17	14442	0.432627
chr19	43011457	43032661	CEACAM1	21204	0.462601
chr19	43084394	43099082	CEACAM8	14688	0.442334
chr19	43225793	43244668	PSG3	18875	0.436821
chr19	43258384	43269831	PSG8	11447	0.469555
chr19	43326014	43331030	LOC100289650	5016	0.478469
chr19	43341148	43359870	PSG10P	18722	0.434462
chr19	43696853	43709926	PSG4	13073	0.457661
chr19	43428283	43441330	PSG7	13047	0.453208
chr19	43511808	43530631	PSG11	18823	0.432025
chr19	43568361	43586893	PSG2	18532	0.434222
chr19	43671894	43690688	PSG5	18794	0.433543
chr19	43715942	43752798	LOC284344	36856	0.411656
chr19	43757434	43773682	PSG9	16248	0.441347
chr19	43853207	43853700	PRG1	493	0.519270
chr19	43857824	43867480	CD177	9656	0.559756
chr19	43919034	43922767	TEX101	3733	0.494508
chr19	43964945	43969831	LYPD3	4886	0.570405
chr19	43979254	44008985	PHLDB3	29731	0.505398
chr19	44010870	44031396	ETHE1	20526	0.485823
chr19	44037339	44040284	ZNF575	2945	0.613582
chr19	44047463	44079730	XRCC1	32267	0.505532
chr19	44080951	44086256	PINLYP	5305	0.533270
chr19	44088518	44100287	IRGQ	11769	0.526978
chr19	44100737	44104587	ZNF576	3850	0.501558
chr19	44116252	44118650	SRRM5	2398	0.547540
chr19	44111375	44124014	ZNF428	12639	0.527020
chr19	44126521	44143991	CADM4	17470	0.532856
chr19	44152722	44174498	PLAUR	21776	0.503490
chr19	44220213	44224169	IRGC	3956	0.584934
chr19	44235300	44259142	SMG9	23842	0.499874
chr19	44270684	44285409	KCNN4	14725	0.551579
chr19	44300078	44306613	LYPD5	6535	0.534353
chr19	44326208	44331358	AK131520	5150	0.399612
chr19	44331472	44353050	ZNF283	21578	0.388729
chr19	44376514	44384288	ZNF404	7774	0.354258
chr19	44395955	44405955	LOC100505715	10000	0.392200
chr19	44416775	44439411	ZNF45	22636	0.413456
chr19	44455396	44471752	ZNF221	16356	0.412326
chr19	44488321	44502477	ZNF155	14156	0.420882
chr19	44502550	44506988	AK090553	4438	0.386661
chr19	44507076	44518072	ZNF230	10996	0.409149
chr19	44529493	44537262	ZNF222	7769	0.420517
chr19	44556163	44572142	ZNF223	15979	0.434320
chr19	44576296	44591623	ZNF284	15327	0.438051
chr19	44598481	44612479	ZNF224	13998	0.406844
chr19	44609491	44617336	LOC100379224	7845	0.396558
chr19	44617547	44637255	ZNF225	19708	0.417546
chr19	44632606	44634853	AX748287	2247	0.410770
chr19	44645709	44664462	ZNF234	18753	0.417160
chr19	44669214	44681838	ZNF226	12624	0.406527
chr19	44716690	44741421	ZNF227	24731	0.411184
chr19	44790500	44809178	ZNF235	18678	0.383178
chr19	44764032	44779470	ZNF233	15438	0.422334
chr19	44830705	44860856	ZFP112	30151	0.380352
chr19	44930425	44952665	ZNF229	22240	0.419155
chr19	44979858	45004574	ZNF180	24716	0.442911
chr19	45010210	45033548	CEACAM20	23338	0.465121
chr19	45041044	45060150	CEACAM22P	19106	0.450748
chr19	45116939	45140081	IGSF23	23142	0.481765
chr19	45147097	45169428	PVR	22331	0.500515
chr19	45156955	45157002	MIR4531	47	0.574468
chr19	45174723	45187627	CEACAM19	12904	0.505890
chr19	45202420	45213986	CEACAM16	11566	0.542366
chr19	45251977	45263301	BCL3	11324	0.581420
chr19	45281125	45303903	CBLC	22778	0.534902
chr19	45312315	45324678	BCAM	12363	0.589258
chr19	45349392	45392485	PVRL2	43093	0.528369
chr19	45394476	45406946	TOMM40	12470	0.559663
chr19	45409038	45412650	APOE	3612	0.610465
chr19	45417920	45422606	APOC1	4686	0.530516
chr19	45430059	45434643	APOC1P1	4584	0.523342
chr19	45445494	45452822	APOC4-APOC2	7328	0.540666
chr19	45458598	45496604	CLPTM1	38006	0.528022
chr19	45504706	45541456	RELB	36750	0.512381
chr19	45542297	45574214	CLASRP	31917	0.540151
chr19	45574757	45579688	ZNF296	4931	0.592375
chr19	45582517	45594782	GEMIN7	12265	0.502894
chr19	45596430	45650543	PPP1R37	54113	0.555430
chr19	45653007	45663408	NKPD1	10401	0.615037
chr19	45666185	45681501	TRAPPC6A	15316	0.568490
chr19	45682002	45685058	BLOC1S3	3056	0.595223
chr19	45715878	45737469	EXOC3L2	21591	0.516048
chr19	45754515	45783992	MARK4	29477	0.529531
chr19	45754515	45808541	MARK4	54026	0.521101
chr19	45809670	45826235	CKM	16565	0.530637
chr19	45843997	45854778	KLC3	10781	0.584269
chr19	45854648	45873845	ERCC2	19197	0.563265
chr19	45882891	45909607	PPP1R13L	26716	0.534436
chr19	45909466	45914024	CD3EAP	4558	0.533129
chr19	45910590	45927177	ERCC1	16587	0.530295
chr19	45971252	45978437	FOSB	7185	0.575783
chr19	45988545	46000313	RTN2	11768	0.541298
chr19	46001730	46005764	PPM1N	4034	0.553793
chr19	46010687	46030240	VASP	19553	0.541656
chr19	46031024	46088122	OPA3	57098	0.488511
chr19	46093022	46105466	GPR4	12444	0.529974
chr19	46112657	46148775	EML2	36118	0.526386
chr19	46142251	46142345	MIR330	94	0.606383
chr19	46144904	46146092	LOC100287177	1188	0.619529
chr19	46171501	46185717	GIPR	14216	0.549733
chr19	46178185	46178282	MIR642A	97	0.546392
chr19	46178189	46178266	MIR642B	77	0.558442
chr19	46190711	46195443	SNRPD2	4732	0.517540
chr19	46195740	46207248	QPCTL	11508	0.525634
chr19	46213886	46234151	FBXO46	20265	0.514434
chr19	46217644	46220639	AX746967	2995	0.479132
chr19	46242887	46262748	LOC388553	19861	0.507779
chr19	46268042	46272497	SIX5	4455	0.676768
chr19	46272975	46285815	DMPK	12840	0.590576
chr19	46286263	46290129	DMWD	3866	0.622607
chr19	46286263	46296060	DMWD	9797	0.577320
chr19	46298967	46318605	RSPH6A	19638	0.527549
chr19	46318699	46366548	SYMPK	47849	0.515685
chr19	46367517	46377055	FOXA3	9538	0.527574
chr19	46386865	46389376	IRF2BP1	2511	0.685783
chr19	46393280	46405862	MYPOP	12582	0.540773
chr19	46416472	46418036	NANOS2	1564	0.596547
chr19	46442770	46476657	NOVA2	33887	0.504058
chr19	46498718	46521874	CCDC61	23156	0.521852
chr19	46522189	46522307	MIR769	118	0.618644
chr19	46522411	46526556	PGLYRP1	4145	0.582871
chr19	46543005	46544274	IGFL4	1269	0.517730
chr19	46560931	46580887	AK096622	19956	0.418922
chr19	46623327	46627931	IGFL3	4604	0.389227
chr19	46651499	46664561	IGFL2	13062	0.410351
chr19	46692285	46706319	BC062328	14034	0.493658
chr19	46713418	46718094	DKFZp434J0226	4676	0.518820
chr19	46720994	46809806	RNU6-66P	88812	0.474632
chr19	46733008	46734500	IGFL1	1492	0.563003
chr19	46800302	46846690	HIF3A	46388	0.502005
chr19	46850250	46894232	PPP5C	43982	0.504775
chr19	46913585	46916919	CCDC8	3334	0.594181
chr19	46969747	46974820	PNMAL1	5073	0.525527
chr19	46984044	47104457	PPP5D1	120413	0.473927
chr19	46994447	46999169	PNMAL2	4722	0.639136
chr19	46997764	46999755	BC132841	1991	0.630337
chr19	47104511	47114039	CALM3	9528	0.571474
chr19	47123724	47128354	PTGIR	4630	0.590065
chr19	47137332	47137939	GNG8	607	0.678748
chr19	47150868	47164395	DACT3	13527	0.547867
chr19	47164734	47174598	DACT3-AS1	9864	0.477697
chr19	47177572	47220384	PRKD2	42812	0.519527
chr19	47212549	47212602	MIR320E	53	0.547170
chr19	47222767	47249720	STRN4	26953	0.571291
chr19	47249302	47261832	FKRP	12530	0.549242
chr19	47278139	47291842	SLC1A5	13703	0.543895
chr19	47333841	47333961	SNAR-E	120	0.583333
chr19	47341422	47354203	AP2S1	12781	0.528597
chr19	47421932	47508333	ARHGAP35	86401	0.479601
chr19	47524142	47549017	NPAS1	24875	0.546090
chr19	47549166	47551882	TMEM160	2716	0.615611
chr19	47567446	47617009	ZC3H4	49563	0.519581
chr19	47634079	47713893	SAE1	79814	0.468615
chr19	47724078	47734451	BBC3	10373	0.600983
chr19	47730198	47730278	MIR3190	80	0.662500
chr19	47730200	47730276	MIR3191	76	0.657895
chr19	47759730	47775210	CCDC9	15480	0.559432
chr19	47778141	47778980	PRR24	839	0.703218
chr19	47813103	47825327	C5AR1	12224	0.496973
chr19	47835403	47845272	C5AR2	9869	0.506434
chr19	47852537	47885961	DHX34	33424	0.542305
chr19	47906374	47922785	MEIS3	16411	0.565231
chr19	47919152	47921155	MEIS3	2003	0.593610
chr19	47931278	47975307	SLC8A2	44029	0.529833
chr19	47978399	47987521	KPTN	9122	0.534642
chr19	47987538	48004854	NAPA-AS1	17316	0.569011
chr19	47990890	48018515	NAPA	27625	0.555258
chr19	48023941	48059113	ZNF541	35172	0.498578
chr19	48111452	48206534	GLTSCR1	95082	0.518942
chr19	48216600	48246391	EHD2	29791	0.529556
chr19	48248792	48260435	GLTSCR2	11643	0.573048
chr19	48259109	48259219	SNORD23	110	0.700000
chr19	48281841	48287943	SEPW1	6102	0.543756
chr19	48304499	48306930	TPRX1	2431	0.610448
chr19	48325098	48346586	CRX	21488	0.486737
chr19	48325098	48339651	CRX	14553	0.493850
chr19	48373722	48389654	SULT2A1	15932	0.466671
chr19	48410934	48411056	SNAR-A12	122	0.631148
chr19	48416307	48416427	SNAR-C2	120	0.583333
chr19	48421685	48421807	SNAR-A1	122	0.639344
chr19	48427035	48427156	SNAR-A3	121	0.636364
chr19	48432074	48432194	SNAR-C2	120	0.583333
chr19	48437437	48437559	SNAR-A1	122	0.639344
chr19	48442797	48442917	SNAR-C4	120	0.583333
chr19	48448178	48448300	SNAR-A12	122	0.631148
chr19	48453552	48453671	SNAR-C3	119	0.596639
chr19	48458938	48459058	SNAR-C2	120	0.583333
chr19	48471302	48495427	BSPH1	24125	0.414135
chr19	48497907	48528410	ELSPBP1	30503	0.446022
chr19	48532639	48547311	CABP5	14672	0.467557
chr19	48551099	48614109	PLA2G4C	63010	0.476861
chr19	48618702	48673560	LIG1	54858	0.513854
chr19	48673948	48700877	C19orf68	26929	0.500390
chr19	48711342	48744320	CARD8	32978	0.435957
chr19	48758931	48761450	LOC100505812	2519	0.383882
chr19	48774501	48790863	ZNF114	16362	0.492483
chr19	48799708	48823332	CCDC114	23624	0.516043
chr19	48828628	48833810	EMP3	5182	0.530104
chr19	48835615	48867186	TMEM143	31571	0.516740
chr19	48867650	48879634	SYNGR4	11984	0.548148
chr19	48885826	48894810	KDELR1	8984	0.533504
chr19	48898131	48948188	GRIN2D	50057	0.525761
chr19	48949029	48960278	GRWD1	11249	0.558094
chr19	48958963	48969367	KCNJ14	10404	0.521915
chr19	48968867	48972950	BC042033	4083	0.549596
chr19	48972464	48985571	CYTH2	13107	0.581827
chr19	48988527	49016446	LMTK3	27919	0.584011
chr19	49055428	49102684	SULT2B1	47256	0.517056
chr19	49103856	49116694	FAM83E	12838	0.558187
chr19	49109999	49110971	SPACA4	972	0.601852
chr19	49118583	49122675	RPL18	4092	0.564761
chr19	49122789	49133663	SPHK2	10874	0.565017
chr19	49133816	49140639	DBP	6823	0.580976
chr19	49141271	49149451	CA11	8180	0.538386
chr19	49141295	49185502	SEC1P	44207	0.539462
chr19	49164663	49176264	NTN5	11601	0.573140
chr19	49199227	49209191	FUT2	9964	0.515556
chr19	49216254	49222976	MAMSTR	6722	0.582565
chr19	49223841	49243970	RASIP1	20129	0.536639
chr19	49244144	49250166	IZUMO1	6022	0.529226
chr19	49251267	49258647	FUT1	7380	0.558672
chr19	49259147	49261582	FGF21	2435	0.607803
chr19	49298318	49314320	BCAT2	16002	0.545869
chr19	49316273	49339934	HSD17B14	23661	0.514856
chr19	49340353	49371884	PLEKHA4	31531	0.510735
chr19	49375648	49379319	PPP1R15A	3671	0.566876
chr19	49384221	49401996	TULP2	17775	0.512405
chr19	49403306	49426540	NUCB1	23234	0.528105
chr19	49436938	49448226	DHDH	11288	0.525691
chr19	49458116	49464519	BAX	6403	0.530689
chr19	49468565	49470136	FTL	1571	0.558243
chr19	49471381	49496610	GYS1	25229	0.525665
chr19	49497155	49519182	RUVBL2	22027	0.529214
chr19	49519236	49520347	LHB	1111	0.641764
chr19	49521504	49522741	LOC101059948	1237	0.604689
chr19	49526125	49527632	CGB	1507	0.646981
chr19	49534925	49535044	SNAR-G2	119	0.588235
chr19	49535129	49536495	CGB2	1366	0.639824
chr19	49538825	49540191	CGB1	1366	0.637628
chr19	49540276	49540404	SNAR-G1	128	0.546875
chr19	49547101	49548568	CGB5	1467	0.648943
chr19	49550894	49552368	CGB8	1474	0.646540
chr19	49558617	49568333	NTF4	9716	0.581000
chr19	49564396	49567119	NTF4	2723	0.543885
chr19	49570674	49576198	KCNA7	5524	0.581825
chr19	49605409	49611870	SNRNP70	6461	0.593561
chr19	49588464	49611870	SNRNP70	23406	0.535589
chr19	49617617	49621717	LIN7B	4100	0.586098
chr19	49621653	49622397	C19orf73	744	0.630376
chr19	49622662	49654280	PPFIA3	31618	0.552185
chr19	49654455	49658681	HRC	4226	0.578798
chr19	49661015	49715098	TRPM4	54083	0.502894
chr19	49792891	49828474	SLC6A16	35583	0.430711
chr19	49812053	49812125	MIR4324	72	0.513889
chr19	49834803	49843559	AK097351	8756	0.558474
chr19	49838676	49843861	CD37	5185	0.590164
chr19	49843852	49865714	TEAD2	21862	0.535724
chr19	49867041	49878373	DKKL1	11332	0.486851
chr19	49891474	49921256	CCDC155	29782	0.535424
chr19	49925670	49926698	PTH2	1028	0.642996
chr19	49929687	49932075	LOC100507003	2388	0.605109
chr19	49932654	49944808	SLC17A7	12154	0.576683
chr19	49946967	49947386	BC128433	419	0.577566
chr19	49949549	49955115	PIH1D1	5566	0.563061
chr19	49956472	49974305	ALDH16A1	17833	0.568328
chr19	49977465	49989488	FLT3LG	12023	0.539965
chr19	49990810	49995564	RPL13A	4754	0.534077
chr19	49993222	49993304	SNORD32A	82	0.512195
chr19	49993873	49993956	SNORD33	83	0.542169
chr19	49994163	49994229	SNORD34	66	0.500000
chr19	49994431	49994517	SNORD35A	86	0.546512
chr19	49999621	50002969	RPS11	3348	0.531362
chr19	50000975	50001062	SNORD35B	87	0.494253
chr19	50004041	50004125	MIR150	84	0.666667
chr19	50016435	50029685	FCGRT	13250	0.524302
chr19	50028312	50029685	FCGRT	1373	0.595047
chr19	50030874	50046890	RCN3	16016	0.541771
chr19	50058724	50083829	NOSIP	25105	0.499064
chr19	50084586	50094265	PRRG2	9679	0.538485
chr19	50094911	50129696	PRR12	34785	0.554923
chr19	50138551	50143400	RRAS	4849	0.590637
chr19	50145381	50161906	SCAF1	16525	0.582088
chr19	50162825	50169132	IRF3	6307	0.571746
chr19	50168398	50177173	BCL2L12	8775	0.543362
chr19	50180408	50191707	PRMT1	11299	0.584300
chr19	50185327	50185411	MIR5088	84	0.702381
chr19	50191941	50194247	ADM5	2306	0.625325
chr19	50194364	50216988	CPT1C	22624	0.529482
chr19	50243010	50266515	TSKS	23505	0.513338
chr19	50270179	50310369	AP2A1	40190	0.545982
chr19	50304803	50307797	AP2A1	2994	0.620241
chr19	50310123	50316567	FUZ	6444	0.573867
chr19	50321535	50340237	MED25	18702	0.560742
chr19	50341902	50354933	PTOV1-AS1	13031	0.496739
chr19	50354415	50363999	PTOV1	9584	0.614775
chr19	50357847	50357908	MIR4749	61	0.704918
chr19	50364459	50370822	PNKP	6363	0.599874
chr19	50372289	50381613	AKT1S1	9324	0.597919
chr19	50380681	50392007	TBC1D17	11326	0.574872
chr19	50390638	50400147	IL4I1	9509	0.614681
chr19	50391431	50391487	MIR4750	56	0.750000
chr19	50410083	50432799	NUP62	22716	0.542305
chr19	50432399	50437193	ATF5	4794	0.552149
chr19	50452249	50464429	SIGLEC11	12180	0.520525
chr19	50472911	50479076	SIGLEC16	6165	0.580535
chr19	50474558	50476964	SIGLEC16	2406	0.611388
chr19	50479723	50528805	VRK3	49082	0.508639
chr19	50529211	50552031	ZNF473	22820	0.484575
chr19	50553936	50570052	FLJ26850	16116	0.457061
chr19	50595745	50595866	SNAR-A3	121	0.636364
chr19	50601082	50601203	SNAR-A3	121	0.636364
chr19	50604147	50604268	SNAR-A3	121	0.636364
chr19	50607211	50607332	SNAR-A3	121	0.636364
chr19	50610270	50610391	SNAR-A3	121	0.636364
chr19	50615624	50615745	SNAR-A3	121	0.636364
chr19	50620976	50621097	SNAR-A3	121	0.636364
chr19	50626330	50626451	SNAR-A3	121	0.636364
chr19	50631658	50631779	SNAR-A3	121	0.636364
chr19	50637001	50637121	SNAR-B2	120	0.600000
chr19	50642374	50642494	SNAR-B2	120	0.600000
chr19	50643458	50643577	SNAR-D	119	0.588235
chr19	50655804	50666538	IZUMO2	10734	0.482206
chr19	50706884	50813801	MYH14	106917	0.510574
chr19	50818764	50832634	KCNC3	13870	0.595314
chr19	50837056	50848005	NAPSB	10949	0.493835
chr19	50861733	50868931	NAPSA	7198	0.524868
chr19	50879491	50886285	NR1H2	6794	0.599941
chr19	50887579	50921275	POLD1	33696	0.549976
chr19	50922194	50934309	SPIB	12115	0.543789
chr19	50936159	50969583	MYBPC2	33424	0.537817
chr19	50970044	50980003	FAM71E1	9959	0.530676
chr19	50979735	50986608	EMC10	6873	0.604249
chr19	50988163	50990120	AX746478	1957	0.519673
chr19	51009253	51014416	JOSD2	5163	0.612435
chr19	51014856	51017142	ASPDH	2286	0.624234
chr19	51020149	51071302	LRRC4B	51153	0.551190
chr19	51108219	51108342	SNAR-F	123	0.569106
chr19	51125233	51143092	SYT3	17859	0.539168
chr19	51152701	51162567	C19orf81	9866	0.508717
chr19	51165083	51220195	SHANK1	55112	0.556848
chr19	51226604	51228981	CLEC11A	2377	0.664283
chr19	51273720	51274989	GPR32	1269	0.557132
chr19	51288984	51289467	GQ868703	483	0.583851
chr19	51293671	51298481	ACPT	4810	0.580457
chr19	51300960	51307974	C19orf48	7014	0.547904
chr19	51302285	51302382	SNORD88B	97	0.670103
chr19	51302695	51302792	SNORD88A	97	0.711340
chr19	51305581	51305678	SNORD88C	97	0.649485
chr19	51320936	51322134	MGC45922	1198	0.622705
chr19	51322403	51327043	KLK1	4640	0.591379
chr19	51328544	51334779	KLK15	6235	0.531676
chr19	51358170	51364020	KLK3	5850	0.556752
chr19	51376688	51383823	KLK2	7135	0.545200
chr19	51385351	51392441	KLKP1	7090	0.466150
chr19	51409607	51413994	KLK4	4387	0.558468
chr19	51446558	51456344	KLK5	9786	0.509503
chr19	51461886	51472047	KLK6	10161	0.522586
chr19	51479734	51487320	KLK7	7586	0.558002
chr19	51499263	51504965	KLK8	5702	0.520694
chr19	51505663	51512890	KLK9	7227	0.498685
chr19	51515999	51523431	KLK10	7432	0.562971
chr19	51525486	51531290	KLK11	5804	0.570124
chr19	51532347	51538148	KLK12	5801	0.542493
chr19	51559462	51568367	KLK13	8905	0.453004
chr19	51581153	51587502	KLK14	6349	0.561663
chr19	51600862	51611647	CTU1	10785	0.543533
chr19	51628136	51633567	SIGLEC9	5431	0.533972
chr19	51645557	51656783	SIGLEC7	11226	0.489221
chr19	51656179	51685222	BC045766	29043	0.463210
chr19	51670584	51676780	SIGLEC17P	6196	0.479987
chr19	51728334	51743274	CD33	14940	0.434471
chr19	51760963	51772582	SIGLECL1	11619	0.427576
chr19	51815101	51834102	IGLON5	19001	0.551708
chr19	51834794	51845378	VSIG10L	10584	0.548564
chr19	51848408	51858096	ETFB	9688	0.524670
chr19	51870351	51872257	CLDND2	1906	0.660546
chr19	51874873	51875960	NKG7	1087	0.593376
chr19	51883162	51891210	LIM2	8048	0.491426
chr19	51891542	51893828	LOC147646	2286	0.556868
chr19	51913274	51921057	SIGLEC10	7783	0.539381
chr19	51919159	51920679	LOC100129083	1520	0.598684
chr19	51954250	51961708	SIGLEC8	7458	0.520917
chr19	51979837	51986611	CEACAM18	6774	0.495571
chr19	51994612	52005043	SIGLEC12	10431	0.504170
chr19	52022783	52035110	SIGLEC6	12327	0.478462
chr19	52074530	52092991	ZNF175	18461	0.409999
chr19	52094258	52095761	AX748312	1503	0.483034
chr19	52095035	52097633	FLJ30403	2598	0.528483
chr19	52114755	52133727	SIGLEC5	18972	0.453774
chr19	52145805	52150132	SIGLEC14	4327	0.549110
chr19	52195864	52195934	MIR99B	70	0.671429
chr19	52196038	52196117	MIRLET7E	79	0.569620
chr19	52196506	52196592	MIR125A	86	0.593023
chr19	52196592	52208443	LINC00085	11851	0.539870
chr19	52216364	52227221	HAS1	10857	0.495072
chr19	52249022	52255150	FPR1	6128	0.465894
chr19	52264452	52273779	FPR2	9327	0.437011
chr19	52298410	52329334	FPR3	30924	0.428211
chr19	52374550	52391229	ZNF577	16679	0.415253
chr19	52392487	52408305	ZNF649	15818	0.434062
chr19	52430687	52449011	ZNF613	18324	0.419286
chr19	52452414	52484615	BC014606	32201	0.423776
chr19	52467592	52490079	ZNF350	22487	0.421266
chr19	52494585	52496450	AK128361	1865	0.341555
chr19	52494586	52511483	ZNF615	16897	0.390543
chr19	52516576	52531680	ZNF614	15104	0.414129
chr19	52536676	52552073	ZNF432	15397	0.407937
chr19	52567718	52599018	ZNF841	31300	0.411118
chr19	52617652	52643191	ZNF616	25539	0.424566
chr19	52658124	52674896	ZNF836	16772	0.429466
chr19	52693054	52729678	PPP2R1A	36624	0.483017
chr19	52772823	52795976	ZNF766	23153	0.454196
chr19	52785049	52785143	MIR643	94	0.393617
chr19	52800425	52829174	ZNF480	28749	0.424154
chr19	52803945	52848482	AK097759	44537	0.433886
chr19	52839497	52870376	ZNF610	30879	0.449173
chr19	52873169	52889046	ZNF880	15877	0.418656
chr19	52892094	52892698	AK097590	604	0.461921
chr19	52897579	52901010	AK097590	3431	0.455552
chr19	52901120	52921657	ZNF528	20537	0.436578
chr19	52934660	52942699	ZNF534	8039	0.419580
chr19	52956828	53020131	ZNF578	63303	0.440895
chr19	52956828	52961407	ZNF578	4579	0.475431
chr19	53030908	53059303	ZNF808	28395	0.450431
chr19	53073916	53090427	ZNF701	16511	0.457210
chr19	53099936	53103405	ZNF137P	3469	0.447968
chr19	53115617	53141644	ZNF83	26027	0.454912
chr19	53206065	53238307	ZNF611	32242	0.460921
chr19	53268747	53290034	ZNF600	21287	0.454550
chr19	53300660	53324922	ZNF28	24262	0.459855
chr19	53341784	53360902	ZNF468	19118	0.439743
chr19	53379424	53394599	ZNF320	15175	0.426227
chr19	53452631	53466164	ZNF816	13533	0.439297
chr19	53471503	53496784	ZNF702P	25281	0.447807
chr19	53510764	53516424	AK127846	5660	0.493993
chr19	53517343	53519833	ERVV-1	2490	0.480321
chr19	53547990	53554380	ERVV-2	6390	0.487480
chr19	53569866	53606687	ZNF160	36821	0.452595
chr19	53611131	53636173	ZNF415	25042	0.453079
chr19	53641956	53662322	ZNF347	20366	0.431896
chr19	53666551	53696619	ZNF665	30068	0.458694
chr19	53716200	53719355	ZNF818P	3155	0.425990
chr19	53738637	53758111	ZNF677	19474	0.387850
chr19	53761544	53762855	VN1R2	1311	0.466056
chr19	53770012	53770918	VN1R4	906	0.486755
chr19	53785542	53787602	FAM90A27P	2060	0.533981
chr19	53792853	53794875	BIRC8	2022	0.484174
chr19	53837001	53858122	ZNF845	21121	0.441693
chr19	53898396	53915262	ZNF765	16866	0.430748
chr19	53868967	53889841	ZNF525	20874	0.428188
chr19	53935226	53961515	ZNF761	26289	0.442390
chr19	53970988	53997546	ZNF813	26558	0.439491
chr19	53994210	53997547	ZNF813	3337	0.371891
chr19	54041539	54083523	ZNF331	41984	0.449743
chr19	54102884	54106751	LOC284379	3867	0.500646
chr19	54135309	54140263	DPRX	4954	0.480016
chr19	54169926	54170024	MIR512-2	98	0.540816
chr19	54172410	54172508	MIR512-2	98	0.540816
chr19	54175221	54175294	MIR1323	73	0.465753
chr19	54175231	54175253	JA715141	22	0.409091
chr19	54177450	54177574	MIR498	124	0.475806
chr19	54178964	54179051	MIR520E	87	0.436782
chr19	54182256	54182339	MIR515-1	83	0.421687
chr19	54183193	54183277	MIR519E	84	0.392857
chr19	54185412	54185499	MIR520F	87	0.482759
chr19	54188262	54188345	MIR515-1	83	0.421687
chr19	54189722	54189809	MIR519C	87	0.425287
chr19	54191734	54191821	MIR1283-1	87	0.436782
chr19	54194134	54194219	MIR520A	85	0.482353
chr19	54197646	54197729	MIR526B	83	0.457831
chr19	54198466	54198547	MIR519B	81	0.432099
chr19	54200786	54200871	MIR525	85	0.470588
chr19	54201638	54201725	MIR523	87	0.482759
chr19	54203268	54203355	MIR518F	87	0.413793
chr19	54204480	54204541	MIR520B	61	0.459016
chr19	54205990	54206073	MIR518B	83	0.493976
chr19	54209505	54209590	MIR526A1	85	0.458824
chr19	54210706	54210793	MIR520C	87	0.448276
chr19	54211988	54212089	MIR518C	101	0.445545
chr19	54214255	54214342	MIR524	87	0.471264
chr19	54215521	54215608	MIR517A	87	0.425287
chr19	54216600	54216688	MIR519D	88	0.465909
chr19	54219847	54219934	MIR521-2	87	0.436782
chr19	54223349	54223436	MIR520D	87	0.425287
chr19	54224329	54224396	MIR517B	67	0.447761
chr19	54225419	54225509	MIR520G	90	0.444444
chr19	54228695	54228780	MIR516B2	85	0.411765
chr19	54230175	54230240	MIR526A2	65	0.446154
chr19	54233091	54233179	MIR518E	88	0.477273
chr19	54234259	54234344	MIR518A1	85	0.470588
chr19	54238130	54238217	MIR518D	87	0.494253
chr19	54240098	54240188	MIR516B1	90	0.422222
chr19	54242586	54242673	MIR518A2	87	0.471264
chr19	54244566	54244661	MIR517C	95	0.421053
chr19	54245765	54245853	MIR520H	88	0.431818
chr19	54251889	54251976	MIR521-1	87	0.448276
chr19	54254464	54254551	MIR522	87	0.448276
chr19	54255650	54255735	MIR519A1	85	0.447059
chr19	54257271	54257356	MIR527	85	0.423529
chr19	54259994	54260084	MIR516A1	90	0.444444
chr19	54261485	54261572	MIR1283-2	87	0.425287
chr19	54264386	54264476	MIR516A2	90	0.433333
chr19	54265597	54265684	MIR519A2	87	0.448276
chr19	54290928	54291210	MIR372	282	0.535461
chr19	54290930	54290996	MIR371B	66	0.530303
chr19	54291958	54292027	MIR373	69	0.507246
chr19	54296854	54327657	NLRP12	30803	0.494270
chr19	54369610	54379689	MYADM	10079	0.582002
chr19	54385466	54410901	PRKCG	25435	0.527973
chr19	54415990	54446969	CACNG7	30979	0.505342
chr19	54466289	54493469	CACNG8	27180	0.531163
chr19	54495541	54515920	CACNG6	20379	0.495216
chr19	54544079	54567207	VSTM1	23128	0.463464
chr19	54573200	54584634	TARM1	11434	0.493178
chr19	54597932	54604242	OSCAR	6310	0.540729
chr19	54606159	54610281	NDUFA3	4122	0.539544
chr19	54610319	54619055	TFPT	8736	0.550252
chr19	54618789	54635150	PRPF31	16361	0.570686
chr19	54641435	54659446	CNOT3	18011	0.578813
chr19	54659378	54663446	LENG1	4068	0.548918
chr19	54663833	54676944	TMC4	13111	0.560522
chr19	54677105	54693733	MBOAT7	16628	0.550577
chr19	54695103	54698394	TSEN34	3291	0.515649
chr19	54704725	54711515	RPS9	6790	0.501473
chr19	54720146	54726959	LILRB3	6813	0.598855
chr19	54754269	54761167	LILRB5	6898	0.595535
chr19	54777674	54785033	LILRB2	7359	0.578068
chr19	54785963	54786035	MIR4752	72	0.472222
chr19	54818352	54824409	LILRA5	6057	0.506852
chr19	54844691	54850421	LILRA4	5730	0.530716
chr19	54865234	54876721	LAIR1	11487	0.511796
chr19	54926604	54947899	TTYH1	21295	0.587180
chr19	54960064	54973196	LENG8	13132	0.589857
chr19	54972978	54974894	LENG9	1916	0.672234
chr19	54976209	54984422	CDC42EP5	8213	0.540363
chr19	55014012	55021900	LAIR2	7888	0.516861
chr19	55048120	55055195	KIR3DX1	7075	0.496537
chr19	55105040	55113687	LILRA1	8647	0.508731
chr19	55141967	55149004	LILRB1	7037	0.595282
chr19	55174123	55179846	LILRB4	5723	0.577145
chr19	55219600	55224887	LILRP2	5287	0.460564
chr19	55235983	55248003	KIR3DL3	12020	0.490100
chr19	55281264	55295778	KIR2DL1	14514	0.483258
chr19	55361897	55378670	KIR3DL2	16773	0.470697
chr19	55280873	55282516	GQ422373	1643	0.536823
chr19	55385548	55401838	FCAR	16290	0.479681
chr19	55417507	55424439	NCR1	6932	0.501298
chr19	55434876	55458873	NLRP7	23997	0.497854
chr19	55471012	55471043	RNU6-64P	31	0.387097
chr19	55476651	55512510	NLRP2	35859	0.488803
chr19	55525074	55549632	GP6	24558	0.483183
chr19	55551815	55553382	AL833150	1567	0.479898
chr19	55555691	55574585	RDH13	18894	0.530645
chr19	55587220	55599291	EPS8L1	12071	0.603678
chr19	55602280	55628968	PPP1R12C	26688	0.576326
chr19	55644160	55660606	TNNT1	16446	0.555697
chr19	55663135	55668957	TNNI3	5822	0.575404
chr19	55670028	55678090	DNAAF3	8062	0.563756
chr19	55670306	55688908	AK097618	18602	0.539189
chr19	55684468	55691720	SYT5	7252	0.584528
chr19	55692614	55720874	PTPRH	28260	0.526327
chr19	55701075	55704597	BC034929	3522	0.481261
chr19	55738001	55740632	TMEM86B	2631	0.636640
chr19	55741146	55770038	PPP6R1	28892	0.562820
chr19	55773590	55791751	HSPBP1	18161	0.519024
chr19	55775352	55775745	X05128	393	0.521628
chr19	55795533	55823903	BRSK1	28370	0.545153
chr19	55824226	55836708	TMEM150B	12482	0.540138
chr19	55851220	55859489	SUV420H2	8269	0.648688
chr19	55861069	55866463	COX6B2	5394	0.607156
chr19	55866017	55874620	FAM71E2	8603	0.614204
chr19	55875749	55881831	IL11	6082	0.608353
chr19	55888203	55889612	TMEM190	1409	0.669269
chr19	55890611	55895627	TMEM238	5016	0.569378
chr19	55897299	55903451	RPL28	6152	0.560143
chr19	55912649	55919325	UBE2S	6676	0.562463
chr19	55919266	55920830	BC047644	1564	0.566496
chr19	55940104	55954230	SHISA7	14126	0.569517
chr19	55964345	55973049	ISOC2	8704	0.563189
chr19	55987698	55995854	ZNF628	8156	0.625061
chr19	55996556	55998935	NAT14	2379	0.656999
chr19	55999869	56030466	SSC5D	30597	0.544694
chr19	56041099	56048435	SBK2	7336	0.572792
chr19	56052022	56056909	SGK110	4887	0.568447
chr19	56088890	56092211	ZNF579	3321	0.682325
chr19	56102736	56110893	FIZ1	8157	0.564914
chr19	56111729	56114504	ZNF524	2775	0.607928
chr19	56124958	56129907	ZNF865	4949	0.659325
chr19	56132106	56135941	ZNF784	3835	0.584355
chr19	56154985	56156989	ZNF581	2004	0.624251
chr19	56152391	56154836	ZNF580	2445	0.638446
chr19	56158953	56164526	CCDC106	5573	0.635205
chr19	56165415	56186082	U2AF2	20667	0.560701
chr19	56187990	56207133	EPN1	19143	0.585384
chr19	56219797	56249768	NLRP9	29971	0.446065
chr19	56270506	56274541	RFPL4A	4035	0.424783
chr19	56283170	56284545	RFPL4AL1	1375	0.451636
chr19	56296762	56348128	NLRP11	51366	0.425495
chr19	56347943	56393220	NLRP4	45277	0.429335
chr19	56407310	56443702	NLRP13	36392	0.429985
chr19	56459197	56499995	NLRP8	40798	0.441394
chr19	56511091	56573174	NLRP5	62083	0.455326
chr19	56598731	56632649	ZNF787	33918	0.586090
chr19	56652534	56672262	ZNF444	19728	0.554288
chr19	56687388	56697144	GALP	9756	0.508405
chr19	56701057	56704421	ZSCAN5B	3364	0.514863
chr19	56732678	56739659	ZSCAN5A	6981	0.468987
chr19	56879489	56891196	ZNF542	11707	0.403861
chr19	56894647	56904889	ZNF582	10242	0.410076
chr19	56905044	56910539	ZNF582-AS1	5495	0.454049
chr19	56915382	56936400	ZNF583	21018	0.383290
chr19	56950692	56988770	ZNF667	38078	0.435763
chr19	56989242	57006805	ZNF667-AS1	17563	0.418778
chr19	57019211	57040269	ZNF471	21058	0.405262
chr19	57050316	57068170	ZFP28	17854	0.407864
chr19	57056934	57078780	BX647249	21846	0.402728
chr19	57078889	57094262	ZNF470	15373	0.396019
chr19	57106663	57135544	ZNF71	28881	0.457844
chr19	57154526	57168614	SMIM17	14088	0.452513
chr19	57174019	57183123	ZNF835	9104	0.552395
chr19	57276711	57311014	BC036412	34303	0.406670
chr19	57321444	57352094	PEG3	30650	0.457390
chr19	57323847	57325161	PEG3-AS1	1314	0.394216
chr19	57352269	57359922	MIMT1	7653	0.368875
chr19	57631508	57643293	USP29	11785	0.414171
chr19	57645463	57656570	ZIM3	11107	0.457459
chr19	57663093	57678856	DUXA	15763	0.452579
chr19	57702867	57734214	ZNF264	31347	0.444700
chr19	57742427	57746916	AURKC	4489	0.492537
chr19	57752052	57774106	ZNF805	22054	0.431985
chr19	57791852	57805436	ZNF460	13584	0.452591
chr19	57831864	57842144	ZNF543	10280	0.473735
chr19	57862644	57871265	ZNF304	8621	0.474423
chr19	57874878	57890925	ZNF547	16047	0.465009
chr19	57922528	57933307	ZNF17	10779	0.476946
chr19	57901217	57913919	ZNF548	12702	0.454889
chr19	57946692	57957191	ZNF749	10499	0.479855
chr19	57966541	57968107	VN1R1	1566	0.402937
chr19	57980953	57988938	ZNF772	7985	0.440827
chr19	57999078	58006048	ZNF419	6970	0.485509
chr19	58011308	58019510	ZNF773	8202	0.497074
chr19	58038692	58052244	ZNF549	13552	0.447240
chr19	58053203	58071231	ZNF550	18028	0.448691
chr19	58082933	58090243	ZNF416	7310	0.485636
chr19	58095627	58103758	ZIK1	8131	0.473251
chr19	58111252	58119637	ZNF530	8385	0.477996
chr19	58125829	58133636	ZNF134	7807	0.475215
chr19	58144534	58154147	ZNF211	9613	0.414647
chr19	58180302	58190520	ZSCAN4	10218	0.415639
chr19	58193336	58201169	ZNF551	7833	0.477978
chr19	58211809	58220579	ZNF154	8770	0.485177
chr19	58231118	58238995	ZNF671	7877	0.494351
chr19	58361180	58376491	ZNF587	15311	0.465482
chr19	58281019	58291984	ZNF586	10965	0.476334
chr19	58318449	58326281	ZNF552	7832	0.477273
chr19	58341661	58357606	ZNF587B	15945	0.466040
chr19	58336666	58338830	FKBP1AP1	2164	0.497689
chr19	58379176	58380140	BC011243	964	0.493776
chr19	58380746	58400442	ZNF814	19696	0.462124
chr19	58417141	58427978	ZNF417	10837	0.458337
chr19	58433251	58446740	ZNF418	13489	0.472088
chr19	58452200	58459077	ZNF256	6877	0.486259
chr19	58469804	58485902	C19orf18	16098	0.457945
chr19	58488440	58514714	ZNF606	26274	0.449989
chr19	58514261	58518574	LOC100128398	4313	0.469974
chr19	58545433	58565999	ZSCAN1	20566	0.555674
chr19	58570606	58581110	ZNF135	10504	0.505807
chr19	58595208	58629793	ZSCAN18	34585	0.501778
chr19	58637694	58662148	ZNF329	24454	0.461479
chr19	58694395	58724927	ZNF274	30532	0.475239
chr19	58740069	58775008	ZNF544	34939	0.473826
chr19	58769781	58790174	BC063675	20393	0.470161
chr19	58790317	58807254	ZNF8	16937	0.487099
chr19	58816739	58827013	LOC113386	10274	0.453572
chr19	58838384	58853712	ZSCAN22	15328	0.499478
chr19	58858171	58864865	A1BG	6694	0.576038
chr19	58863335	58866549	A1BG-AS1	3214	0.581207
chr19	58865722	58874214	ZNF497	8492	0.585846
chr19	58868265	58869514	BC023201	1249	0.667734
chr19	58869520	58870969	BC023201	1449	0.617667
chr19	58878989	58892389	ZNF837	13400	0.545075
chr19	58898136	58898225	MIR4754	89	0.696629
chr19	58898635	58906171	RPS5	7536	0.494559
chr19	58907456	58908446	LOC646862	990	0.759596
chr19	58920062	58929692	ZNF584	9630	0.485670
chr19	58943743	58943786	DQ581862	43	0.488372
chr19	58944180	58951589	ZNF132	7409	0.483601
chr19	58962970	58969199	ZNF324B	6229	0.589982
chr19	58978411	58984945	ZNF324	6534	0.593205
chr19	58987794	58992597	ZNF446	4803	0.601499
chr19	59009699	59023432	SLC27A5	13733	0.522464
chr19	59024896	59030921	ZBTB45	6025	0.614108
chr19	59055835	59062082	TRIM28	6247	0.587162
chr19	59062932	59066486	CHMP2A	3554	0.543050
chr19	59067078	59070343	UBE2M	3265	0.617458
chr19	59070552	59086164	LOC100131691	15612	0.550666
chr19	59073283	59084942	MZF1	11659	0.553392
chr19	59086765	59095762	MGC2752	8997	0.524508
chr2	38813	46588	FAM110C	7775	0.449904
chr2	218135	264068	SH3YL1	45933	0.399909
chr2	239560	242178	SH3YL1	2618	0.386937
chr2	264868	278282	ACP1	13414	0.410541
chr2	279560	288308	FAM150B	8748	0.464449
chr2	667972	677439	TMEM18	9467	0.545579
chr2	779836	864112	LOC339822	84276	0.452881
chr2	946553	1371384	SNTG2	424831	0.431849
chr2	1417232	1546499	TPO	129267	0.491015
chr2	1635658	1748291	PXDN	112633	0.498362
chr2	1792884	2335045	MYT1L	542161	0.445002
chr2	2323003	2330880	LOC730811	7877	0.409293
chr2	2898819	3129798	AK095310	230979	0.436654
chr2	3192740	3381653	TSSC1	188913	0.482624
chr2	3383445	3483342	TRAPPC12	99897	0.469884
chr2	3501689	3523350	ADI1	21661	0.445640
chr2	3592690	3605940	RNASEH1	13250	0.447774
chr2	3605975	3609340	LOC100506054	3365	0.480238
chr2	3622852	3628509	RPS7	5657	0.445996
chr2	3649495	3692234	COLEC11	42739	0.508014
chr2	3664889	3665294	BC113076	405	0.471605
chr2	3705785	3750260	ALLC	44475	0.444340
chr2	4005244	4021622	LOC100505964	16378	0.459091
chr2	4271220	4271240	JA429818	20	0.450000
chr2	4675807	4703812	LOC727982	28005	0.382753
chr2	5832798	5841517	SOX11	8719	0.477463
chr2	6072818	6120350	LOC150622	47532	0.433834
chr2	6122109	6128364	LOC400940	6255	0.460432
chr2	6869299	6910442	LINC00487	41143	0.418516
chr2	6988439	7005950	CMPK2	17511	0.443321
chr2	7017795	7038363	RSAD2	20568	0.401303
chr2	7052406	7058813	RNF144A-AS1	6407	0.511784
chr2	7057522	7184309	RNF144A	126787	0.450969
chr2	7561391	7590381	LOC100506274	28990	0.420421
chr2	8062555	8116977	LOC339788	54422	0.414152
chr2	8347272	8468549	LINC00299	121277	0.436942
chr2	8822112	8824583	ID2	2471	0.449616
chr2	8868986	8977755	KIDINS220	108769	0.381901
chr2	8996700	9143876	MBOAT2	147176	0.403001
chr2	9346893	9545812	ASAP2	198919	0.465556
chr2	9545814	9563643	ITGB1BP1	17829	0.464244
chr2	9563665	9613239	CPSF3	49574	0.421128
chr2	9614669	9628591	IAH1	13922	0.470622
chr2	9629410	9695917	ADAM17	66507	0.410919
chr2	9724105	9771106	YWHAQ	47001	0.403247
chr2	9983570	10074545	TAF1B	90975	0.394944
chr2	10091791	10142412	GRHL1	50621	0.426404
chr2	10092865	10096058	BC051708	3193	0.397745
chr2	10183681	10194963	KLF11	11282	0.495125
chr2	10196925	10220538	CYS1	23613	0.527675
chr2	10262694	10271546	RRM2	8852	0.447131
chr2	10281980	10350942	C2orf48	68962	0.516154
chr2	10332739	10332797	MIR4261	58	0.603448
chr2	10508803	10567743	HPCAL1	58940	0.538904
chr2	10580507	10588453	ODC1	7946	0.451045
chr2	10586839	10586975	SNORA80B	136	0.588235
chr2	10710891	10830113	NOL10	119222	0.407324
chr2	10861774	10925236	ATP6V1C2	63462	0.497274
chr2	10923516	10952960	PDIA6	29444	0.429867
chr2	11052062	11054351	KCNF1	2289	0.670162
chr2	11239125	11240188	AX746649	1063	0.511759
chr2	11245442	11272347	FLJ33534	26905	0.491581
chr2	11273178	11286916	C2orf50	13738	0.475106
chr2	11295539	11318998	PQLC3	23459	0.497251
chr2	11321777	11484711	ROCK2	162934	0.365369
chr2	11534106	11543203	LINC00570	9097	0.486864
chr2	11584500	11606303	E2F6	21803	0.419575
chr2	11674241	11782912	GREB1	108671	0.485686
chr2	11680730	11680803	MIR4429	73	0.534247
chr2	11701319	11701432	U2	113	0.380531
chr2	11798303	11810329	NTSR2	12026	0.505821
chr2	11817704	11967533	LPIN1	149829	0.467646
chr2	11977058	11977112	MIR4262	54	0.574074
chr2	12147253	12718474	AK001558	571221	0.402177
chr2	12170428	12170498	SNORD18	70	0.371429
chr2	12856997	12882858	TRIB2	25861	0.477128
chr2	12877492	12877570	MIR3125	78	0.576923
chr2	13106907	13147138	LOC100506474	40231	0.375109
chr2	14368997	14541082	BC035112	172085	0.373658
chr2	14772809	14780168	FAM84A	7359	0.466232
chr2	14775214	14790933	AX747684	15719	0.379986
chr2	15307031	15701472	NBAS	394441	0.381167
chr2	15731744	15771235	DDX1	39491	0.394039
chr2	15830905	15859085	AK093525	28180	0.481086
chr2	16080019	16081845	MYCNOS	1826	0.591457
chr2	16080682	16087129	MYCN	6447	0.537614
chr2	16380470	16380563	SNORA40	93	0.333333
chr2	16730729	16847134	FAM49A	116405	0.428959
chr2	17304107	17304407	7SK	300	0.493333
chr2	17691985	17699706	RAD51AP2	7721	0.346717
chr2	17721806	17837706	VSNL1	115900	0.416868
chr2	17845078	17935096	SMC6	90018	0.362772
chr2	17935176	17966632	GEN1	31456	0.350585
chr2	17997785	17998367	MSGN1	582	0.615120
chr2	18059944	18114225	KCNS3	54281	0.415191
chr2	18735988	18770846	NT5C1B-RDH14	34858	0.382839
chr2	18764632	18764734	U6	102	0.372549
chr2	19548189	19548266	MIR4757	77	0.636364
chr2	19551245	19558372	OSR1	7127	0.557037
chr2	20068614	20084808	LINC00954	16194	0.487279
chr2	20096513	20101744	TTC32	5231	0.397438
chr2	20110028	20189884	WDR35	79856	0.368952
chr2	20191812	20212455	MATN3	20643	0.425326
chr2	20232410	20251789	LAPTM4A	19379	0.416069
chr2	20400557	20424927	SDC1	24370	0.573738
chr2	20448452	20527139	PUM2	78687	0.363478
chr2	20646834	20649201	RHOB	2367	0.574567
chr2	20817563	20850864	HS1BP3	33301	0.551665
chr2	20866423	20871250	GDF7	4827	0.648643
chr2	20884817	21022827	C2orf43	138010	0.381588
chr2	21224300	21266945	APOB	42645	0.429640
chr2	21910305	21933524	LOC645949	23219	0.365993
chr2	23608297	23931483	KLHL29	323186	0.504719
chr2	23971533	24149936	ATAD2B	178403	0.379747
chr2	24163375	24223693	UBXN2A	60318	0.424633
chr2	24232952	24247145	MFSD2B	14193	0.555415
chr2	24252205	24270296	C2orf44	18091	0.427174
chr2	24272583	24286550	FKBP1B	13967	0.481993
chr2	24290453	24299314	SF3B14	8861	0.432005
chr2	24346349	24392507	FAM228B	46158	0.416634
chr2	24300302	24308085	TP53I3	7783	0.495824
chr2	24338243	24346151	PFN4	7908	0.433359
chr2	24397971	24414567	FAM228A	16596	0.428175
chr2	24425734	24583397	ITSN2	157663	0.398565
chr2	24807344	24993570	NCOA1	186226	0.366571
chr2	25013135	25016251	PTRHD1	3116	0.472080
chr2	25016174	25045245	CENPO	29071	0.438237
chr2	25042038	25142055	ADCY3	100017	0.509083
chr2	25166504	25194963	DNAJC27	28459	0.407077
chr2	25194980	25262563	DNAJC27-AS1	67583	0.449359
chr2	25264972	25382004	EFR3B	117032	0.483816
chr2	25383721	25391559	POMC	7838	0.506890
chr2	25455829	25564784	DNMT3A	108955	0.533312
chr2	25551508	25551590	MIR1301	82	0.621951
chr2	25600066	25896516	DTNB	296450	0.414583
chr2	25962252	26101312	ASXL2	139060	0.396929
chr2	25991888	25991965	U2	77	0.350649
chr2	26149454	26205443	KIF3C	55989	0.481416
chr2	26256728	26360323	RAB10	103595	0.406979
chr2	26265543	26265650	U6	107	0.383178
chr2	26395959	26412532	GAREML	16573	0.584203
chr2	26413503	26467594	HADHA	54091	0.419330
chr2	26467615	26513333	HADHB	45718	0.409860
chr2	26532811	26541917	GPR113	9106	0.547771
chr2	26568953	26618759	EPT1	49806	0.404831
chr2	26624783	26679579	DRC1	54796	0.440616
chr2	26680070	26781566	OTOF	101496	0.528100
chr2	26785480	26802395	C2orf70	16915	0.529707
chr2	26804072	26864211	CIB4	60139	0.490381
chr2	26915580	26954066	KCNK3	38486	0.539521
chr2	26928413	26931548	AX746487	3135	0.577034
chr2	26987141	27004099	SLC35F6	16958	0.526713
chr2	27008881	27017455	CENPA	8574	0.459645
chr2	27070968	27173219	DPYSL5	102251	0.463203
chr2	27193524	27250087	MAPRE3	56563	0.458674
chr2	27234636	27237480	AK125769	2844	0.488397
chr2	27255773	27264565	TMEM214	8792	0.550273
chr2	27273649	27273738	TRNA	89	0.561798
chr2	27274490	27293490	AGBL5	19000	0.490000
chr2	27293341	27294567	OST4	1226	0.551387
chr2	27301434	27309265	EMILIN1	7831	0.616907
chr2	27309610	27323619	KHK	14009	0.531301
chr2	27323461	27341773	CGREF1	18312	0.491699
chr2	27346656	27353680	ABHD1	7024	0.507973
chr2	27353624	27357542	PREB	3918	0.574783
chr2	27359714	27362332	C2orf53	2618	0.588235
chr2	27371944	27375819	TCF23	3875	0.536774
chr2	27422454	27435175	SLC5A6	12721	0.532584
chr2	27434898	27440046	ATRAID	5148	0.455517
chr2	27440257	27466654	CAD	26397	0.511801
chr2	27477439	27481451	SLC30A3	4012	0.537886
chr2	27477439	27485960	SLC30A3	8521	0.563432
chr2	27498288	27504296	DNAJC5G	6008	0.487017
chr2	27505296	27530307	TRIM54	25011	0.477110
chr2	27530264	27531130	UCN	866	0.698614
chr2	27532359	27545969	MPV17	13610	0.509331
chr2	27548715	27579901	GTF3C2	31186	0.463894
chr2	27558408	27560670	LOC100505624	2262	0.506189
chr2	27587218	27592919	EIF2B4	5701	0.490616
chr2	27593362	27600400	SNX17	7038	0.531117
chr2	27600097	27603611	ZNF513	3514	0.577120
chr2	27604065	27632550	PPM1G	28485	0.454766
chr2	27615489	27616443	FTH1P3	954	0.517820
chr2	27651184	27665124	NRBP1	13940	0.489383
chr2	27665232	27667164	KRTCAP3	1932	0.579193
chr2	27667239	27712571	IFT172	45332	0.454668
chr2	27714749	27718126	FNDC4	3377	0.580101
chr2	27719705	27746550	GCKR	26845	0.453269
chr2	27799388	27805589	C2orf16	6201	0.467021
chr2	27805835	27846082	ZNF512	40247	0.412080
chr2	27848505	27851745	CCDC121	3240	0.417284
chr2	27851862	27873713	GPN1	21851	0.407350
chr2	27873678	27886449	SUPT7L	12771	0.411323
chr2	27886337	27917847	SLC4A1AP	31510	0.400762
chr2	27929629	27938599	AK124439	8970	0.467113
chr2	27994583	28002608	MRPL33	8025	0.409844
chr2	28004265	28113223	RBKS	108958	0.406157
chr2	28113481	28561767	BRE	448286	0.393505
chr2	28206825	28207893	BC048132	1068	0.334270
chr2	28219233	28219316	MIR4263	83	0.457831
chr2	28530557	28533326	LOC100505716	2769	0.451788
chr2	28607275	28617539	AK055918	10264	0.543940
chr2	28615778	28637516	FOSL2	21738	0.525347
chr2	28718937	28866653	PLB1	147716	0.470863
chr2	28974613	29025806	PPP1CB	51193	0.388999
chr2	29033699	29073475	SPDYA	39776	0.394987
chr2	29072687	29093175	TRMT61B	20488	0.413754
chr2	29117532	29171080	WDR43	53548	0.392694
chr2	29136527	29136616	SNORD92	89	0.460674
chr2	29149932	29150008	SNORD53	76	0.473684
chr2	29204163	29275096	FAM179A	70933	0.509551
chr2	29284555	29297127	C2orf71	12572	0.519170
chr2	29338307	29406679	CLIP4	68372	0.373618
chr2	29415639	30144477	ALK	728838	0.435109
chr2	30369749	30383399	YPEL5	13650	0.420220
chr2	30454396	30482899	LBH	28503	0.478686
chr2	30569524	30573024	AK123934	3500	0.482000
chr2	30573783	30575297	AK123934	1514	0.472259
chr2	30631035	30631111	L07266	76	0.578947
chr2	30631111	30631212	L07266	101	0.544554
chr2	30670136	30867091	LCLAT1	196955	0.375345
chr2	30945637	31030311	CAPN13	84674	0.460259
chr2	31133330	31361592	GALNT14	228262	0.464278
chr2	31395921	31440411	CAPN14	44490	0.444931
chr2	31456879	31491260	EHD3	34381	0.503098
chr2	31557187	31637611	XDH	80424	0.429150
chr2	31749655	31806040	SRD5A2	56385	0.389643
chr2	32092893	32235698	MEMO1	142805	0.380288
chr2	32248971	32264844	DPY30	15873	0.438228
chr2	32288679	32382706	SPAST	94027	0.399758
chr2	32390909	32449181	SLC30A6	58272	0.397670
chr2	32449517	32490689	NLRC4	41172	0.428204
chr2	32502957	32531658	YIPF4	28701	0.414933
chr2	32582095	32843965	BIRC6	261870	0.375591
chr2	32757219	32757313	MIR558	94	0.425532
chr2	32853086	33046118	TTC27	193032	0.394593
chr2	32860321	32860398	MIR4765	77	0.415584
chr2	33107765	33151756	LINC00486	43991	0.421564
chr2	33152193	33171202	LOC100271832	19009	0.411174
chr2	33172368	33624575	LTBP1	452207	0.402254
chr2	33738941	33789798	RASGRP3	50857	0.417642
chr2	33808728	33824362	FAM98A	15634	0.374057
chr2	33951127	33953284	MYADML	2157	0.554010
chr2	36581891	36582713	LOC100288911	822	0.565693
chr2	36583369	36778278	CRIM1	194909	0.401798
chr2	36779403	36825332	FEZ2	45929	0.400052
chr2	36923832	37041937	VIT	118105	0.432878
chr2	37064840	37193615	STRN	128775	0.377076
chr2	37186504	37186605	U6	101	0.346535
chr2	37208152	37311485	HEATR5B	103333	0.380846
chr2	37311593	37323738	GPATCH11	12145	0.387979
chr2	37332283	37384190	EIF2AK2	51907	0.415300
chr2	37394962	37415690	SULT6B1	20728	0.404284
chr2	37423634	37431886	LOC100505876	8252	0.408386
chr2	37428774	37458740	CEBPZ	29966	0.379997
chr2	37458773	37476303	NDUFAF7	17530	0.396691
chr2	37477645	37544222	PRKD3	66577	0.366763
chr2	37571752	37600465	QPCT	28713	0.410232
chr2	37662652	37662751	U6	99	0.393939
chr2	37869024	37899342	CDC42EP3	30318	0.444653
chr2	38053389	38056541	AK057187	3152	0.430203
chr2	38177595	38294285	RMDN2	116690	0.384497
chr2	38177476	38263484	RMDN2-AS1	86008	0.380813
chr2	38294745	38303323	CYP1B1	8578	0.441012
chr2	38358246	38408993	CYP1B1-AS1	50747	0.416300
chr2	38522028	38604432	ATL2	82404	0.394605
chr2	38790327	38830178	HNRPLL	39851	0.369401
chr2	38893051	38961909	GALM	68858	0.453368
chr2	38970740	38978636	SRSF7	7896	0.414514
chr2	39005257	39009106	GEMIN6	3849	0.462458
chr2	39024875	39103021	DHX57	78146	0.415172
chr2	39103102	39109850	MORN2	6748	0.387670
chr2	39146503	39202590	ARHGEF33	56087	0.422469
chr2	39186428	39187485	LOC375196	1057	0.604541
chr2	39208689	39347604	SOS1	138915	0.373624
chr2	39405687	39456673	CDKL4	50986	0.405582
chr2	39476406	39664453	MAP4K3	188047	0.368961
chr2	39620662	39620759	U6	97	0.319588
chr2	39741286	39828484	LOC728730	87198	0.415216
chr2	39893034	39945104	TMEM178A	52070	0.402017
chr2	39963199	40006416	THUMPD2	43217	0.366106
chr2	40144773	40482349	SLC8A1-AS1	337576	0.388073
chr2	40339285	40657444	SLC8A1	318159	0.380558
chr2	42098410	42098528	U4	118	0.567797
chr2	42104694	42121186	LOC388942	16492	0.447065
chr2	42162507	42180943	C2orf91	18436	0.471740
chr2	42275160	42285668	PKDCC	10508	0.562143
chr2	42396489	42559688	EML4	163199	0.380223
chr2	42577644	42588988	COX7A2L	11344	0.429566
chr2	42667516	42667576	SNORD75	60	0.416667
chr2	42669156	42721237	KCNG3	52081	0.424243
chr2	42795670	42936353	MTA3	140683	0.417655
chr2	42989638	42991401	OXER1	1763	0.618832
chr2	42994228	43019751	HAAO	25523	0.489598
chr2	43449540	43453745	ZFP36L2	4205	0.559334
chr2	43454349	43455994	LOC100129726	1645	0.565957
chr2	43457974	43823185	THADA	365211	0.404706
chr2	43864438	43995126	PLEKHH2	130688	0.389714
chr2	43902291	43903461	LOC728819	1170	0.390598
chr2	43999258	43999489	7SK	231	0.463203
chr2	44001177	44037149	DYNC2LI1	35972	0.375681
chr2	44039610	44065958	ABCG5	26348	0.451685
chr2	44066102	44105605	ABCG8	39503	0.457307
chr2	44113362	44223144	LRPPRC	109782	0.370962
chr2	44395999	44458611	PPM1B	62612	0.388823
chr2	44502596	44547962	SLC3A1	45366	0.417074
chr2	44544747	44589001	PREPL	44254	0.372215
chr2	44589042	44999731	CAMKMT	410689	0.379292
chr2	44776629	44776659	MIR548AD	30	0.333333
chr2	45169036	45173216	SIX3	4180	0.572010
chr2	45232323	45236542	SIX2	4219	0.590424
chr2	45414308	45419424	UNQ6975	5116	0.487686
chr2	45615818	45838433	SRBD1	222615	0.365312
chr2	45879042	46415129	PRKCE	536087	0.444040
chr2	46524540	46613842	EPAS1	89302	0.463685
chr2	46656333	46668972	BC031304	12639	0.403355
chr2	46706703	46711564	TMEM247	4861	0.475005
chr2	46738985	46747096	ATP6V1E2	8111	0.398594
chr2	46755024	46769141	AF086285	14117	0.430474
chr2	46769866	46811827	RHOQ	41961	0.435071
chr2	46795395	46807374	BC048424	11979	0.396110
chr2	46808412	46844251	PIGF	35839	0.361338
chr2	46844324	46852881	CRIPT	8557	0.368237
chr2	46926098	46989927	SOCS5	63829	0.372370
chr2	47043806	47049799	LOC388948	5993	0.485233
chr2	47073014	47086145	LOC100134259	13131	0.490976
chr2	47129008	47143251	MCFD2	14243	0.470968
chr2	47168312	47303275	TTC7A	134963	0.522439
chr2	47314129	47382517	C2orf61	68388	0.434404
chr2	47387220	47403740	CALM2	16520	0.397094
chr2	47441087	47572105	AK094343	131018	0.464829
chr2	47536171	47538026	AX747384	1855	0.492183
chr2	47586643	47586916	7SK	273	0.505495
chr2	47596286	47614167	EPCAM	17881	0.427884
chr2	47604813	47604909	MIR559	96	0.343750
chr2	47630205	47710367	MSH2	80162	0.416220
chr2	47713159	47715691	AK056077	2532	0.374013
chr2	47747914	47797470	KCNK12	49556	0.485330
chr2	48010220	48034092	MSH6	23872	0.438422
chr2	48034058	48132932	FBXO11	98874	0.390578
chr2	48541794	48606434	FOXN2	64640	0.363011
chr2	48667907	48742531	PPP1R21	74624	0.396561
chr2	48807725	48906749	STON1-GTF2A1L	99024	0.384472
chr2	48913912	48982880	LHCGR	68968	0.412293
chr2	49189295	49381666	FSHR	192371	0.390579
chr2	50145642	51259674	NRXN1	1114032	0.357783
chr2	53897116	54087170	ASB3	190054	0.391778
chr2	53990097	53992017	AX747197	1920	0.383333
chr2	53994928	54002287	CHAC2	7359	0.392037
chr2	54014067	54045956	ERLEC1	31889	0.382044
chr2	54076258	54076342	MIR3682	84	0.297619
chr2	54080049	54087170	GPR75	7121	0.451482
chr2	54091203	54197977	PSME4	106774	0.379802
chr2	54342409	54532435	ACYP2	190026	0.389541
chr2	54480314	54483409	TSPYL6	3095	0.489176
chr2	54558070	54588714	C2orf73	30644	0.370023
chr2	54683453	54898583	SPTBN1	215130	0.427802
chr2	54756358	54756978	RPL23AP32	620	0.467742
chr2	54952148	55199156	EML6	247008	0.406809
chr2	55077425	55077489	U7	64	0.453125
chr2	55199326	55277734	RTN4	78408	0.368266
chr2	55241553	55241657	U6	104	0.365385
chr2	55276897	55277436	RTN4	539	0.743970
chr2	55399686	55459449	CLHC1	59763	0.395998
chr2	55459038	55462989	RPS27A	3951	0.458112
chr2	55463755	55496384	MTIF2	32629	0.395231
chr2	55509454	55511607	PRORSD1P	2153	0.450999
chr2	55514977	55647057	CCDC88A	132080	0.364453
chr2	55683241	55683340	U6	99	0.323232
chr2	55746739	55772216	CCDC104	25477	0.403815
chr2	55775513	55845113	SMEK2	69600	0.380345
chr2	55861197	55921045	PNPT1	59848	0.397240
chr2	56093096	56151298	EFEMP1	58202	0.379643
chr2	56178788	56179149	7SK	361	0.529086
chr2	56179253	56408788	BC043355	229535	0.393665
chr2	56210101	56210211	MIR217	110	0.363636
chr2	56216084	56216194	MIR216A	110	0.472727
chr2	56227848	56227930	MIR216B	82	0.451219
chr2	56301788	56317511	BC040311	15723	0.383833
chr2	56400668	56412048	AK295617	11380	0.461687
chr2	56400668	56412905	AK311113	12237	0.472828
chr2	56411257	56613309	CCDC85A	202052	0.384886
chr2	57771669	57771734	SNORD78	65	0.292308
chr2	58273776	58387055	VRK2	113279	0.351221
chr2	58386377	58468515	FANCL	82138	0.347622
chr2	59152745	59290901	FLJ30838	138156	0.378550
chr2	60040037	60040057	JB153659	20	0.400000
chr2	60140736	60140761	JB153659	25	0.520000
chr2	60614496	60614580	MIR4432	84	0.511905
chr2	60684328	60780633	BCL11A	96305	0.448170
chr2	60751623	60755350	AL833181	3727	0.411054
chr2	60983364	61029221	PAPOLG	45857	0.396035
chr2	61074894	61108449	FLJ16341	33555	0.436060
chr2	61108751	61150178	REL	41427	0.377435
chr2	61167547	61245365	PUS10	77818	0.395268
chr2	61244811	61279125	PEX13	34314	0.396048
chr2	61293005	61351413	KIAA1841	58408	0.396418
chr2	61368726	61372110	LOC339803	3384	0.457742
chr2	61389628	61391964	C2orf74	2336	0.401113
chr2	61404554	61414686	AHSA2	10132	0.464962
chr2	61414589	61697849	USP34	283260	0.387499
chr2	61644378	61644512	SNORA70B	134	0.492537
chr2	61705068	61765418	XPO1	60350	0.407970
chr2	62051982	62081278	FAM161A	29296	0.413196
chr2	62095261	62115806	CCT4	20545	0.409978
chr2	62132802	62363205	COMMD1	230403	0.407325
chr2	62296587	62374016	BC071802	77429	0.416717
chr2	62423261	62451866	B3GNT2	28605	0.453872
chr2	62432960	62433052	MIR5192	92	0.554348
chr2	62727355	62733604	TMEM17	6249	0.405665
chr2	62839006	62889763	BC038779	50757	0.394074
chr2	62933000	63273621	EHBP1	340621	0.365154
chr2	63271099	63274846	LOC100132215	3747	0.451294
chr2	63277936	63284966	OTX1	7030	0.579801
chr2	63344985	63346677	DBIL5P2	1692	0.452128
chr2	63348534	63815867	WDPCP	467333	0.371435
chr2	63816284	63834330	MDH1	18046	0.374986
chr2	64069013	64118696	UGP2	49683	0.381398
chr2	64119666	64246214	VPS54	126548	0.369907
chr2	64319785	64371605	PELI1	51820	0.369182
chr2	64412212	64432619	LINC00309	20407	0.408193
chr2	64565203	64568782	AL355732	3579	0.472478
chr2	64681326	64688517	LGALSL	7191	0.437213
chr2	64751438	64820138	AFTPH	68700	0.372897
chr2	64752646	64752699	MIR4434	53	0.339623
chr2	64834445	64843616	LOC339807	9171	0.501799
chr2	64858754	64881046	SERTAD2	22292	0.427463
chr2	65073263	65090760	AK097952	17497	0.472481
chr2	65128973	65159581	LOC400958	30608	0.459390
chr2	65216494	65251000	SLC1A4	34506	0.447980
chr2	65283494	65314142	CEP68	30648	0.478171
chr2	65313987	65357435	RAB1A	43448	0.413644
chr2	65454828	65498390	ACTR2	43562	0.395161
chr2	65537984	65659656	SPRED2	121672	0.437512
chr2	65663844	66299751	FLJ16124	635907	0.419198
chr2	66305393	66311772	AK131224	6379	0.418247
chr2	66585380	66585460	MIR4778	80	0.412500
chr2	66650474	66660602	MEIS1-AS3	10128	0.437599
chr2	66662531	66799891	MEIS1	137360	0.389684
chr2	67313577	67516376	BC040863	202799	0.369982
chr2	67350488	67442451	LOC644838	91963	0.362483
chr2	67624441	67637533	ETAA1	13092	0.333792
chr2	68269331	68290159	C1D	20828	0.373104
chr2	68357280	68384692	WDR92	27412	0.392967
chr2	68385004	68403094	PNO1	18090	0.411830
chr2	68405988	68479651	PPP3R1	73663	0.370932
chr2	68520141	68547183	CNRIP1	27042	0.399859
chr2	68592321	68624585	PLEK	32264	0.412193
chr2	68689504	68694390	FBXO48	4886	0.400941
chr2	68694690	68807294	APLF	112604	0.360209
chr2	68872793	68882708	PROKR1	9915	0.453656
chr2	68961912	69053957	ARHGAP25	92045	0.424097
chr2	69092612	69098649	BMP10	6037	0.404174
chr2	69172363	69180102	GKN2	7739	0.396175
chr2	69201704	69208112	GKN1	6408	0.368134
chr2	69240275	69476459	ANTXR1	236184	0.418809
chr2	69330813	69330887	MIR3126	74	0.405405
chr2	69546900	69614386	GFPT1	67486	0.395000
chr2	69623244	69664760	NFU1	41516	0.415671
chr2	69685126	69870977	AAK1	185851	0.420853
chr2	69747176	69747303	SNORA36C	127	0.425197
chr2	69969126	70053596	ANXA4	84470	0.425903
chr2	70016683	70026080	AK125871	9397	0.425668
chr2	70056817	70106727	GMCL1	49910	0.379162
chr2	70121074	70132368	SNRNP27	11294	0.407827
chr2	70142172	70170076	MXD1	27904	0.407863
chr2	70157399	70160078	FW340055	2679	0.403882
chr2	70187223	70189397	ASPRV1	2174	0.555658
chr2	70189394	70314147	PCBP1-AS1	124753	0.457039
chr2	70314584	70316334	PCBP1	1750	0.552571
chr2	70351167	70352448	LOC100133985	1281	0.574551
chr2	70377016	70418151	C2orf42	41135	0.451343
chr2	70436575	70475779	TIA1	39204	0.396694
chr2	70476122	70476193	TRNA	71	0.619718
chr2	70485230	70508317	PCYOX1	23087	0.448131
chr2	70508505	70520869	SNRPG	12364	0.410466
chr2	70523107	70529220	FAM136A	6113	0.484378
chr2	70674411	70781147	TGFA	106736	0.438952
chr2	70889215	70994847	ADD2	105632	0.453849
chr2	71004441	71017775	FIGLA	13334	0.435653
chr2	71035776	71047732	CLEC4F	11956	0.468886
chr2	71057342	71062953	CD207	5611	0.510426
chr2	71127719	71160575	VAX2	32856	0.479973
chr2	71162997	71192561	ATP6V1B1	29564	0.501962
chr2	71205574	71212629	ANKRD53	7055	0.556626
chr2	71213067	71222001	TEX261	8934	0.523953
chr2	71251204	71257060	OR7E91P	5856	0.449454
chr2	71295407	71305998	NAGK	10591	0.510622
chr2	71336805	71357394	MCEE	20589	0.414105
chr2	71357443	71377232	MPHOSPH10	19789	0.405023
chr2	71409867	71454233	PAIP2B	44366	0.401636
chr2	71410052	71411508	AF090102	1456	0.404533
chr2	71558884	71662191	ZNF638	103307	0.374360
chr2	71606884	71606988	U6	104	0.432692
chr2	71693831	71913893	DYSF	220062	0.493684
chr2	72356366	72374991	CYP26B1	18625	0.598497
chr2	72406443	73053177	EXOC6B	646734	0.370839
chr2	72948934	72949132	U2	198	0.353535
chr2	72987662	72987731	SNORD78	69	0.304348
chr2	73114511	73119289	SPR	4778	0.545835
chr2	73144603	73162020	EMX1	17417	0.541827
chr2	73169164	73298965	SFXN5	129801	0.492515
chr2	73223653	73298965	SFXN5	75312	0.461334
chr2	73300509	73307147	RAB11FIP5	6638	0.557397
chr2	73300509	73340146	RAB11FIP5	39637	0.543457
chr2	73307789	73307828	DQ580250	39	0.512821
chr2	73429385	73438340	NOTO	8955	0.511558
chr2	73441365	73454355	SMYD5	12990	0.509469
chr2	73455133	73460356	PRADC1	5223	0.521156
chr2	73461363	73480150	CCT7	18787	0.454623
chr2	73481809	73496848	FBXO41	15039	0.567192
chr2	73511661	73518113	AK125051	6452	0.473342
chr2	73518056	73520829	EGR4	2773	0.652001
chr2	73525810	73525915	U6	105	0.314286
chr2	73612885	73837046	ALMS1	224161	0.382390
chr2	73867849	73869537	NAT8	1688	0.521327
chr2	73872045	73912694	ALMS1P	40649	0.409604
chr2	73927635	73928467	NAT8B	832	0.543269
chr2	73956956	73964517	TPRKB	7561	0.403650
chr2	73989324	74007284	DUSP11	17960	0.402951
chr2	74011315	74044274	C2orf78	32959	0.429443
chr2	74056042	74094295	STAMBP	38253	0.423209
chr2	74120092	74146780	ACTG2	26688	0.450727
chr2	74153952	74186088	DGUOK	32136	0.428118
chr2	74273404	74335302	TET3	61898	0.465120
chr2	74362527	74375039	BOLA3	12512	0.504076
chr2	74375107	74379516	BOLA3-AS1	4409	0.457700
chr2	74383210	74405995	MOB1A	22785	0.418609
chr2	74425689	74442424	MTHFD2	16735	0.436510
chr2	74448560	74542152	SLC4A5	93592	0.468416
chr2	74588280	74607482	DCTN1	19202	0.528382
chr2	74612844	74621008	DCTN1-AS1	8164	0.434591
chr2	74641302	74644844	C2orf81	3542	0.587239
chr2	74642573	74643694	DQ588163	1121	0.594112
chr2	74648884	74652882	WDR54	3998	0.542771
chr2	74652987	74669060	RTKN	16073	0.533752
chr2	74682149	74685087	INO80B	2938	0.530973
chr2	74685526	74688018	WBP1	2492	0.559791
chr2	74688183	74692537	MOGS	4354	0.579008
chr2	74699084	74699942	MRPL53	858	0.590909
chr2	74699958	74710357	CCDC142	10399	0.513415
chr2	74710199	74721691	TTC31	11492	0.509224
chr2	74724643	74730443	LBX2	5800	0.600690
chr2	74729743	74732192	LBX2-AS1	2449	0.588403
chr2	74732169	74734821	PCGF1	2652	0.552790
chr2	74740685	74744275	TLX2	3590	0.652925
chr2	74741595	74744275	TLX2	2680	0.655970
chr2	74745257	74753408	DQX1	8151	0.494418
chr2	74753774	74756974	AUP1	3200	0.552813
chr2	74756531	74760683	HTRA2	4152	0.546002
chr2	74759945	74781062	LOXL3	21117	0.495430
chr2	74781511	74784678	DOK1	3167	0.620461
chr2	74785009	74875164	M1AP	90155	0.405235
chr2	74881354	74910981	SEMA4F	29627	0.449725
chr2	75059781	75120481	HK2	60700	0.477133
chr2	75155365	75160151	AK125960	4786	0.442750
chr2	75185774	75196859	POLE4	11085	0.388723
chr2	75273589	75426645	TACR1	153056	0.402846
chr2	75317938	75318041	MIR5000	103	0.466019
chr2	75719443	75788092	EVA1A	68649	0.418025
chr2	75873908	75889334	MRPL19	15426	0.379165
chr2	75889831	75938111	GCFC2	48280	0.366715
chr2	76974849	77749502	LRRTM4	774653	0.349229
chr2	78182032	78182152	SNAR-H	120	0.591667
chr2	78245155	78517815	BC030125	272660	0.349996
chr2	78639670	78769187	BC024248	129517	0.347954
chr2	79252811	79255630	REG3G	2819	0.482086
chr2	79312148	79315150	REG1B	3002	0.434710
chr2	79347583	79350545	REG1A	2962	0.445645
chr2	79362628	79365553	REG1P	2925	0.444786
chr2	79384131	79386880	REG3A	2749	0.491088
chr2	79740059	80875988	CTNNA2	1135929	0.387106
chr2	79863987	79864089	U6	102	0.343137
chr2	79876419	79876485	MIR4264	66	0.424242
chr2	80529002	80531487	LRRTM1	2485	0.567404
chr2	83083926	83084893	LOC1720	967	0.401241
chr2	84517805	84519324	FUNDC2P2	1519	0.479921
chr2	84650646	84686586	SUCLG1	35940	0.390790
chr2	84743578	85046713	DNAH6	303135	0.383730
chr2	85048790	85108369	TRABD2A	59579	0.469091
chr2	85132762	85133799	TMSB10	1037	0.636451
chr2	85198230	85286595	KCMF1	88365	0.417111
chr2	85360582	85537511	TCF7L1	176929	0.469606
chr2	85545140	85555419	TGOLN2	10279	0.475435
chr2	85569077	85581821	RETSAT	12744	0.514046
chr2	85581842	85618875	ELMOD3	37033	0.460292
chr2	85621870	85641197	CAPG	19327	0.514048
chr2	85661917	85664152	SH2D6	2235	0.599553
chr2	85764589	85766009	LOC100630918	1420	0.548592
chr2	85766100	85772403	MAT2A	6303	0.454545
chr2	85771977	85788657	GGCX	16680	0.461870
chr2	85804613	85809156	VAMP8	4543	0.524763
chr2	85811530	85820511	VAMP5	8981	0.522882
chr2	85822836	85824831	RNF181	1995	0.545865
chr2	85825669	85829822	TMEM150A	4153	0.593547
chr2	85843214	85876407	USP39	33193	0.453770
chr2	85832375	85839179	C2orf68	6804	0.493386
chr2	85884439	85895864	SFTPB	11425	0.560525
chr2	85921413	85925875	GNLY	4462	0.562528
chr2	85955316	85955460	U1	144	0.472222
chr2	85980908	86018506	ATOH8	37598	0.546279
chr2	86042252	86053911	LOC284950	11659	0.409984
chr2	86066270	86116157	ST3GAL5	49887	0.449536
chr2	86116402	86119375	BC036617	2973	0.465523
chr2	86247338	86250991	LOC90784	3653	0.493841
chr2	86253450	86333278	POLR1A	79828	0.464712
chr2	86333304	86369280	PTCD3	35976	0.412247
chr2	86362992	86363129	SNORD94	137	0.540146
chr2	86371054	86422893	IMMT	51839	0.414070
chr2	86420148	86420231	MIR4779	83	0.361446
chr2	86426555	86440477	MRPL35	13922	0.408993
chr2	86441119	86564777	REEP1	123658	0.459687
chr2	86668583	86719839	KDM3A	51256	0.398470
chr2	86830515	86851000	RNF103	20485	0.390530
chr2	86831129	86845887	BC066991	14758	0.378439
chr2	86947413	88038768	RMND5A	1091355	0.415290
chr2	86947413	87005164	RMND5A	57751	0.403093
chr2	87011727	87018837	CD8A	7110	0.527004
chr2	87042459	87089047	CD8B	46588	0.468382
chr2	87088947	87122165	ANAPC1P1	33218	0.400656
chr2	87144737	87241099	RGPD1	96362	0.398155
chr2	87237587	87248973	PLGLB2	11386	0.399789
chr2	87257799	87277689	LOC285074	19890	0.388587
chr2	87407210	87423980	ANAPC1	16770	0.389505
chr2	87565883	87566141	IGKV3-11	258	0.569767
chr2	87607326	87607354	DQ571479	28	0.571429
chr2	87615404	87615434	DQ576039	30	0.533333
chr2	87754973	87821030	LINC00152	66057	0.451595
chr2	87929273	87929353	MIR4435-1	80	0.550000
chr2	88047605	88058994	PLGLB2	11389	0.399596
chr2	88055478	88125286	RGPD1	69808	0.395528
chr2	88326723	88355248	KRCC1	28525	0.385451
chr2	88367298	88412902	SMYD1	45604	0.446408
chr2	88382037	88382118	MIR4780	81	0.654321
chr2	88422507	88427650	FABP1	5143	0.484348
chr2	88472657	88486156	THNSL2	13499	0.468627
chr2	88747725	88752053	FOXI3	4328	0.505776
chr2	88824168	88829103	TEX37	4935	0.463222
chr2	88856258	88927094	EIF2AK3	70836	0.385651
chr2	88927346	88931337	BC046476	3991	0.429967
chr2	88991175	89050452	RPIA	59277	0.412386
chr2	89065418	89106109	ANKRD36BP2	40691	0.350348
chr2	89111883	89111968	MIR4436A	85	0.552941
chr2	89156873	89630175	abParts	473302	0.401724
chr2	89185067	89595920	abParts	410853	0.401044
chr2	89197030	89197301	IGKV	271	0.431734
chr2	89890561	90471176	abParts	580615	0.372257
chr2	89986779	89987080	IGVK-A2	301	0.524917
chr2	90273739	90458465	IGL@	184726	0.299205
chr2	90310954	90310982	DQ571479	28	0.571429
chr2	90319058	90319088	DQ576039	30	0.533333
chr2	90493807	90493837	DQ576041	30	0.533333
chr2	90501914	90501942	DQ571479	28	0.571429
chr2	90537855	90538113	IGKV3-11	258	0.569767
chr2	91715333	91715363	DQ576041	30	0.533333
chr2	91723564	91723592	DQ571479	28	0.571429
chr2	91805187	91847975	LOC654342	42788	0.466322
chr2	91963367	91970153	GGT8P	6786	0.536693
chr2	92129158	92130496	ACTR3BP2	1338	0.397608
chr2	95421070	95426929	FAM95A	5859	0.507424
chr2	95428927	95428954	DQ586768	27	0.518519
chr2	95453168	95453198	DQ587539	30	0.566667
chr2	95454193	95454222	DQ579969	29	0.551724
chr2	95476804	95483546	ANKRD20A8P	6742	0.322456
chr2	95534421	95613087	LOC442028	78666	0.431254
chr2	95537231	95542568	TEKT4	5337	0.632190
chr2	95691399	95719737	MAL	28338	0.520785
chr2	95752951	95787754	MRPS5	34803	0.418125
chr2	95813399	95825263	ZNF514	11864	0.457856
chr2	95831182	95850064	ZNF2	18882	0.446510
chr2	95940200	95957055	PROM2	16855	0.588787
chr2	95963071	96051825	KCNIP3	88754	0.536877
chr2	96068447	96078879	FAHD2A	10432	0.485525
chr2	96080755	96082345	AX747836	1590	0.513837
chr2	96142714	96150479	TRIM43B	7765	0.395879
chr2	96192398	96198153	AK055967	5755	0.504952
chr2	96257765	96265469	TRIM43	7704	0.397196
chr2	96331831	96334463	BC016831	2632	0.468465
chr2	96455401	96463594	GPAT2	8193	0.554009
chr2	96472812	96492729	AL832439	19917	0.400211
chr2	96521755	96573247	ANKRD36C	51492	0.359221
chr2	96592961	96657541	DKFZp667P0924	64580	0.353453
chr2	96676298	96688884	FAHD2CP	12586	0.492055
chr2	96687693	96700727	GPAT2	13034	0.567823
chr2	96778622	96781888	ADRA2B	3266	0.594611
chr2	96789588	96804175	ASTL	14587	0.522177
chr2	96808907	96811179	DUSP2	2272	0.636444
chr2	96850602	96874573	STARD7	23971	0.429978
chr2	96874153	96908362	LOC285033	34209	0.465930
chr2	96915945	96931751	TMEM127	15806	0.509617
chr2	96931883	96939900	CIAO1	8017	0.489335
chr2	96940073	96971307	SNRNP200	31234	0.475988
chr2	96991944	96994091	ITPRIPL1	2147	0.550070
chr2	97001483	97041274	NCAPH	39791	0.453143
chr2	97165719	97171094	NEURL3	5375	0.594419
chr2	97202463	97218371	ARID5A	15908	0.553809
chr2	97258891	97304116	KANSL3	45225	0.443051
chr2	97308573	97370624	FER1L5	62051	0.507405
chr2	97371666	97405813	LMAN2L	34147	0.449761
chr2	97426638	97477628	CNNM4	50990	0.501628
chr2	97464014	97464090	MIR3127	76	0.644737
chr2	97481990	97501121	CNNM3	19131	0.528305
chr2	97503650	97509758	ANKRD23	6108	0.582024
chr2	97513723	97523756	ANKRD39	10033	0.489784
chr2	97525472	97535735	SEMA4C	10263	0.616292
chr2	97541618	97652301	FAM178B	110683	0.521010
chr2	97749322	97760582	FAHD2B	11260	0.486945
chr2	97779232	97930257	ANKRD36	151025	0.359172
chr2	97948228	97957632	LOC100506123	9404	0.397703
chr2	98081675	98091049	LOC100506123	9374	0.397589
chr2	98121260	98206428	ANKRD36B	85168	0.356965
chr2	98262520	98264657	COX5B	2137	0.512401
chr2	98272401	98280561	ACTR1B	8160	0.586152
chr2	98286205	98319529	LOC728537	33324	0.448386
chr2	98330030	98356323	ZAP70	26293	0.551021
chr2	98372800	98612354	TMEM131	239554	0.392888
chr2	98529516	98529580	U7	64	0.312500
chr2	98703594	98929410	VWA3B	225816	0.419319
chr2	98962617	99015064	CNGA3	52447	0.473430
chr2	99061320	99207496	INPP4A	146176	0.473005
chr2	99215785	99224981	COA5	9196	0.428991
chr2	99225041	99234977	UNC50	9936	0.428140
chr2	99235568	99347589	MGAT4A	112021	0.400130
chr2	99410308	99552684	KIAA1211L	142376	0.460092
chr2	99613723	99771187	TSGA10	157464	0.375889
chr2	99741229	99757612	TSGA10	16383	0.402185
chr2	99758184	99767928	C2orf15	9744	0.425287
chr2	99797541	99816020	MRPL30	18479	0.402186
chr2	99771417	99779613	LIPT1	8196	0.413372
chr2	99785725	99797492	MITD1	11767	0.391264
chr2	99858710	99871570	LYG2	12860	0.418663
chr2	99900700	99917639	LYG1	16939	0.425291
chr2	99935486	99952860	TXNDC9	17374	0.413204
chr2	99953833	100016728	EIF5B	62895	0.385643
chr2	100016937	100106480	REV1	89543	0.393241
chr2	100163715	100722045	AFF3	558330	0.415865
chr2	100824715	100867946	BC105019	43231	0.455298
chr2	100889752	100939195	LONRF2	49443	0.414760
chr2	101008321	101034130	CHST10	25809	0.489248
chr2	101086943	101099742	NMS	12799	0.436128
chr2	101179417	101193201	PDCL3	13784	0.466918
chr2	101436612	101613287	NPAS2	176675	0.458361
chr2	101618690	101636155	RPL31	17465	0.419754
chr2	101623689	101767846	TBC1D8	144157	0.443808
chr2	101768121	101771874	BC077729	3753	0.476152
chr2	101869344	101886778	CNOT11	17434	0.432029
chr2	101889397	101889511	SNORD89	114	0.473684
chr2	101892062	101925178	RNF149	33116	0.411040
chr2	101925911	101925996	MIR5696	85	0.411765
chr2	101964815	102003965	CREG2	39150	0.456833
chr2	102013822	102091165	RFX8	77343	0.452413
chr2	102314164	102511152	MAP4K4	196988	0.409355
chr2	102608305	102644884	IL1R2	36579	0.446786
chr2	102770400	102796334	IL1R1	25934	0.391918
chr2	102803432	102855811	IL1RL2	52379	0.415548
chr2	102979092	103015217	IL18R1	36125	0.400000
chr2	102927961	102968497	IL1RL1	40536	0.396339
chr2	103035253	103069024	IL18RAP	33771	0.400462
chr2	103048748	103048826	MIR4772	78	0.487179
chr2	103089761	103150431	SLC9A4	60670	0.409659
chr2	103236165	103327809	SLC9A2	91644	0.404740
chr2	103333665	103353337	MFSD9	19672	0.421259
chr2	103378489	103434138	TMEM182	55649	0.382163
chr2	103486031	103486051	DD413674	20	0.300000
chr2	104995307	105024790	LOC100287010	29483	0.411288
chr2	105050804	105129215	LOC150568	78411	0.386438
chr2	105363094	105374177	LOC284998	11083	0.465217
chr2	105421882	105467934	LOC100506421	46052	0.417984
chr2	105471968	105473471	POU3F3	1503	0.739188
chr2	105481954	105488840	AK095498	6886	0.513506
chr2	105654482	105716418	MRPS9	61936	0.366088
chr2	105858199	105859924	GPR45	1725	0.585507
chr2	105880846	105882690	LOC644617	1844	0.432755
chr2	105883539	105946148	TGFBRAP1	62609	0.438036
chr2	105954012	105961984	C2orf49	7972	0.390617
chr2	105977282	106015681	FHL2	38399	0.463163
chr2	106209553	106227016	LOC285000	17463	0.444082
chr2	106468203	106510730	NCK2	42527	0.455052
chr2	106682112	106694609	C2orf40	12497	0.460751
chr2	106709758	106810795	UXS1	101037	0.450310
chr2	106998569	107007851	PLGLA	9282	0.398836
chr2	107021135	107084801	RGPD3	63666	0.402208
chr2	107418055	107503563	ST6GAL2	85508	0.413435
chr2	108439519	108443285	LOC729121	3766	0.368826
chr2	108443387	108509000	RGPD4	65613	0.404554
chr2	108602994	108630443	SLC5A7	27449	0.372582
chr2	108863650	108881807	SULT1C3	18157	0.378477
chr2	108905094	108926371	SULT1C2	21277	0.444189
chr2	108938693	108970254	SULT1C2P1	31561	0.421628
chr2	108994420	109004270	SULT1C4	9850	0.400914
chr2	109065576	109125854	GCC2	60278	0.382776
chr2	109123996	109150675	FLJ38668	26679	0.414446
chr2	109271267	109303702	LIMS1	32435	0.405550
chr2	109335936	109402267	RANBP2	66331	0.390104
chr2	109403218	109492847	CCDC138	89629	0.374968
chr2	109510926	109605828	EDAR	94902	0.488483
chr2	109743783	109746575	SH3RF3-AS1	2792	0.643266
chr2	109745996	110262207	SH3RF3	516211	0.352220
chr2	109757945	109758044	MIR4265	99	0.595960
chr2	109930026	109930081	MIR4266	55	0.672727
chr2	110300373	110371783	SEPT10	71410	0.403445
chr2	110339914	110342057	AX747172	2143	0.409706
chr2	110371910	110376564	SOWAHC	4654	0.475935
chr2	110550334	110615282	RGPD6	64948	0.393376
chr2	110656008	110664033	LIMS3	8025	0.427664
chr2	110679216	110721127	LIMS3-LOC440895	41911	0.428432
chr2	110732487	110732549	DQ584199	62	0.516129
chr2	110744556	110752858	LOC440894	8302	0.471694
chr2	110751770	110751798	DQ571479	28	0.571429
chr2	110827537	110827619	MIR4267	82	0.658537
chr2	110841446	110874143	MALL	32697	0.473285
chr2	110844009	110844100	MIR4436B1	91	0.582418
chr2	110880913	110962639	NPHP1	81726	0.395040
chr2	110969105	110980516	LINC00116	11411	0.430637
chr2	111003214	111024135	LOC100507334	20921	0.434492
chr2	111030450	111030512	DQ584199	62	0.516129
chr2	111032524	111032565	DQ595602	41	0.365854
chr2	111033229	111033271	DQ587734	42	0.500000
chr2	111042429	111042520	MIR4436B1	91	0.582418
chr2	111132685	111142113	LOC440894	9428	0.472953
chr2	111134824	111134852	DQ571479	28	0.571429
chr2	111143987	111192743	LIMS3-LOC440895	48756	0.452252
chr2	111153819	111153857	DQ586666	38	0.605263
chr2	111154093	111154155	DQ581602	62	0.516129
chr2	111222627	111230652	LIMS3	8025	0.427664
chr2	111271378	111336309	RGPD6	64931	0.393187
chr2	111395408	111435684	BUB1	40276	0.382461
chr2	111443670	111443702	DQ594093	32	0.468750
chr2	111447395	111447450	DQ573754	55	0.327273
chr2	111447819	111447856	DQ593945	37	0.351351
chr2	111453577	111453619	DQ574014	42	0.500000
chr2	111454283	111454324	DQ592678	41	0.365854
chr2	111456069	111456107	DQ586666	38	0.605263
chr2	111456343	111456405	DQ581602	62	0.516129
chr2	111457037	111457101	DQ599706	64	0.421875
chr2	111457602	111457638	DQ586378	36	0.555556
chr2	111457826	111457860	DQ573409	34	0.411765
chr2	111457980	111458015	DQ586966	35	0.400000
chr2	111458324	111458355	DQ586506	31	0.516129
chr2	111471361	111471391	DQ579470	30	0.500000
chr2	111490149	111875799	ACOXL	385650	0.426514
chr2	111855921	111871762	AK125994	15841	0.400859
chr2	111878490	111926022	BCL2L11	47532	0.437116
chr2	111965358	112252692	LOC541471	287334	0.446922
chr2	112078588	112078668	MIR4435-1	80	0.550000
chr2	112249106	112249838	AX747531	732	0.461749
chr2	112257364	112258585	AX747531	1221	0.366093
chr2	112525213	112641741	ANAPC1	116528	0.388671
chr2	112656190	112786945	MERTK	130755	0.436144
chr2	112812799	112876895	TMEM87B	64096	0.395142
chr2	112895961	112945791	FBLN7	49830	0.495164
chr2	112973438	113012664	ZC3H8	39226	0.382680
chr2	113033177	113097640	ZC3H6	64463	0.369095
chr2	113057425	113063330	ZC3H6	5905	0.340051
chr2	113125945	113191222	RGPD8	65277	0.396143
chr2	113239742	113290222	TTL	50480	0.427615
chr2	113299491	113334727	POLR1B	35236	0.421699
chr2	113342035	113346617	CHCHD5	4582	0.533173
chr2	113399406	113401757	FLJ42351	2351	0.481923
chr2	113403433	113421400	SLC20A1	17967	0.424556
chr2	113479062	113500454	NT5DC4	21392	0.486864
chr2	113495443	113522254	CKAP2L	26811	0.396404
chr2	113531491	113542971	IL1A	11480	0.401655
chr2	113587336	113594356	IL1B	7020	0.455698
chr2	113670547	113676458	IL37	5911	0.504652
chr2	113735605	113743227	IL36G	7622	0.442666
chr2	113763448	113765621	IL36A	2173	0.406811
chr2	113779667	113810440	IL36B	30773	0.412829
chr2	113816684	113822320	IL36RN	5636	0.495919
chr2	113825546	113833427	IL1F10	7881	0.463901
chr2	113885137	113891593	IL1RN	6456	0.505886
chr2	113931559	113960677	PSD4	29118	0.523662
chr2	113963502	113966973	AK123617	3471	0.486027
chr2	113973573	114036498	PAX8	62925	0.491553
chr2	113993103	114024600	LOC654433	31497	0.490809
chr2	113993103	113998419	LOC654433	5316	0.534236
chr2	114195267	114253781	CBWD2	58514	0.362751
chr2	114256660	114258727	FOXD4L1	2067	0.597484
chr2	114297631	114300242	AY343891	2611	0.567982
chr2	114320850	114320877	DQ598479	27	0.407407
chr2	114334958	114336429	FAM138B	1471	0.505099
chr2	114341204	114341711	DKFZp434K1323	507	0.719921
chr2	114353644	114356613	WASH2P	2969	0.591782
chr2	114356604	114359153	DDX11L2	2549	0.572381
chr2	114368815	114384715	RPL23AP7	15900	0.408931
chr2	114384816	114400975	RABL2A	16159	0.499103
chr2	114438687	114438794	U6	107	0.392523
chr2	114471932	114514400	SLC35F5	42468	0.363191
chr2	114478866	114478945	MIR4782	79	0.379747
chr2	114647510	114719129	ACTR3	71619	0.366858
chr2	114735245	114737561	LOC100499194	2316	0.562176
chr2	114737145	114764887	LOC440900	27742	0.433206
chr2	115919512	116602326	DPP10	682814	0.356047
chr2	115586008	115591125	BC033566	5117	0.362908
chr2	115901624	115918920	LOC389023	17296	0.362454
chr2	117781154	117781185	DQ571524	31	0.451613
chr2	117897290	117897351	U7	61	0.426230
chr2	118572254	118589953	DDX18	17699	0.392282
chr2	118673053	118771739	CCDC93	98686	0.427862
chr2	118846049	118867597	INSIG2	21548	0.380685
chr2	119599746	119605759	EN1	6013	0.581241
chr2	119699744	119752236	MARCO	52492	0.443344
chr2	119913818	119916471	C1QL2	2653	0.675462
chr2	119981383	120023227	STEAP3	41844	0.516848
chr2	120060019	120124258	C2orf76	64239	0.391927
chr2	120124828	120130122	DBI	5294	0.495844
chr2	120189445	120196096	TMEM37	6651	0.547436
chr2	120197418	120282028	SCTR	84610	0.467392
chr2	120302007	120414237	PCDP1	112230	0.414506
chr2	120436742	120439694	TMEM177	2952	0.520664
chr2	120517206	120742474	PTPN4	225268	0.370079
chr2	120770603	120936697	EPB41L5	166094	0.384963
chr2	120975046	120980984	TMEM185B	5938	0.502863
chr2	121010413	121052286	RALB	41873	0.447018
chr2	121103718	121109383	INHBB	5665	0.560812
chr2	121221910	121223925	LOC84931	2015	0.580149
chr2	121554866	121750229	GLI2	195363	0.525509
chr2	121974163	122042778	TFCP2L1	68615	0.485258
chr2	122095351	122407052	CLASP1	311701	0.410486
chr2	122288455	122288585	RNU4ATAC	130	0.446154
chr2	122407229	122486136	LOC254128	78907	0.440709
chr2	122407229	122409114	LOC254128	1885	0.475332
chr2	122484520	122494503	MKI67IP	9983	0.430131
chr2	122513120	122525428	TSN	12308	0.414690
chr2	124626832	124627147	7SK	315	0.507937
chr2	124769621	124771990	AX747402	2369	0.385817
chr2	124782863	125672863	CNTNAP5	890000	0.389331
chr2	127413510	127454251	GYPC	40741	0.501976
chr2	127805598	127864903	BIN1	59305	0.596543
chr2	127941411	127963343	CYP27C1	21932	0.463934
chr2	128014865	128051752	ERCC3	36887	0.461816
chr2	128056244	128100805	MAP3K2	44561	0.368192
chr2	128175995	128186822	PROC	10827	0.576706
chr2	128181112	128181194	MIR4783	82	0.743902
chr2	128238382	128284087	IWS1	45705	0.397746
chr2	128258672	128259739	BC022892	1067	0.358950
chr2	128293377	128395303	MYO7B	101926	0.510243
chr2	128395995	128422167	LIMS2	26172	0.592045
chr2	128403438	128410213	GPR17	6775	0.593948
chr2	128458596	128461407	SFT2D3	2811	0.536464
chr2	128461807	128568761	WDR33	106954	0.414926
chr2	128603839	128615729	POLR2D	11890	0.453827
chr2	128619206	128642434	AMMECR1L	23228	0.447047
chr2	128643658	128643749	DL490450	91	0.582418
chr2	128698790	128784869	SAP130	86079	0.430848
chr2	128848753	128953249	UGGT1	104496	0.408398
chr2	129023053	129076171	HS6ST1	53118	0.568451
chr2	129622178	129626301	AK311291	4123	0.429542
chr2	129999745	130031421	LOC151121	31676	0.402734
chr2	130680434	130691890	LOC389033	11456	0.505325
chr2	130724164	130738045	LOC100131320	13881	0.417621
chr2	130737234	130740311	RAB6C	3077	0.431914
chr2	130783571	130808704	LOC440905	25133	0.419647
chr2	130817128	130817160	DQ573684	32	0.468750
chr2	130817941	130817975	DQ573684	34	0.470588
chr2	130818008	130818038	DQ587539	30	0.566667
chr2	130818479	130818511	DQ573684	32	0.468750
chr2	130818544	130818574	DQ587539	30	0.566667
chr2	130819328	130819364	DQ582260	36	0.555556
chr2	130819650	130819684	DQ573684	34	0.470588
chr2	130819717	130819747	DQ587539	30	0.566667
chr2	130819959	130819995	DQ582260	36	0.555556
chr2	130820283	130820317	DQ573684	34	0.470588
chr2	130820351	130820391	DQ587539	40	0.600000
chr2	130820578	130820618	DQ595048	40	0.575000
chr2	130820958	130820989	DQ589348	31	0.548387
chr2	130822271	130822305	DQ573684	34	0.470588
chr2	130822338	130822368	DQ587539	30	0.566667
chr2	130823129	130823159	DQ590589	30	0.566667
chr2	130823449	130823481	DQ573684	32	0.468750
chr2	130823769	130823799	DQ590589	30	0.566667
chr2	130824202	130824234	DQ573684	32	0.468750
chr2	130825509	130825549	DQ590589	40	0.575000
chr2	130831107	130886795	POTEF	55688	0.388576
chr2	130887195	130896986	CCDC74B-AS1	9791	0.481769
chr2	130896855	130902707	CCDC74B	5852	0.616883
chr2	130908964	130940323	SMPD4	31359	0.539622
chr2	130939500	130948300	MZT2B	8800	0.574659
chr2	130940897	130942576	FLJ14346	1679	0.606313
chr2	130949317	130956034	TUBA3E	6717	0.517493
chr2	131029910	131029982	TRNA	72	0.444444
chr2	131031158	131031227	TRNA	69	0.318841
chr2	131031228	131031301	TRNA	73	0.356164
chr2	131031333	131031399	TRNA	66	0.469697
chr2	131031399	131031463	TRNA	64	0.359375
chr2	131035540	131035608	TRNA	68	0.294118
chr2	131037796	131037867	TRNA	71	0.352113
chr2	131040179	131040248	TRNA	69	0.289855
chr2	131095815	131099922	CCDC115	4107	0.513757
chr2	131100488	131104197	IMP4	3709	0.559180
chr2	131113579	131132982	PTPN18	19403	0.476473
chr2	131174325	131186119	LOC100216479	11794	0.393590
chr2	131193234	131198988	BC069809	5754	0.466806
chr2	131208622	131208651	DQ589348	29	0.551724
chr2	131208796	131208832	DQ582260	36	0.555556
chr2	131209187	131209227	DQ587539	40	0.600000
chr2	131209794	131209823	DQ589348	29	0.551724
chr2	131209964	131210004	DQ582260	40	0.600000
chr2	131211071	131211100	DQ589348	29	0.551724
chr2	131211245	131211281	DQ582260	36	0.555556
chr2	131212385	131212417	DQ573684	32	0.468750
chr2	131213061	131213090	DQ589348	29	0.517241
chr2	131220388	131266808	POTEI	46420	0.376476
chr2	131278666	131285565	CFC1B	6899	0.531236
chr2	131296668	131307488	LOC646743	10820	0.553604
chr2	131328401	131339208	LOC646743	10807	0.553715
chr2	131349737	131357251	CFC1	7514	0.529811
chr2	131369105	131415610	POTEJ	46505	0.375164
chr2	131422745	131422774	DQ600793	29	0.517241
chr2	131423920	131423949	DQ600792	29	0.551724
chr2	131424589	131424623	DQ599716	34	0.470588
chr2	131426350	131426382	DQ591735	32	0.468750
chr2	131426850	131426879	DQ600792	29	0.551724
chr2	131428019	131428048	DQ600792	29	0.551724
chr2	131437622	131443435	CYP4F30P	5813	0.466024
chr2	131451086	131462317	AK054990	11231	0.383848
chr2	131486642	131487909	GPR148	1267	0.574586
chr2	131513076	131525707	AMER3	12631	0.554905
chr2	131588550	131594567	AX746725	6017	0.561409
chr2	131595027	131672771	AK127124	77744	0.481954
chr2	131674223	131804836	ARHGEF4	130613	0.455008
chr2	131805448	131851004	FAM168B	45556	0.457700
chr2	131862419	131907425	PLEKHB2	45006	0.443452
chr2	131975923	132022416	POTEE	46493	0.377777
chr2	132029530	132029559	DQ600793	29	0.517241
chr2	132029667	132029699	DQ591735	32	0.468750
chr2	132030203	132030237	DQ599716	34	0.470588
chr2	132031018	132031050	DQ591735	32	0.468750
chr2	132031517	132031548	DQ600792	31	0.548387
chr2	132032193	132032227	DQ599716	34	0.470588
chr2	132033004	132033040	DQ570062	36	0.472222
chr2	132033507	132033538	DQ600792	31	0.548387
chr2	132034182	132034210	DQ591735	28	0.464286
chr2	132034685	132034714	DQ600792	29	0.517241
chr2	132035460	132035495	DQ587054	35	0.457143
chr2	132036862	132057392	LOC440910	20530	0.471943
chr2	132050804	132050830	DQ601639	26	0.423077
chr2	132118064	132121731	WTH3DI	3667	0.401963
chr2	132127288	132127357	TRNA	69	0.304348
chr2	132129666	132129737	TRNA	71	0.323944
chr2	132137656	132137724	TRNA	68	0.294118
chr2	132141651	132141715	TRNA	64	0.390625
chr2	132141813	132141886	TRNA	73	0.369863
chr2	132141887	132141956	TRNA	69	0.318841
chr2	132160473	132165801	LOC389043	5328	0.400338
chr2	132199733	132202467	LOC401010	2734	0.584492
chr2	132233579	132240507	TUBA3D	6928	0.523095
chr2	132241532	132250064	MZT2A	8532	0.572316
chr2	132248732	132248809	MIR4784	77	0.597403
chr2	132250385	132276309	LOC150776	25924	0.534833
chr2	132276292	132279149	LOC150776	2857	0.581029
chr2	132285406	132291239	CCDC74A	5833	0.615635
chr2	132360440	132360468	RNU6-81P	28	0.321429
chr2	132383958	132384268	FKSG30	310	0.593548
chr2	132390859	132390893	DQ599716	34	0.470588
chr2	132394283	132394315	DQ583165	32	0.468750
chr2	132442469	132457442	BX648270	14973	0.388499
chr2	132480063	132524977	C2orf27A	44914	0.407646
chr2	132552533	132559234	C2orf27B	6701	0.561856
chr2	132905163	132919525	ANKRD30BL	14362	0.351274
chr2	133014538	133014653	MIR663B	115	0.704348
chr2	133062358	133080309	AK094599	17951	0.415464
chr2	133164324	133164431	U6	107	0.355140
chr2	133174146	133404169	GPR39	230023	0.429257
chr2	133402336	133428481	LYPD1	26145	0.449417
chr2	133429371	134326031	NCKAP5	896660	0.393037
chr2	133673155	133689067	BC031872	15912	0.385935
chr2	134023813	134026613	BC008215	2800	0.493929
chr2	134353661	134353970	7SK	309	0.533981
chr2	134884695	134884763	MIR3679	68	0.529412
chr2	135011829	135212192	MGAT5	200363	0.421655
chr2	135213329	135476571	TMEM163	263242	0.437164
chr2	135596185	135659602	ACMSD	63417	0.395162
chr2	135624202	135676176	LOC100129961	51974	0.384866
chr2	135676391	135716915	CCNT2	40524	0.370595
chr2	135722272	135782248	MAP3K19	59976	0.414949
chr2	135809834	135928279	RAB3GAP1	118445	0.374807
chr2	135957573	136288806	ZRANB3	331233	0.387365
chr2	136289082	136482839	R3HDM1	193757	0.379677
chr2	136422966	136423048	MIR128-1	82	0.500000
chr2	136499188	136542633	UBXN4	43445	0.398251
chr2	136545414	136594750	LCT	49336	0.472069
chr2	136577760	136580657	LOC100507600	2897	0.456334
chr2	136597195	136634047	MCM6	36852	0.403316
chr2	136664253	136743222	DARS	78969	0.369056
chr2	136871918	136875725	CXCR4	3807	0.519832
chr2	137147901	137148239	7SK	338	0.449704
chr2	137748461	138435287	THSD7B	686826	0.374507
chr2	138721807	138773934	HNMT	52127	0.368159
chr2	139259349	139330805	SPOPL	71456	0.367093
chr2	139426726	139537811	NXPH2	111085	0.381465
chr2	139654893	139656744	YY1P2	1851	0.380335
chr2	140988995	142889270	LRP1B	1900275	0.348188
chr2	141924825	141924926	U6	101	0.356436
chr2	143635194	143799885	KYNU	164691	0.375740
chr2	143886898	144525921	ARHGAP15	639023	0.364835
chr2	144703580	145090083	GTDC1	386503	0.367971
chr2	145141941	145277958	ZEB2	136017	0.382989
chr2	145277180	145278465	ZEB2-AS1	1285	0.464591
chr2	145425533	145834291	TEX41	408758	0.365382
chr2	145462783	145462986	VIS1	203	0.413793
chr2	145780738	145910072	U80770	129334	0.360686
chr2	147344624	147348558	PABPC1P2	3934	0.432384
chr2	148602569	148688393	ACVR2A	85824	0.353118
chr2	148634990	148635097	U6	107	0.392523
chr2	148687965	148779173	ORC4	91208	0.361492
chr2	148778579	149271044	MBD5	492465	0.362810
chr2	149402559	149545136	EPC2	142577	0.369302
chr2	149632791	149883273	KIF5C	250482	0.258530
chr2	149639364	149639388	JB137817	24	0.416667
chr2	149894980	150071772	LYPD6B	176792	0.399294
chr2	150186498	150330659	LYPD6	144161	0.398721
chr2	150222141	150222268	U2	127	0.299213
chr2	150426146	150444330	MMADHC	18184	0.351463
chr2	150467181	150467288	U6	107	0.373832
chr2	151324706	151344209	RND3	19503	0.411526
chr2	151542508	151542545	SNORD95	37	0.432432
chr2	152104727	152118389	RBM43	13662	0.429659
chr2	152126981	152146430	NMI	19449	0.398735
chr2	152194341	152235885	FW340097	41544	0.398277
chr2	152214105	152236562	TNFAIP6	22457	0.384424
chr2	152224847	152224925	MIR4773-2	78	0.487179
chr2	152224847	152224925	MIR4773-1	78	0.487179
chr2	152266396	152333860	RIF1	67464	0.383568
chr2	152341852	152591001	NEB	249149	0.388101
chr2	152657479	152685009	ARL5A	27530	0.372575
chr2	152689285	152955593	CACNB4	266308	0.414591
chr2	152973314	153032506	STAM2	59192	0.390948
chr2	153191750	153506348	FMNL2	314598	0.405673
chr2	153508106	153573975	PRPF40A	65869	0.360579
chr2	153574406	153617767	ARL6IP6	43361	0.369087
chr2	154333851	154335322	RPRM	1471	0.596193
chr2	154728425	155310489	GALNT13	582064	0.351592
chr2	155292364	155313950	LOC100144595	21586	0.332623
chr2	155555092	155714864	KCNJ3	159772	0.348265
chr2	156877046	157111432	BC032407	234386	0.361779
chr2	157180943	157189287	NR4A2	8344	0.480345
chr2	157193083	157198172	AK128708	5089	0.333071
chr2	157292899	157442915	GPD2	150016	0.381466
chr2	158114339	158167913	GALNT5	53574	0.396144
chr2	158175124	158184146	ERMN	9022	0.370095
chr2	158271130	158300604	CYTIP	29474	0.371242
chr2	158383278	158485399	ACVR1C	102121	0.368308
chr2	158592957	158732374	ACVR1	139417	0.403057
chr2	158769283	158769397	U6	114	0.350877
chr2	158851690	158992666	UPP2	140976	0.399933
chr2	159023161	159092681	CCDC148-AS1	69520	0.381214
chr2	159027868	159313265	CCDC148	285397	0.379153
chr2	159313475	159537940	PKP4	224465	0.385633
chr2	159390711	159390796	SnoZ5	85	0.329412
chr2	159514848	159591514	AK126351	76666	0.441460
chr2	159651828	159672496	DAPL1	20668	0.406425
chr2	159792309	159792497	U2	188	0.398936
chr2	159825145	160089170	TANC1	264025	0.434262
chr2	160092303	160143236	WDSUB1	50933	0.390631
chr2	160175489	160473112	BAZ2B	297623	0.361625
chr2	160569009	160625084	MARCH7	56075	0.381864
chr2	160625138	160761267	LY75-CD302	136129	0.382909
chr2	160797259	160919126	PLA2R1	121867	0.393413
chr2	160958232	161056589	ITGB6	98357	0.394105
chr2	161128661	161350318	RBMS1	221657	0.391998
chr2	161264320	161264393	MIR4785	73	0.808219
chr2	161993465	162092683	TANK	99218	0.357576
chr2	162101249	162105241	AK027541	3992	0.404810
chr2	162164785	162268228	PSMD14	103443	0.353799
chr2	162196026	162196646	BC073897	620	0.417742
chr2	162272619	162281573	TBR1	8954	0.485928
chr2	162355577	162364413	AHCTF1P1	8836	0.395088
chr2	162480844	162841786	SLC4A10	360942	0.352104
chr2	162848754	162931052	DPP4	82298	0.396753
chr2	162999378	163008914	GCG	9536	0.341967
chr2	163027199	163100045	FAP	72846	0.367035
chr2	163123588	163175218	IFIH1	51630	0.357563
chr2	163200582	163219148	GCA	18566	0.334913
chr2	163227916	163695257	KCNH7	467341	0.350352
chr2	163625448	163654482	BC042876	29034	0.348832
chr2	164464117	164592513	FIGN	128396	0.364599
chr2	165349322	165478360	GRB14	129038	0.371782
chr2	165541257	165697928	COBLL1	156671	0.359556
chr2	165544152	165544287	SNORA70F	135	0.488889
chr2	165754708	165812035	SLC38A11	57327	0.353760
chr2	165944029	166060577	SCN3A	116548	0.350740
chr2	166152282	166248820	SCN2A	96538	0.350100
chr2	166428845	166545917	CSRNP3	117072	0.372642
chr2	166604312	166650803	GALNT3	46491	0.368695
chr2	166713985	166728451	LOC100506124	14466	0.399350
chr2	166729871	166810348	TTC21B	80477	0.354288
chr2	166790366	166804831	LOC100506134	14465	0.354096
chr2	166845669	166930180	SCN1A	84511	0.339932
chr2	166938040	167158293	BC051759	220253	0.357035
chr2	167051696	167232497	SCN9A	180801	0.344412
chr2	167260082	167343481	SCN7A	83399	0.341431
chr2	167744996	168116261	XIRP2	371265	0.361933
chr2	168675181	168727366	B3GALT1	52185	0.403009
chr2	168810529	169104105	STK39	293576	0.401157
chr2	169312758	169631644	CERS6	318886	0.392811
chr2	169439452	169439528	MIR4774	76	0.342105
chr2	169628460	169642939	CERS6-AS1	14479	0.413495
chr2	169658890	169721849	NOSTRIN	62959	0.408202
chr2	169727400	169746944	SPC25	19544	0.376791
chr2	169757749	169766510	G6PC2	8761	0.373473
chr2	169779448	169887833	ABCB11	108385	0.369267
chr2	169937616	169952677	DHRS9	15061	0.398314
chr2	169983618	170219122	LRP2	235504	0.395900
chr2	170183042	170183721	BC016143	679	0.714286
chr2	170366211	170382772	KLHL41	16561	0.385424
chr2	170386262	170430424	FASTKD1	44162	0.380033
chr2	170440849	170494254	PPIG	53405	0.383972
chr2	170501934	170550931	CCDC173	48997	0.386758
chr2	170590355	170608396	KLHL23	18041	0.425309
chr2	170550963	170558218	PHOSPHO2	7255	0.372433
chr2	170655321	170668571	SSB	13250	0.391019
chr2	170668267	170681353	METTL5	13086	0.401116
chr2	170684017	170940639	UBR3	256622	0.368717
chr2	171006860	171007413	BC016143	553	0.500904
chr2	171034654	171511674	MYO3B	477020	0.402086
chr2	171496888	171551884	AK127400	54996	0.413576
chr2	171568948	171571077	LOC440925	2129	0.604039
chr2	171571856	171574498	SP5	2642	0.669947
chr2	171579718	171627276	AK023515	47558	0.414000
chr2	171627603	171634757	LOC100505695	7154	0.400475
chr2	171640295	171655476	ERICH2	15181	0.372307
chr2	171673199	171717659	GAD1	44460	0.453396
chr2	171784947	171823643	GORASP2	38696	0.410378
chr2	171847332	172087824	TLK1	240492	0.380803
chr2	172173912	172291312	METTL8	117400	0.393901
chr2	172290760	172341562	DCAF17	50802	0.373391
chr2	172378865	172414643	CYBRD1	35778	0.411985
chr2	172543918	172606668	DYNC1I2	62750	0.363602
chr2	172639914	172750816	SLC25A12	110902	0.396007
chr2	172778934	172848600	HAT1	69666	0.400554
chr2	172864803	172945587	METAP1D	80784	0.397504
chr2	172950207	172954401	DLX1	4194	0.534335
chr2	172964165	172967478	DLX2	3313	0.590401
chr2	173292313	173371181	ITGA6	78868	0.416937
chr2	173420778	173463862	PDK1	43084	0.391468
chr2	173587917	173600934	RAPGEF4-AS1	13017	0.429592
chr2	173600524	173917620	RAPGEF4	317096	0.405108
chr2	173940564	174132737	ZAK	192173	0.388556
chr2	174062440	174146764	MLK7-AS1	84324	0.401843
chr2	174219560	174233718	CDCA7	14158	0.432123
chr2	174771186	174830430	SP3	59244	0.376966
chr2	174937174	175113365	OLA1	176191	0.364837
chr2	175190754	175195370	LOC285084	4616	0.528596
chr2	175199820	175202268	SP9	2448	0.639297
chr2	175212877	175260443	CIR1	47566	0.377412
chr2	175260456	175294303	SCRN3	33847	0.378970
chr2	175296299	175351816	GPR155	55517	0.391736
chr2	175411868	175639554	BC046497	227686	0.429552
chr2	175424301	175499307	WIPF1	75006	0.412740
chr2	175612322	175629200	CHRNA1	16878	0.440455
chr2	175664041	175869981	CHN1	205940	0.371958
chr2	175894496	175894605	U6	109	0.366972
chr2	175936977	176032934	ATF2	95957	0.359911
chr2	176032360	176032437	MIR933	77	0.662338
chr2	176040985	176046391	ATP5G3	5406	0.394747
chr2	176790409	176867018	KIAA1715	76609	0.350638
chr2	176944834	176948690	EVX2	3856	0.599066
chr2	176957531	176960666	HOXD13	3135	0.493780
chr2	176964529	176965488	HOXD12	959	0.650678
chr2	176972083	176974316	HOXD11	2233	0.636364
chr2	176981491	176984670	HOXD10	3179	0.491664
chr2	176987412	176989645	HOXD9	2233	0.601881
chr2	176992554	176993195	AX747372	641	0.452418
chr2	176993366	176994493	AX747372	1127	0.603372
chr2	176994467	176997423	HOXD8	2956	0.518268
chr2	176999568	177001826	HOXD-AS2	2258	0.527901
chr2	177001339	177005119	BC047605	3780	0.498677
chr2	177015030	177015140	MIR10B	110	0.400000
chr2	177016112	177017949	HOXD4	1837	0.598802
chr2	177028804	177037826	HOXD3	9022	0.498337
chr2	177037923	177053686	HOXD-AS1	15763	0.473387
chr2	177037923	177042841	HOXD-AS1	4918	0.478040
chr2	177053306	177055635	HOXD1	2329	0.565908
chr2	177134122	177202753	MTX2	68631	0.350235
chr2	177465707	177465780	MIR1246	73	0.438356
chr2	177494308	177502302	LOC375295	7994	0.374781
chr2	177529403	177529494	U6atac	91	0.395604
chr2	178077421	178088685	HNRNPA3	11264	0.395597
chr2	178095030	178129859	NFE2L2	34829	0.428235
chr2	178120672	178120738	MIR3128	66	0.303030
chr2	178257470	178408564	AGPS	151094	0.359955
chr2	178414880	178417524	TTC30B	2644	0.448185
chr2	178479025	178483694	TTC30A	4669	0.415078
chr2	178487976	178937482	PDE11A	449506	0.391565
chr2	178977181	178994382	RBM45	17201	0.369339
chr2	179059207	179264160	OSBPL6	204953	0.393544
chr2	179152018	179152059	SNORD77	41	0.317073
chr2	179246804	179541009	MIR548N	294205	0.388573
chr2	179278389	179298394	BX538254	20005	0.407248
chr2	179296140	179315958	PRKRA	19818	0.392471
chr2	179316162	179326110	DFNB59	9948	0.395356
chr2	179328390	179343355	FKBP7	14965	0.376412
chr2	179345198	179369782	PLEKHA3	24584	0.377563
chr2	179387553	179470132	TTN-AS1	82579	0.405103
chr2	179390716	179672150	TTN	281434	0.377932
chr2	179443516	179445633	AX746670	2117	0.403873
chr2	179641652	179644689	AK123298	3037	0.359236
chr2	179694483	179914786	CCDC141	220303	0.377435
chr2	179966418	180129350	SESTD1	162932	0.368528
chr2	180306710	180726232	ZNF385B	419522	0.369473
chr2	180725562	180725635	MIR1258	73	0.547945
chr2	180725607	180725628	JB175181	21	0.428571
chr2	180799127	180799265	SNORA43	138	0.449275
chr2	180809603	180871780	CWC22	62177	0.350113
chr2	181556830	181781666	SChLAP1	224836	0.362144
chr2	181845111	181928150	UBE2E3	83039	0.354087
chr2	181988563	182264280	AK125001	275717	0.358868
chr2	182170319	182170379	MIR4437	60	0.533333
chr2	182321618	182402468	ITGA4	80850	0.360965
chr2	182401400	182521834	CERKL	120434	0.365594
chr2	182540832	182545392	NEUROD1	4560	0.422807
chr2	182756471	182795464	SSFA2	38993	0.358116
chr2	182850550	182996109	PPP1R1C	145559	0.362355
chr2	183004761	183387572	PDE1A	382811	0.365677
chr2	183580767	183644750	DNAJC10	63983	0.361487
chr2	183698004	183731498	FRZB	33494	0.366603
chr2	183789578	183903586	NCKAP1	114008	0.354265
chr2	183943286	183964722	DUSP19	21436	0.381694
chr2	183989082	184026408	NUP35	37326	0.376949
chr2	185463092	185804214	ZNF804A	341122	0.340380
chr2	186411871	186411894	DD413621	23	0.391304
chr2	186584600	186603441	BC039382	18841	0.346638
chr2	186603354	186698016	FSIP2	94662	0.344552
chr2	187350884	187374087	ZC3H15	23203	0.372279
chr2	187454789	187545629	ITGAV	90840	0.357783
chr2	187558788	187628512	FAM171B	69724	0.373315
chr2	187692206	187713897	ZSWIM2	21691	0.325988
chr2	188206689	188313021	CALCRL	106332	0.330079
chr2	188293063	188313021	CALCRL	19958	0.320022
chr2	188328957	188419219	TFPI	90262	0.350402
chr2	189156395	189460652	GULP1	304257	0.353616
chr2	189162218	189162315	MIR561	97	0.453608
chr2	189598464	189654831	DIRC1	56367	0.341175
chr2	189839098	189877472	COL3A1	38374	0.337937
chr2	189842817	189842886	MIR1245A	69	0.304348
chr2	189842819	189842887	MIR1245B	68	0.308824
chr2	189860355	189860418	MIR3606	63	0.269841
chr2	189896640	190044605	COL5A2	147965	0.346197
chr2	189997761	189997837	MIR3129	76	0.434211
chr2	190306158	190340264	WDR75	34106	0.370433
chr2	190425315	190445537	SLC40A1	20222	0.370141
chr2	190435595	190435682	7SK	87	0.482759
chr2	190526124	190535557	ASNSD1	9433	0.376974
chr2	190540710	190611376	ANKAR	70666	0.372371
chr2	190611385	190627924	OSGEPL1	16539	0.390773
chr2	190627505	190630282	OSGEPL1-AS1	2777	0.402953
chr2	190634992	190649097	ORMDL1	14105	0.375328
chr2	190648810	190742355	PMS1	93545	0.368058
chr2	190920425	190927455	MSTN	7030	0.328449
chr2	191045680	191068210	C2orf88	22530	0.375988
chr2	191069359	191184771	HIBCH	115412	0.392524
chr2	191208195	191236391	INPP1	28196	0.401404
chr2	191273080	191367041	MFSD6	93961	0.398591
chr2	191371618	191399468	TMEM194B	27850	0.406643
chr2	191417989	191418206	7SK	217	0.465438
chr2	191513847	191557492	NAB1	43645	0.369848
chr2	191745546	191830270	GLS	84724	0.351176
chr2	191833761	191878976	STAT1	45215	0.420613
chr2	191894301	192016322	STAT4	122021	0.372706
chr2	192110106	192290115	MYO1B	180009	0.396302
chr2	192542860	192553248	NABP1	10388	0.377166
chr2	192699031	192712006	SDPR	12975	0.408324
chr2	192814746	193059644	TMEFF2	244898	0.359031
chr2	193614570	193641625	PCGEM1	27055	0.351950
chr2	195209005	195284355	BC038548	75350	0.333895
chr2	196521531	196602426	SLC39A10	80895	0.364979
chr2	196535095	196535198	U6	103	0.378641
chr2	196602426	196933536	DNAH7	331110	0.371028
chr2	196998306	197036336	STK17B	38030	0.367079
chr2	197063976	197457335	HECW2	393359	0.390948
chr2	197124837	197128922	BC062769	4085	0.378213
chr2	197504355	197597530	CCDC150	93175	0.375562
chr2	197565358	197577736	LOC100130452	12378	0.384715
chr2	197627755	197664492	GTF3C3	36737	0.367586
chr2	197669138	197675000	C2orf66	5862	0.371887
chr2	197697727	197791454	PGAP1	93727	0.358072
chr2	197851385	198175521	ANKRD44	324136	0.402572
chr2	198256697	198299771	SF3B1	43074	0.394391
chr2	198266281	198266315	SnR39B	34	0.382353
chr2	198318230	198339851	COQ10B	21621	0.417557
chr2	198351307	198364640	HSPD1	13333	0.412510
chr2	198364720	198418423	HSPE1-MOB4	53703	0.410256
chr2	198435526	198540584	RFTN2	105058	0.408565
chr2	198557829	198639547	BC021693	81718	0.383526
chr2	198570027	198573114	MARS2	3087	0.488176
chr2	198591602	198650938	BOLL	59336	0.374427
chr2	198669425	199014608	PLCL1	345183	0.376954
chr2	199164086	199239273	AK096499	75187	0.358267
chr2	200134222	200329831	SATB2	195609	0.382994
chr2	200323124	200324484	AK125157	1360	0.706618
chr2	200332820	200337481	SATB2-AS1	4661	0.539155
chr2	200489253	200523855	BC035629	34602	0.373649
chr2	200683082	200715896	FTCDNL1	32814	0.400622
chr2	200775978	200792996	C2orf69	17018	0.387590
chr2	200793633	200820459	TYW5	26826	0.374115
chr2	200820039	200828847	C2orf47	8808	0.400886
chr2	201171355	201346986	SPATS2L	175631	0.401376
chr2	201353683	201374792	KCTD18	21109	0.401014
chr2	201390864	201448818	SGOL2	57954	0.367516
chr2	201450730	201536217	AOX1	85487	0.414203
chr2	201560445	201658941	AOX2P	98496	0.425225
chr2	201577027	201599900	LOC100507140	22873	0.407773
chr2	201676907	201688569	BZW1	11662	0.397788
chr2	201717731	201729467	CLK1	11736	0.418456
chr2	201735678	201753849	PPIL3	18171	0.413846
chr2	201754049	201768655	NIF3L1	14606	0.410174
chr2	201763742	201763844	U6	102	0.401961
chr2	201774893	201828424	ORC2	53531	0.390708
chr2	201838440	201936392	FAM126B	97952	0.391590
chr2	201936461	201950473	NDUFB3	14012	0.410648
chr2	201944564	201944667	U6	103	0.300971
chr2	201980876	202037411	CFLAR	56535	0.443513
chr2	202002313	202002343	DQ582762	30	0.466667
chr2	202005011	202022515	CFLAR-AS1	17504	0.422246
chr2	202047620	202086383	CASP10	38763	0.423342
chr2	202122753	202152434	CASP8	29681	0.444291
chr2	202153146	202222101	ALS2CR12	68955	0.409049
chr2	202241929	202316319	TRAK2	74390	0.377363
chr2	202316391	202345574	STRADB	29183	0.388719
chr2	202352143	202483905	ALS2CR11	131762	0.378402
chr2	202484906	202508252	TMEM237	23346	0.387647
chr2	202509596	202563417	MPP4	53821	0.413798
chr2	202564985	202645895	ALS2	80910	0.380509
chr2	202671301	202760273	CDK15	88972	0.409758
chr2	202899309	202903160	FZD7	3851	0.528434
chr2	202937977	203061886	LOC100652824	123909	0.442147
chr2	203070902	203103322	SUMO1	32420	0.416564
chr2	203130514	203168384	NOP58	37870	0.411275
chr2	203141153	203141241	SNORD70	88	0.375000
chr2	203142830	203142915	SNORD70	85	0.364706
chr2	203156039	203156151	SNORD11B	112	0.339286
chr2	203157773	203157857	SNORD11	84	0.369048
chr2	203241049	203432474	BMPR2	191425	0.411211
chr2	203499900	203634480	FAM117B	134580	0.395304
chr2	203637872	203736371	ICA1L	98499	0.398502
chr2	203745322	203776949	WDR12	31627	0.393461
chr2	203776977	203851060	ALS2CR8	74083	0.385635
chr2	203879601	204082717	NBEAL1	203116	0.378916
chr2	204103163	204170563	CYP20A1	67400	0.424466
chr2	204193002	204296892	ABI2	103890	0.392511
chr2	204298538	204400058	RAPH1	101520	0.392819
chr2	204571197	204603636	CD28	32439	0.400012
chr2	204732510	204738683	CTLA4	6173	0.421999
chr2	204801470	204826298	ICOS	24828	0.382713
chr2	205410515	206484886	PARD3B	1074371	0.375773
chr2	206547223	206662857	NRP2	115634	0.457746
chr2	206858444	206950906	INO80D	92462	0.407865
chr2	206950355	206951576	BC047484	1221	0.518427
chr2	206980296	206981296	GCSHP3	1000	0.410000
chr2	206983254	206984146	AX747742	892	0.441704
chr2	206987802	207023918	NDUFS1	36116	0.402259
chr2	207024317	207027653	EEF1B2	3336	0.452038
chr2	207026604	207026674	SNORD51	70	0.357143
chr2	207026951	207027083	SNORA41	132	0.424242
chr2	207040041	207078352	GPR1	38311	0.427110
chr2	207068099	207128751	GPR1AS	60652	0.435155
chr2	207117170	207118497	AX748049	1327	0.480030
chr2	207139522	207179148	ZDBF2	39626	0.374325
chr2	207308367	207485854	ADAM23	177487	0.382496
chr2	207507141	207514173	LOC200726	7032	0.374858
chr2	207516344	207583120	DYTN	66776	0.384435
chr2	207602488	207630050	MDH1B	27562	0.405921
chr2	207630111	207660911	FASTKD2	30800	0.381786
chr2	207647957	207648032	MIR3130-1	75	0.546667
chr2	207647957	207648032	MIR3130-2	75	0.546667
chr2	207804277	207834198	CPO	29921	0.383710
chr2	207938861	207998861	KLF7	60000	0.408217
chr2	207974710	207974797	MIR2355	87	0.413793
chr2	208084387	208100789	BC038530	16402	0.435557
chr2	208394615	208470284	CREB1	75669	0.373984
chr2	208473838	208489973	METTL21A	16135	0.467679
chr2	208576263	208620896	CCNYL1	44633	0.414469
chr2	208627309	208634143	FZD5	6834	0.495757
chr2	208686011	208890284	PLEKHM3	204273	0.413373
chr2	208983852	209021486	LOC100507443	37634	0.428416
chr2	208986330	208989313	CRYGD	2983	0.383842
chr2	208992860	208994554	CRYGC	1694	0.423259
chr2	209007296	209010877	CRYGB	3581	0.479754
chr2	209030070	209054773	C2orf80	24703	0.415415
chr2	209100952	209119806	IDH1	18854	0.405643
chr2	209119956	209120918	IDH1-AS1	962	0.517672
chr2	209129351	209129374	JA429503	23	0.521739
chr2	209130990	209223475	PIKFYVE	92485	0.370839
chr2	209271554	209359231	PTH2R	87677	0.373211
chr2	210444402	210598834	MAP2	154432	0.355697
chr2	210636716	210864024	UNC80	227308	0.375746
chr2	210867288	210886984	RPE	19696	0.385205
chr2	210885434	211036051	KANSL1L	150617	0.363272
chr2	210895456	210929080	AK093026	33624	0.378985
chr2	211052715	211090215	ACADL	37500	0.364400
chr2	211097415	211098702	BC130595	1287	0.386169
chr2	211154867	211179895	MYL1	25028	0.345533
chr2	211295972	211341429	LANCL1	45457	0.380447
chr2	211421322	211543831	CPS1	122509	0.356480
chr2	211482294	211484599	CPS1-IT1	2305	0.343601
chr2	212240441	213403352	ERBB4	1162911	0.346837
chr2	213290986	213291084	MIR548F2	98	0.275510
chr2	213790980	213791060	MIR4776-2	80	0.537500
chr2	213790980	213791060	MIR4776-1	80	0.537500
chr2	213864410	214015058	IKZF2	150648	0.345693
chr2	214141276	214148929	LOC100130451	7653	0.387038
chr2	214149102	215275225	SPAG16	1126123	0.358893
chr2	215276460	215440653	VWC2L	164193	0.373914
chr2	215374905	215401613	VWC2L-IT1	26708	0.379137
chr2	215593274	215674428	BARD1	81154	0.365268
chr2	215796265	216003151	ABCA12	206886	0.371813
chr2	216176678	216214496	ATIC	37818	0.410492
chr2	216225178	216300791	FN1	75613	0.393914
chr2	216476285	216708259	LINC00607	231974	0.396402
chr2	216807313	216878346	MREG	71033	0.425394
chr2	216903110	216946539	PECR	43429	0.406894
chr2	216946588	216967506	TMEM169	20918	0.439526
chr2	216974019	217071016	XRCC5	96997	0.393342
chr2	217079049	217081397	AX747067	2348	0.381175
chr2	217081611	217084915	PKI55	3304	0.443099
chr2	217122584	217236750	MARCH4	114166	0.444432
chr2	217277472	217347774	SMARCAL1	70302	0.430571
chr2	217363519	217366188	RPL37A	2669	0.433496
chr2	217498126	217529158	IGFBP2	31032	0.501418
chr2	217536827	217560272	IGFBP5	23445	0.507614
chr2	217724181	217724782	TNP1	601	0.495840
chr2	217731054	217732536	BC031974	1482	0.442645
chr2	218148092	218148246	Pinc	154	0.461039
chr2	218148745	218621316	DIRC3	472571	0.423039
chr2	218664511	218808796	TNS1	144285	0.528766
chr2	218933737	218955304	RUFY4	21567	0.504521
chr2	218923877	218926013	CXCR2P1	2136	0.457865
chr2	218990735	219001976	CXCR2	11241	0.458589
chr2	219027567	219031716	CXCR1	4149	0.497951
chr2	219029390	219029414	HV303425	24	0.541667
chr2	219081816	219119071	ARPC2	37255	0.443189
chr2	219110548	219110641	TRNA	93	0.483871
chr2	219125737	219128582	GPBAR1	2845	0.613005
chr2	219128851	219134893	AAMP	6042	0.563886
chr2	219135114	219211516	PNKD	76402	0.513193
chr2	219138916	219157280	TMBIM1	18364	0.543727
chr2	219221578	219232817	C2orf62	11239	0.520509
chr2	219231387	219232558	BC038211	1171	0.575576
chr2	219246751	219261617	SLC11A1	14866	0.553410
chr2	219263060	219270664	CTDSP1	7604	0.633745
chr2	219267368	219267445	MIR26B	77	0.558442
chr2	219283837	219314248	VIL1	30411	0.517148
chr2	219314973	219433084	USP37	118111	0.396153
chr2	219433302	219461158	RQCD1	27856	0.410612
chr2	219472487	219501909	PLCD4	29422	0.473693
chr2	219472487	219483530	PLCD4	11043	0.483383
chr2	219502639	219524355	ZNF142	21716	0.495119
chr2	219524378	219528166	BCS1L	3788	0.527455
chr2	219528586	219536781	RNF25	8195	0.493350
chr2	219536748	219567440	STK36	30692	0.460478
chr2	219575567	219620138	TTLL4	44571	0.449597
chr2	219646471	219680016	CYP27A1	33545	0.437114
chr2	219684883	219687242	AX748340	2359	0.483680
chr2	219687105	219696512	PRKAG3	9407	0.523865
chr2	219724545	219738954	WNT6	14409	0.559234
chr2	219745254	219758651	WNT10A	13397	0.560573
chr2	219765535	219795358	BC038542	29823	0.432787
chr2	219824349	219826877	CDK5R2	2528	0.663370
chr2	219841005	219842644	LINC00608	1639	0.465528
chr2	219845808	219850379	FEV	4571	0.631809
chr2	219854911	219858127	CRYBA2	3216	0.579602
chr2	219866366	219866430	MIR375	64	0.671875
chr2	219866936	219880444	LOC100129175	13508	0.532055
chr2	219867567	219906273	CCDC108	38706	0.523356
chr2	219919141	219925238	IHH	6097	0.632934
chr2	219923409	219923472	MIR3131	63	0.634921
chr2	219940045	220025587	NHEJ1	85542	0.431192
chr2	220026180	220034817	SLC23A3	8637	0.504458
chr2	220036618	220041702	CNPPD1	5084	0.536979
chr2	220042938	220050197	FAM134A	7259	0.515085
chr2	220071505	220074373	ZFAND2B	2868	0.562064
chr2	220074487	220085174	ABCB6	10687	0.552260
chr2	220082846	220094361	ATG9A	11515	0.567000
chr2	220094478	220101391	ANKZF1	6913	0.491248
chr2	220101502	220110131	GLB1L	8629	0.495886
chr2	220110191	220115059	STK16	4868	0.530403
chr2	220115000	220118638	TUBA4A	3638	0.572567
chr2	220117964	220136910	TUBA4B	18946	0.496464
chr2	220144039	220151622	DNAJB2	7583	0.568377
chr2	220154344	220174295	PTPRN	19951	0.535712
chr2	220158832	220158922	MIR153-1	90	0.466667
chr2	220192130	220197899	RESP18	5769	0.504767
chr2	220238179	220252662	DNPEP	14483	0.500242
chr2	220283098	220291461	DES	8363	0.552792
chr2	220299699	220358354	SPEG	58655	0.575262
chr2	220363586	220371718	GMPPA	8132	0.543901
chr2	220378891	220403494	ASIC4	24603	0.569565
chr2	220403668	220408487	CHPF	4819	0.610915
chr2	220408744	220415317	TMEM198	6573	0.553172
chr2	220413794	220413869	MIR3132	75	0.613333
chr2	220415449	220436268	OBSL1	20819	0.581776
chr2	220436953	220440435	INHA	3482	0.544515
chr2	220462595	220481173	STK11IP	18578	0.533534
chr2	220492291	220506702	SLC4A3	14411	0.605718
chr2	220771222	220771286	MIR4268	64	0.531250
chr2	222282746	222437010	EPHA4	154264	0.399555
chr2	222437225	222439174	AX747413	1949	0.609543
chr2	223064605	223163715	PAX3	99110	0.397296
chr2	223162865	223169936	CCDC140	7071	0.540093
chr2	223162960	223162982	DD413687	22	0.636364
chr2	223185412	223186441	LOC440934	1029	0.455782
chr2	223289321	223423617	SGPP2	134296	0.416461
chr2	223363009	223363117	U6	108	0.388889
chr2	223436161	223520827	FARSB	84666	0.380365
chr2	223536456	223574649	MOGAT1	38193	0.411672
chr2	223725731	223808119	ACSL3	82388	0.395337
chr2	223916647	223920357	KCNE4	3710	0.480054
chr2	224461657	224467217	SCG2	5560	0.362770
chr2	224620046	224702319	AP1S3	82273	0.425522
chr2	224740064	224810052	WDFY1	69988	0.424830
chr2	224822120	224832431	MRPL44	10311	0.374454
chr2	224839764	224904036	SERPINE2	64272	0.432039
chr2	225243414	225266711	FAM124B	23297	0.441301
chr2	225334866	225450114	CUL3	115248	0.372328
chr2	225629806	225907330	DOCK10	277524	0.393865
chr2	225875177	225875257	MIR4439	80	0.425000
chr2	226265601	226518734	NYAP2	253133	0.380342
chr2	226628160	226628181	MIR548AR	21	0.285714
chr2	227007509	227044778	LOC646736	37269	0.365746
chr2	227523425	227523509	MIR5702	84	0.464286
chr2	227596032	227663506	IRS1	67474	0.404748
chr2	227700670	227863923	RHBDD1	163253	0.395160
chr2	227833704	227833838	SNORA48	134	0.507463
chr2	227867426	228029275	COL4A4	161849	0.410117
chr2	228029280	228179508	COL4A3	150228	0.398734
chr2	228085767	228189880	LOC654841	104113	0.403696
chr2	228110425	228189902	LOC654841	79477	0.402016
chr2	228192227	228222552	MFF	30325	0.359604
chr2	228226873	228244022	TM4SF20	17149	0.410986
chr2	228336847	228336903	MIR5703	56	0.642857
chr2	228336887	228425938	AGFG1	89051	0.370922
chr2	228474805	228498036	C2orf83	23231	0.431837
chr2	228549925	228582745	SLC19A3	32820	0.416301
chr2	228573100	228575446	AX746677	2346	0.437766
chr2	228678557	228682280	CCL20	3723	0.358850
chr2	228736326	228789026	DAW1	52700	0.392163
chr2	228844669	229046361	SPHKAP	201692	0.381825
chr2	229888688	230136057	PID1	247369	0.392220
chr2	230222344	230579286	DNER	356942	0.410378
chr2	230470953	230471015	U7	62	0.467742
chr2	230631929	230786655	TRIP12	154726	0.380175
chr2	230787206	230877825	FBXO36	90619	0.437601
chr2	230899689	230933715	SLC16A14	34026	0.428555
chr2	231033644	231084827	SP110	51183	0.420511
chr2	231090444	231177930	SP140	87486	0.408077
chr2	231191893	231268445	SP140L	76552	0.387305
chr2	231280870	231410317	SP100	129447	0.391859
chr2	231555635	231565244	LOC151475	9609	0.449995
chr2	231577556	231685790	CAB39	108234	0.407811
chr2	231616855	231616962	U6	107	0.429907
chr2	231729620	231743963	ITM2C	14343	0.581887
chr2	231751260	231769232	LOC151484	17972	0.510739
chr2	231772042	231789941	GPR55	17899	0.458461
chr2	231849082	231860747	LOC348761	11665	0.532962
chr2	231860838	231871999	SPATA3	11161	0.487322
chr2	231902280	231914427	C2orf72	12147	0.486211
chr2	231905971	231914427	C2orf72	8456	0.463103
chr2	231921577	232037540	PSMD1	115963	0.378750
chr2	231972949	231989824	HTR2B	16875	0.349333
chr2	231998175	231998344	U1	169	0.449704
chr2	232063293	232238606	ARMC9	175313	0.457120
chr2	232227418	232227504	MIR4777	86	0.290698
chr2	232260334	232265875	B3GNT7	5541	0.629850
chr2	232319458	232329205	NCL	9747	0.432749
chr2	232320510	232320647	SNORA75	137	0.386861
chr2	232321154	232321234	SNORD20	80	0.337500
chr2	232325078	232325153	SNORD82	75	0.373333
chr2	232373136	232379050	LINC00471	5914	0.427798
chr2	232387870	232395182	NMUR1	7312	0.558671
chr2	232457574	232458994	C2orf57	1420	0.603521
chr2	232570398	232571710	BC069004	1312	0.599848
chr2	232573234	232578250	PTMA	5016	0.608254
chr2	232597146	232645974	PDE6D	48828	0.422278
chr2	232651161	232673434	COPS7B	22273	0.449109
chr2	232756951	232757008	MIR1471	57	0.649123
chr2	232786804	232791038	NPPC	4234	0.575815
chr2	232826292	233201908	DIS3L2	375616	0.422272
chr2	233243347	233247599	ALPP	4252	0.622060
chr2	233250459	233251754	ECEL1P2	1295	0.555212
chr2	233271551	233275424	ALPPL2	3873	0.629744
chr2	233320832	233324742	ALPI	3910	0.625575
chr2	233344536	233352532	ECEL1	7996	0.647574
chr2	233385172	233390425	PRSS56	5253	0.661336
chr2	233390869	233401375	CHRND	10506	0.559966
chr2	233404436	233411113	CHRNG	6677	0.584095
chr2	233412778	233415283	TIGD1	2505	0.440719
chr2	233415356	233433920	EIF4E2	18564	0.440584
chr2	233498206	233547491	EFHD1	49285	0.493964
chr2	233562014	233725289	GIGYF2	163275	0.394371
chr2	233593257	233595607	AX748196	2350	0.468085
chr2	233630511	233641275	KCNJ13	10764	0.356187
chr2	233734993	233741107	C2orf82	6114	0.609748
chr2	233743395	233877951	NGEF	134556	0.483776
chr2	233897381	233899767	NEU2	2386	0.568315
chr2	233925035	234116549	INPP5D	191514	0.360574
chr2	234160216	234204320	ATG16L1	44104	0.443996
chr2	234184371	234184649	SCARNA5	278	0.471223
chr2	234197321	234197587	SCARNA6	266	0.530075
chr2	234216308	234255701	SAG	39393	0.487269
chr2	234263152	234380743	DGKD	117591	0.477605
chr2	234384164	234474236	USP40	90072	0.387201
chr2	234627437	234681951	UGT1A4	54514	0.438071
chr2	234651395	234652661	DNAJB3	1266	0.492101
chr2	234662961	234663991	LOC100286922	1030	0.516505
chr2	234684369	234688428	DQ655968	4059	0.467357
chr2	234737200	234742064	HEATR7B1	4864	0.558388
chr2	234745485	234763212	HJURP	17727	0.483274
chr2	234774089	234777055	MSL3P1	2966	0.471679
chr2	234826042	234928166	TRPM8	102124	0.434971
chr2	234959345	234985776	SPP2	26431	0.417124
chr2	235361542	235363353	AX748264	1811	0.426836
chr2	235401685	235405693	ARL4C	4008	0.501747
chr2	235791851	235797446	AF279775	5595	0.446649
chr2	235860627	235964358	SH3BP4	103731	0.507640
chr2	235904746	235905261	BC148242	515	0.497087
chr2	236402732	237040444	AGAP1	637712	0.473287
chr2	236916211	236918761	AK000798	2550	0.429412
chr2	236945291	236945327	DQ587855	36	0.638889
chr2	236945893	236945955	U7	62	0.467742
chr2	237074306	237076652	GBX2	2346	0.631287
chr2	237103514	237172988	ASB18	69474	0.459913
chr2	237232789	237412340	IQCA1	179551	0.426614
chr2	237478379	237490994	CXCR7	12615	0.495363
chr2	237968076	237994460	AK056246	26384	0.448871
chr2	237994083	238007489	COPS8	13406	0.393481
chr2	238232654	238322850	COL6A3	90196	0.445463
chr2	238395877	238463961	MLPH	68084	0.513322
chr2	238475216	238475818	PRLH	602	0.652824
chr2	238482964	238499769	RAB17	16805	0.519905
chr2	238600806	238674558	LRRFIP1	73752	0.459364
chr2	238707387	238751451	RBM44	44064	0.371800
chr2	238768186	238820755	RAMP1	52569	0.522684
chr2	238969564	239008054	SCLY	38490	0.462198
chr2	238877434	238951423	UBE2F	73989	0.443661
chr2	239008950	239041928	ESPNL	32978	0.583874
chr2	239047362	239061547	KLHL30	14185	0.623053
chr2	239072632	239077515	FAM132B	4883	0.595126
chr2	239079042	239112324	ILKAP	33282	0.448050
chr2	239133753	239140318	LOC151174	6565	0.545164
chr2	239140326	239142985	LOC643387	2659	0.445280
chr2	239146907	239148681	HES6	1774	0.697858
chr2	239152678	239197207	PER2	44529	0.517416
chr2	239229184	239309541	TRAF3IP1	80357	0.444591
chr2	239335625	239360891	ASB1	25266	0.470870
chr2	239359012	239360880	AF055024	1868	0.497859
chr2	239419330	239464140	LOC151171	44810	0.491631
chr2	239711520	239711607	U4	87	0.390805
chr2	239756672	239832237	TWIST2	75565	0.295706
chr2	239840997	239847965	FLJ43879	6968	0.523823
chr2	239969863	240322643	HDAC4	352780	0.512898
chr2	239990512	239990610	MIR4440	98	0.581633
chr2	240007522	240007622	MIR4441	100	0.510000
chr2	240115026	240117153	MGC16025	2127	0.550071
chr2	240227156	240227240	MIR4269	84	0.619048
chr2	240273418	240273499	MIR2467	81	0.604938
chr2	240499994	240507788	BC132948	7794	0.521812
chr2	240684553	240722356	LOC150935	37803	0.486496
chr2	240882431	240882511	MIR4786	80	0.600000
chr2	240896788	240964819	NDUFA10	68031	0.454984
chr2	240968907	240969846	OR6B2	939	0.559105
chr2	240981229	240982399	PRR21	1170	0.600855
chr2	240984493	240985489	OR6B3	996	0.559237
chr2	241065979	241075764	MYEOV2	9785	0.540623
chr2	241078445	241080073	OTOS	1628	0.596437
chr2	241375114	241407495	GPC1	32381	0.646212
chr2	241388835	241396117	PP14571	7282	0.657924
chr2	241395417	241395506	MIR149	89	0.719101
chr2	241418838	241497405	ANKMY1	78567	0.481614
chr2	241499470	241503431	DUSP28	3961	0.533451
chr2	241508003	241518149	RNPEPL1	10146	0.653952
chr2	241526132	241538526	CAPN10	12394	0.596740
chr2	241564661	241570676	GPR35	6015	0.619950
chr2	241615834	241622317	AQP12B	6483	0.628259
chr2	241631261	241637900	AQP12A	6639	0.625546
chr2	241653180	241759725	KIF1A	106545	0.586081
chr2	241808161	241818536	AGXT	10375	0.633349
chr2	241825464	241835573	C2orf54	10109	0.625977
chr2	241894035	241906868	LOC200772	12833	0.629471
chr2	241920931	241925489	AK055890	4558	0.605529
chr2	241938254	242033643	SNED1	95389	0.508308
chr2	242034544	242039910	MTERFD2	5366	0.431047
chr2	242045513	242088919	PASK	43406	0.507372
chr2	242089901	242122439	PPP1R7	32538	0.478394
chr2	242127923	242164791	ANO7	36868	0.581290
chr2	242166681	242212246	HDLBP	45565	0.498584
chr2	242198934	242201083	DKFZp686L08115	2149	0.449977
chr2	242254722	242293441	SEPT2	38719	0.417082
chr2	242295663	242434256	FARP2	138593	0.455968
chr2	242381568	242384661	AK055601	3093	0.463628
chr2	242434121	242448110	STK25	13989	0.594753
chr2	242483800	242498558	BOK-AS1	14758	0.523716
chr2	242498145	242513553	BOK	15408	0.616693
chr2	242523819	242576725	THAP4	52906	0.497600
chr2	242577026	242613271	ATG4B	36245	0.521037
chr2	242615156	242626383	DTYMK	11227	0.511267
chr2	242615158	242617529	AK126180	2371	0.598482
chr2	242641455	242668896	ING5	27441	0.518749
chr2	242674029	242708231	D2HGDH	34202	0.568622
chr2	242716239	242743702	GAL3ST2	27463	0.492481
chr2	242749406	242751722	PABL	2316	0.584197
chr2	242750159	242758739	NEU4	8580	0.656527
chr2	242792032	242801058	PDCD1	9026	0.631398
chr2	242811885	242815482	CXXC11	3597	0.651376
chr2	242912833	242919427	AK097934	6594	0.511526
chr2	242945877	242948160	BC101234	2283	0.496715
chr2	243030843	243102469	LOC728323	71626	0.391045
chr20	68350	77296	DEFB125	8946	0.375810
chr20	123251	126392	DEFB126	3141	0.346705
chr20	138110	139804	DEFB127	1694	0.398465
chr20	168526	170264	DEFB128	1738	0.409666
chr20	207898	210527	DEFB129	2629	0.399391
chr20	238376	241736	DEFB132	3360	0.429167
chr20	251503	271419	C20orf96	19916	0.483832
chr20	278203	280963	ZCCHC3	2760	0.556522
chr20	306214	310872	SOX12	4658	0.621511
chr20	327369	335512	NRSN2	8143	0.540096
chr20	361307	378203	TRIB3	16896	0.516927
chr20	388708	411610	RBCK1	22902	0.506506
chr20	416123	443187	TBC1D20	27064	0.463716
chr20	463337	524482	CSNK2A1	61145	0.408995
chr20	584636	590910	TCF15	6274	0.564393
chr20	627267	634014	SRXN1	6747	0.528828
chr20	642239	656823	SCRT2	14584	0.567060
chr20	740723	749228	SLC52A3	8505	0.525220
chr20	814355	826922	FAM110A	12567	0.540622
chr20	853296	896960	ANGPT4	43664	0.506527
chr20	939095	982907	RSPO4	43812	0.508536
chr20	1099239	1148426	PSMF1	49187	0.423872
chr20	1161214	1165117	TMEM74B	3903	0.520625
chr20	1184097	1188918	C20orf202	4821	0.475835
chr20	1206763	1235145	RAD21L1	28382	0.368156
chr20	1246959	1289971	SNPH	43012	0.504696
chr20	1290554	1306513	SDCBP2	15959	0.502726
chr20	1305986	1359379	SDCBP2-AS1	53393	0.440039
chr20	1349620	1373816	FKBP1A	24196	0.454703
chr20	1422806	1448337	NSFL1C	25531	0.450629
chr20	1455235	1472233	SIRPB2	16998	0.433463
chr20	1514896	1538343	SIRPD	23447	0.399411
chr20	1545028	1600689	SIRPB1	55661	0.441692
chr20	1609797	1638425	SIRPG	28628	0.437264
chr20	1611582	1629118	AK093519	17536	0.448905
chr20	1754010	1760392	LOC100289473	6382	0.469602
chr20	1875424	1920540	SIRPA	45116	0.510395
chr20	1927891	1988163	AK090681	60272	0.465390
chr20	1959401	1974394	PDYN	14993	0.485960
chr20	2082527	2129198	STK35	46671	0.479848
chr20	2276612	2321725	TGM3	45113	0.479175
chr20	2361553	2413399	TGM6	51846	0.451877
chr20	2442280	2451499	SNRPB	9219	0.461981
chr20	2443597	2443693	SNORD119	96	0.406250
chr20	2454888	2455853	AK126717	965	0.355440
chr20	2462466	2489778	ZNF343	27312	0.435413
chr20	2517252	2622430	TMC2	105178	0.428226
chr20	2633177	2639039	NOP56	5862	0.531389
chr20	2633422	2633488	MIR1292	66	0.712121
chr20	2634857	2634932	SNORD110	75	0.453333
chr20	2635712	2635844	SNORA51	132	0.507576
chr20	2639040	2644865	IDH3B	5825	0.513820
chr20	2673523	2740754	EBF4	67231	0.492184
chr20	2774714	2781292	CPXM1	6578	0.597446
chr20	2795656	2796476	C20orf141	820	0.610976
chr20	2796975	2797804	TMEM239	829	0.640531
chr20	2815960	2821348	PCED1A	5388	0.567558
chr20	2821372	2847378	VPS16	26006	0.487734
chr20	2903852	3019315	PTPRA	115463	0.432563
chr20	3024267	3026391	GNRH2	2124	0.577684
chr20	3026674	3028896	MRPS26	2222	0.605311
chr20	3052265	3053162	OXT	897	0.720178
chr20	3063201	3065370	AVP	2169	0.679576
chr20	3087556	3131513	UBOX5-AS1	43957	0.476511
chr20	3088218	3140556	UBOX5	52338	0.469926
chr20	3127164	3140556	FASTKD5	13392	0.445565
chr20	3143272	3149207	LZTS3	5935	0.625611
chr20	3171011	3185295	DDRGK1	14284	0.543265
chr20	3190005	3204516	ITPA	14511	0.507684
chr20	3208062	3218835	SLC4A11	10773	0.602710
chr20	3229947	3388309	C20orf194	158362	0.437971
chr20	3340682	3340789	U6	107	0.439252
chr20	3451664	3631769	ATRN	180105	0.403454
chr20	3639938	3644046	GFRA4	4108	0.627313
chr20	3648619	3662738	ADAM33	14119	0.609958
chr20	3650541	3651272	AX748440	731	0.601915
chr20	3667616	3687775	SIGLEC1	20159	0.562478
chr20	3713316	3733758	HSPA12B	20442	0.562861
chr20	3734145	3748452	C20orf27	14307	0.558678
chr20	3758150	3762102	SPEF1	3952	0.575152
chr20	3764497	3767337	CENPB	2840	0.661972
chr20	3776400	3786761	CDC25B	10361	0.578902
chr20	3789140	3793081	BC042140	3941	0.487440
chr20	3801170	3805954	AP5S1	4784	0.522157
chr20	3827445	3856770	MAVS	29325	0.525217
chr20	3867915	3869231	BC012193	1316	0.488602
chr20	3869231	3869724	BC012193	493	0.632860
chr20	3869741	3904502	PANK2	34761	0.436783
chr20	3898140	3898218	MIR103A2	78	0.448718
chr20	3898148	3898210	MIR103B2	62	0.467742
chr20	3912068	3996216	RNF24	84148	0.401400
chr20	4100588	4124836	BC027448	24248	0.441645
chr20	4129425	4168394	SMOX	38969	0.534989
chr20	4173736	4176600	LOC728228	2864	0.467528
chr20	4201277	4229659	ADRA1D	28382	0.515256
chr20	4409710	4412358	BC039673	2648	0.444109
chr20	4666796	4682234	PRNP	15438	0.419873
chr20	4667156	4682234	PRNP	15078	0.413981
chr20	4702555	4709106	PRND	6551	0.463593
chr20	4711927	4721314	PRNT	9387	0.432620
chr20	4760668	4795769	RASSF2	35101	0.484773
chr20	4833001	4990939	SLC23A2	157938	0.449322
chr20	4849629	4849764	SNORA31	135	0.496296
chr20	5080483	5093733	TMEM230	13250	0.430491
chr20	5095598	5100647	PCNA	5049	0.425035
chr20	5100231	5100615	PCNA-AS1	384	0.614583
chr20	5107406	5178533	CDS2	71127	0.448367
chr20	5282685	5295023	PROKR2	12338	0.439780
chr20	5296221	5298369	AX746654	2148	0.613594
chr20	5412602	5426394	LINC00658	13792	0.411615
chr20	5451841	5457780	LOC643406	5939	0.505472
chr20	5479217	5485242	LINC00654	6025	0.507718
chr20	5525079	5591672	GPCPD1	66593	0.392384
chr20	5731042	5844559	C20orf196	113517	0.433477
chr20	5891973	5906005	CHGB	14032	0.430373
chr20	5918485	5931173	TRMT6	12688	0.428358
chr20	5931297	5975831	MCM8	44534	0.392015
chr20	5986738	6020697	CRLS1	33959	0.393681
chr20	6021191	6034726	LRRN4	13535	0.510750
chr20	6055491	6104191	FERMT1	48700	0.427187
chr20	6748744	6760910	BMP2	12166	0.425448
chr20	7328113	7349146	BC043288	21033	0.388104
chr20	7863630	7921093	HAO1	57463	0.378887
chr20	7961715	8000393	TMX4	38678	0.377036
chr20	8000548	8008603	AK097836	8055	0.375791
chr20	8112911	8865547	PLCB1	752636	0.380121
chr20	9288446	9461462	PLCB4	173016	0.397940
chr20	9495004	9511171	LAMP5	16167	0.427723
chr20	9518036	9819687	PAK7	301651	0.393345
chr20	9748763	9751753	AX747070	2990	0.405017
chr20	10004459	10200154	SNAP25-AS1	195695	0.398079
chr20	10015696	10037407	ANKEF1	21711	0.372438
chr20	10199476	10288066	SNAP25	88590	0.408895
chr20	10385427	10414887	MKKS	29460	0.384827
chr20	10415950	10604027	SLX4IP	188077	0.402734
chr20	10618331	10654694	JAG1	36363	0.474933
chr20	11036256	11036493	7SK	237	0.434599
chr20	11247306	11254031	LOC339593	6725	0.433160
chr20	11898564	11907243	BTBD3	8679	0.384952
chr20	12989626	13147411	SPTLC3	157785	0.399328
chr20	13200349	13200970	AY927515	621	0.557166
chr20	13202417	13281297	ISM1	78880	0.439604
chr20	13218066	13220334	ISM1-AS1	2268	0.426367
chr20	13370035	13619583	TASP1	249548	0.373159
chr20	13694968	13765579	ESF1	70611	0.379912
chr20	13765671	13799067	NDUFAF5	33396	0.398641
chr20	13830043	13971265	SEL1L2	141222	0.403464
chr20	13953961	13954070	U6	109	0.385321
chr20	13976145	16033841	MACROD2	2057696	0.379372
chr20	14304638	14318313	FLRT3	13675	0.347715
chr20	14885586	14910161	MACROD2-AS1	24575	0.396134
chr20	15002198	15002305	U6	107	0.401869
chr20	15872978	15903959	AK125594	30981	0.404151
chr20	16347487	16554079	KIF16B	206592	0.408515
chr20	16710608	16722417	SNRPB2	11809	0.383436
chr20	16729002	16732809	OTOR	3807	0.353297
chr20	17207596	17465222	PCSK2	257626	0.413856
chr20	17474549	17512013	BFSP1	37464	0.470505
chr20	17550598	17588652	DSTN	38054	0.393914
chr20	17556850	17557155	7SK	305	0.485246
chr20	17594322	17662928	RRBP1	68606	0.525071
chr20	17674319	17716517	BANF2	42198	0.478743
chr20	17922243	17949154	SNX5	26911	0.416447
chr20	17943352	17943589	SNORD17	237	0.497890
chr20	17948332	17949436	AK296947	1104	0.603261
chr20	17949761	17971762	MGME1	22001	0.426253
chr20	17993520	17993546	JB175279	26	0.346154
chr20	18004795	18038521	OVOL2	33726	0.489118
chr20	18118498	18123812	PET117	5314	0.452014
chr20	18122867	18169031	CSRP2BP	46164	0.420544
chr20	18269120	18297640	ZNF133	28520	0.402875
chr20	18303195	18339944	BC043266	36749	0.380337
chr20	18359692	18362127	LINC00851	2435	0.464887
chr20	18364010	18447829	DZANK1	83819	0.417077
chr20	18448032	18465286	POLR3F	17254	0.403617
chr20	18451258	18451335	MIR3192	77	0.480519
chr20	18467187	18477887	RBBP9	10700	0.416916
chr20	18488187	18542059	SEC23B	53872	0.429630
chr20	18548072	18550203	LINC00493	2131	0.434538
chr20	18548072	18550203	LINC00493	2131	0.434538
chr20	18568555	18744560	DTD1	176005	0.431073
chr20	18768614	18775228	LINC00652	6614	0.424252
chr20	18774692	18776709	LOC100270804	2017	0.439266
chr20	18790371	18810839	C20orf78	20468	0.461403
chr20	18794369	18795035	SCP2D1	666	0.463964
chr20	19193289	19703541	SLC24A3	510252	0.438779
chr20	19222945	19265240	LOC100130264	42295	0.444544
chr20	19780217	19790937	BC090059	10720	0.452612
chr20	19789171	19789201	DQ594620	30	0.433333
chr20	19789762	19789790	DQ573663	28	0.535714
chr20	19867164	19983103	RIN2	115939	0.454023
chr20	19997933	20014273	NAA20	16340	0.408262
chr20	20015011	20036690	CRNKL1	21679	0.390793
chr20	20033157	20341346	C20orf26	308189	0.413328
chr20	20348764	20351592	INSM1	2828	0.631542
chr20	20370271	20693266	RALGAPA2	322995	0.404350
chr20	21106623	21227258	PLK1S1	120635	0.411721
chr20	21134666	21198927	BC042893	64261	0.403091
chr20	21175043	21198927	BC034426	23884	0.400100
chr20	21283941	21370463	XRN2	86522	0.372217
chr20	21376004	21378047	NKX2-4	2043	0.676946
chr20	21491659	21494664	NKX2-2	3005	0.583694
chr20	21686296	21699124	PAX1	12828	0.509822
chr20	22034727	22055292	LOC100270679	20565	0.415317
chr20	22255045	22263124	CR627206	8079	0.374675
chr20	22380970	22401281	LOC284788	20311	0.399094
chr20	22541191	22559280	LINC00261	18089	0.456410
chr20	22561641	22565101	FOXA2	3460	0.595954
chr20	22656709	22665514	AK055550	8805	0.454174
chr20	22989741	23011422	BC045663	21681	0.449703
chr20	23016056	23017314	SSTR4	1258	0.665342
chr20	23026269	23030301	THBD	4032	0.547123
chr20	23059992	23066977	CD93	6985	0.514388
chr20	23105704	23113273	LINC00656	7569	0.529264
chr20	23168597	23170942	AX747171	2345	0.507889
chr20	23331372	23335408	NXT1	4036	0.489098
chr20	23344999	23353683	GZF1	8684	0.428374
chr20	23355155	23402156	NAPB	47001	0.407247
chr20	23420321	23425567	CSTL1	5246	0.489135
chr20	23431040	23433482	CST11	2442	0.481572
chr20	23471765	23476655	CST8	4890	0.450102
chr20	23499782	23522655	CST13P	22873	0.425218
chr20	23545369	23549386	CST9L	4017	0.500871
chr20	23583046	23586610	CST9	3564	0.501122
chr20	23614293	23618574	CST3	4281	0.571128
chr20	23666276	23669662	CST4	3386	0.563497
chr20	23728189	23731574	CST1	3385	0.564550
chr20	23804403	23807312	CST2	2909	0.565143
chr20	23856571	23860380	CST5	3809	0.544237
chr20	23965689	23969416	GGTLC1	3727	0.580091
chr20	23969722	23969753	DQ583395	31	0.548387
chr20	24180402	24205224	FLJ33581	24822	0.439691
chr20	24449834	24647167	SYNDIG1	197333	0.461636
chr20	24929865	24940564	CST7	10699	0.564632
chr20	24943579	24973425	APMAP	29846	0.463915
chr20	24986865	25038818	ACSS1	51953	0.517814
chr20	25056071	25063015	VSX1	6944	0.492079
chr20	25121433	25129426	LOC284798	7993	0.487802
chr20	25165307	25177508	AX747658	12201	0.482665
chr20	25176338	25207360	ENTPD6	31022	0.507833
chr20	25228705	25278648	PYGB	49943	0.521655
chr20	25268550	25269403	BC128043	853	0.608441
chr20	25275378	25371618	ABHD12	96240	0.474241
chr20	25388322	25429191	GINS1	40869	0.413981
chr20	25433337	25566153	NINL	132816	0.490656
chr20	25593572	25604648	NANP	11076	0.434182
chr20	25604680	25658708	ZNF337	54028	0.411824
chr20	25654850	25677469	ZNF337	22619	0.426809
chr20	25825302	25834657	BX648489	9355	0.503367
chr20	25936452	25949924	BC052952	13472	0.390143
chr20	25990434	26002430	LOC100134868	11996	0.457486
chr20	26035249	26067553	FAM182A	32304	0.494799
chr20	26084051	26094677	NCOR1P1	10626	0.385470
chr20	26167654	26189869	LOC284801	22215	0.354130
chr20	26188821	26188914	MIR663A	93	0.763441
chr20	29624034	29653908	FRG1B	29874	0.400047
chr20	29637583	29638138	MLLT10P1	555	0.320721
chr20	29845466	29847435	DEFB115	1969	0.409853
chr20	29891014	29896388	DEFB116	5374	0.396539
chr20	29956420	29961705	DEFB118	5285	0.421570
chr20	29976770	29978452	DEFB119	1682	0.483948
chr20	29992647	30000641	DEFB121	7994	0.427320
chr20	30009241	30016983	DEFB122	7742	0.466804
chr20	30028410	30038060	DEFB123	9650	0.443420
chr20	30053308	30060816	DEFB124	7508	0.560336
chr20	30057268	30057864	BC016143	596	0.523490
chr20	30063104	30072708	REM1	9604	0.506352
chr20	30073580	30075377	LINC00028	1797	0.490818
chr20	30102240	30157370	HM13	55130	0.493506
chr20	30135184	30136019	PSIMCT-1	835	0.443114
chr20	30155509	30161066	HM13-AS1	5557	0.555516
chr20	30193085	30194317	ID1	1232	0.586039
chr20	30194988	30195043	MIR3193	55	0.563636
chr20	30225690	30232800	COX4I2	7110	0.524191
chr20	30252260	30310656	BCL2L1	58396	0.478303
chr20	30326903	30389603	TPX2	62700	0.415726
chr20	30407177	30422500	MYLK2	15323	0.543823
chr20	30432102	30433420	FOXS1	1318	0.641882
chr20	30448869	30458479	DUSP15	9610	0.554943
chr20	30458504	30530858	TTLL9	72354	0.459408
chr20	30489056	30489229	U1	173	0.491329
chr20	30532757	30539883	PDRG1	7126	0.499719
chr20	30555804	30586256	XKR7	30452	0.514285
chr20	30598244	30619984	CCM2L	21740	0.501656
chr20	30610177	30619984	CCM2L	9807	0.495768
chr20	30639990	30689657	HCK	49667	0.481104
chr20	30697308	30755061	TM9SF4	57753	0.474521
chr20	30776948	30778163	TSPY26P	1215	0.659259
chr20	30780306	30795546	PLAGL2	15240	0.484514
chr20	30795695	30826467	POFUT1	30772	0.476472
chr20	30865453	30922811	KIF3B	57358	0.438265
chr20	30946146	31027122	ASXL1	80976	0.421705
chr20	31030861	31172875	C20orf112	142014	0.543946
chr20	31175280	31196694	LOC149950	21414	0.534043
chr20	31219426	31239783	C20orf203	20357	0.517758
chr20	31290492	31331814	COMMD7	41322	0.482092
chr20	31350190	31397162	DNMT3B	46972	0.493996
chr20	31407698	31438211	MAPRE1	30513	0.444401
chr20	31571580	31592239	SUN5	20659	0.494167
chr20	31595383	31611515	BPIFB2	16132	0.550025
chr20	31619453	31631853	BPIFB6	12400	0.509677
chr20	31643229	31661434	BPIFB3	18205	0.530404
chr20	31669317	31699557	BPIFB4	30240	0.492626
chr20	31755959	31769223	BPIFA2	13264	0.451071
chr20	31781410	31798268	BPIFA4P	16858	0.449935
chr20	31805134	31815559	BPIFA3	10425	0.453141
chr20	31823801	31831115	BPIFA1	7314	0.493711
chr20	31870940	31897684	BPIFB1	26744	0.505646
chr20	31946644	31989375	CDK5RAP1	42731	0.443987
chr20	31995762	32031698	SNTA1	35936	0.504091
chr20	32077927	32237837	CBFA2T2	159910	0.423438
chr20	32244892	32262264	NECAB3	17372	0.595326
chr20	32250091	32251721	C20orf144	1630	0.628834
chr20	32254303	32256331	ACTL10	2028	0.664694
chr20	32263291	32274210	E2F1	10919	0.554996
chr20	32290549	32308136	PXMP4	17587	0.494286
chr20	32319807	32380075	ZNF341	60268	0.491339
chr20	32399109	32442173	CHMP4B	43064	0.464309
chr20	32581457	32670991	RALY	89534	0.454598
chr20	32636924	32636996	MIR4755	72	0.472222
chr20	32676114	32678564	EIF2S2	2450	0.440816
chr20	32676114	32700085	EIF2S2	23971	0.422052
chr20	32848170	32857148	ASIP	8978	0.459791
chr20	32868070	32891215	AHCY	23145	0.516742
chr20	32951040	33099198	ITCH	148158	0.405311
chr20	33054129	33054223	MIR644A	94	0.329787
chr20	33104203	33128762	DYNLRB1	24559	0.483326
chr20	33146500	33148149	MAP1LC3A	1649	0.689509
chr20	33148345	33265089	PIGU	116744	0.442755
chr20	33292147	33301237	TP53INP2	9090	0.551705
chr20	33302577	33413433	NCOA6	110856	0.417136
chr20	33421377	33422265	HMGB3P1	888	0.475225
chr20	33432522	33460661	GGT7	28139	0.490458
chr20	33464327	33515769	ACSS2	51442	0.447242
chr20	33516235	33543601	GSS	27366	0.462764
chr20	33543703	33590240	MYH7B	46537	0.538453
chr20	33578178	33578300	MIR499A	122	0.598361
chr20	33578202	33578275	MIR499B	73	0.506849
chr20	33590206	33680618	TRPC4AP	90412	0.429246
chr20	33703159	33735161	EDEM2	32002	0.458128
chr20	33704938	33705010	SNORD56	72	0.388889
chr20	33759773	33765165	PROCR	5392	0.526521
chr20	33814538	33864804	MMP24	50266	0.490948
chr20	33866708	33872619	EIF6	5911	0.516664
chr20	33873533	33880225	FAM83C	6692	0.580992
chr20	33890368	33999945	UQCC	109577	0.430209
chr20	34021148	34026027	GDF5	4879	0.549703
chr20	33969330	33969610	7SK	280	0.482143
chr20	34020826	34023250	GDF5OS	2424	0.556518
chr20	34043222	34099803	CEP250	56581	0.475548
chr20	34114798	34117481	C20orf173	2683	0.543794
chr20	34129777	34145405	ERGIC3	15628	0.508510
chr20	34146506	34152834	FER1L4	6328	0.560367
chr20	34151621	34173198	FER1L4	21577	0.475367
chr20	34179900	34190188	FER1L4	10288	0.511372
chr20	34203808	34208965	SPAG4	5157	0.594532
chr20	34213952	34252878	CPNE1	38926	0.431203
chr20	34231064	34231384	7SK	320	0.525000
chr20	34236846	34252878	RBM12	16032	0.397954
chr20	34256609	34287287	NFS1	30678	0.467240
chr20	34287231	34288902	ROMO1	1671	0.497307
chr20	34291530	34330258	RBM39	38728	0.401441
chr20	34359922	34538288	PHF20	178366	0.440712
chr20	34516491	34516597	U6	106	0.424528
chr20	34541538	34542548	SCAND1	1010	0.697030
chr20	34556528	34618622	CNBD2	62094	0.458321
chr20	34633539	34638882	LINC00657	5343	0.415310
chr20	34742661	34820721	EPB41L1	78060	0.498681
chr20	34738334	34743655	AX746683	5321	0.563240
chr20	34824338	34844863	AAR2	20525	0.450621
chr20	34995447	35157040	DLGAP4	161593	0.504310
chr20	35136104	35201678	BC039668	65574	0.495730
chr20	35169886	35178226	MYL9	8340	0.583693
chr20	35201875	35222355	TGIF2	20480	0.519824
chr20	35240923	35274619	SLA2	33696	0.504926
chr20	35280168	35374541	NDRG3	94373	0.445191
chr20	35380193	35402154	DSN1	21961	0.447839
chr20	35412177	35492087	SOGA1	79910	0.516644
chr20	35504569	35522632	TLDC2	18063	0.501799
chr20	35520226	35580246	SAMHD1	60020	0.437021
chr20	35626177	35724410	RBL1	98233	0.431902
chr20	35629595	35630032	FKSG51	437	0.505721
chr20	35729628	35807974	MROH8	78346	0.453195
chr20	35807455	35870025	RPN2	62570	0.442784
chr20	35879489	35885311	GHRH	5822	0.501718
chr20	35918050	35945663	MANBAL	27613	0.473581
chr20	35974556	36033821	SRC	59265	0.540251
chr20	36145818	36156083	BLCAP	10265	0.526254
chr20	36149606	36152090	NNAT	2484	0.541868
chr20	36247699	36251521	LINC00489	3822	0.470958
chr20	36305311	36311636	LOC100287792	6325	0.492964
chr20	36322433	36500520	CTNNBL1	178087	0.420233
chr20	36531498	36573747	VSTM2L	42249	0.540202
chr20	36611422	36661833	TTI1	50411	0.433100
chr20	36613295	36615884	AK123872	2589	0.441869
chr20	36661947	36720766	RPRD1B	58819	0.419031
chr20	36756863	36793700	TGM2	36837	0.528056
chr20	36769765	36769787	HV531022	22	0.590909
chr20	36770464	36770484	HV531009	20	0.500000
chr20	36770514	36770535	HV531016	21	0.476190
chr20	36776425	36776476	HV531005	51	0.470588
chr20	36779347	36779381	HV531011	34	0.411765
chr20	36784275	36784297	HV531029	22	0.545455
chr20	36784439	36784460	HV531015	21	0.523810
chr20	36789847	36789868	HV531014	21	0.523810
chr20	36838906	36889174	KIAA1755	50268	0.508335
chr20	36888576	36922294	BPI	33718	0.459576
chr20	36932551	36965905	BPI	33354	0.480872
chr20	36974813	37005653	LBP	30840	0.471920
chr20	37034659	37045444	AX746690	10785	0.483357
chr20	37049238	37063962	SNHG17	14724	0.512768
chr20	37053842	37053978	SNORA71B	136	0.514706
chr20	37055948	37056086	SNORA71A	138	0.536232
chr20	37058309	37058447	SNORA71C	138	0.579710
chr20	37062504	37062642	SNORA71D	138	0.536232
chr20	37075296	37079564	SNHG11	4268	0.528116
chr20	37101485	37207504	RALGAPB	106019	0.393618
chr20	37209837	37217104	ADIG	7267	0.504885
chr20	37230576	37279295	ARHGAP40	48719	0.484719
chr20	37353104	37358015	SLC32A1	4911	0.608634
chr20	37377096	37401089	ACTR5	23993	0.448631
chr20	37434347	37551667	PPP1R16B	117320	0.475205
chr20	37554954	37581703	FAM83D	26749	0.465326
chr20	37590980	37668366	DHX35	77386	0.413072
chr20	37734393	37734416	miR-449b-3P	23	0.565217
chr20	37842423	37853391	LOC339568	10968	0.415937
chr20	39045514	39045586	SNORD112	72	0.375000
chr20	39314516	39317876	MAFB	3360	0.566071
chr20	39634673	39654015	AK023614	19342	0.474873
chr20	39657461	39659162	TOP1	1701	0.570253
chr20	39657461	39753126	TOP1	95665	0.398557
chr20	39726968	39766640	BC035080	39672	0.430883
chr20	39766160	39804357	PLCG1	38197	0.531141
chr20	39807088	39928739	ZHX3	121651	0.407107
chr20	39969559	39989222	LPIN3	19663	0.551137
chr20	39988605	39995498	EMILIN3	6893	0.627448
chr20	40031169	40247133	CHD6	215964	0.411004
chr20	40313624	40313730	U6	106	0.386792
chr20	40701391	41818557	PTPRT	1117166	0.423413
chr20	41314122	41317202	BC040166	3080	0.443831
chr20	41691965	41692249	7SK	284	0.531690
chr20	41933194	41933319	SCARNA15	125	0.352000
chr20	42086503	42092244	SRSF6	5741	0.427626
chr20	42136319	42170535	L3MBTL1	34216	0.493979
chr20	42194736	42214273	SGK2	19537	0.492143
chr20	42219578	42275862	IFT52	56284	0.445189
chr20	42295708	42345122	MYBL2	49414	0.498442
chr20	42354800	42355642	GTSF1L	842	0.485748
chr20	42543491	42698254	TOX2	154763	0.475553
chr20	42740336	42816218	JPH2	75882	0.480048
chr20	42824580	42839546	OSER1	14966	0.407724
chr20	42839725	42854667	OSER1-AS1	14942	0.458172
chr20	42846121	42852332	BC036500	6211	0.464015
chr20	42875897	42909557	GDAP1L1	33660	0.502139
chr20	42935196	42939889	FITM2	4693	0.517366
chr20	42965797	42979432	R3HDML	13635	0.482655
chr20	42984440	43036115	HNF4A	51675	0.473672
chr20	43029895	43061485	HNF4A	31590	0.506299
chr20	43001506	43031509	BC071794	30003	0.470820
chr20	43006382	43024346	AF143870	17964	0.477455
chr20	43036759	43036843	MIR3646	84	0.380952
chr20	43090402	43093984	C20orf62	3582	0.466220
chr20	43104525	43123244	TTPAL	18719	0.465516
chr20	43124863	43150726	SERINC3	25863	0.425241
chr20	43160435	43247678	PKIG	87243	0.437892
chr20	43248162	43280376	ADA	32214	0.532098
chr20	43289218	43367608	LOC79015	78390	0.480202
chr20	43343884	43356452	WISP2	12568	0.515675
chr20	43374487	43380954	KCNK15	6467	0.546621
chr20	43380444	43438979	RIMS4	58535	0.495379
chr20	43514343	43537161	YWHAB	22818	0.403848
chr20	43538702	43567962	PABPC1L	29260	0.486910
chr20	43570770	43589114	TOMM34	18344	0.450829
chr20	43592439	43595099	STK4-AS1	2660	0.459023
chr20	43595119	43708593	STK4	113474	0.384564
chr20	43720949	43729753	KCNS1	8804	0.525329
chr20	43738092	43743813	WFDC5	5721	0.519140
chr20	43752066	43753106	WFDC12	1040	0.532692
chr20	43803539	43805185	PI3	1646	0.513366
chr20	43850009	43853099	SEMG2	3090	0.407120
chr20	43880878	43883206	SLPI	2328	0.513316
chr20	43922086	43936967	MATN4	14881	0.508030
chr20	43935490	43946464	RBPJL	10974	0.548205
chr20	43953928	43977064	SDC4	23136	0.499438
chr20	43991739	43997862	SYS1	6123	0.490609
chr20	44036628	44039250	DBNDD2	2622	0.486270
chr20	44002519	44006957	TP53TG5	4438	0.504957
chr20	44044706	44054885	PIGT	10179	0.485215
chr20	44098393	44110172	WFDC2	11779	0.467272
chr20	44141100	44144264	SPINT3	3164	0.429836
chr20	44164918	44176065	EPPIN-WFDC6	11147	0.445770
chr20	44179790	44207965	WFDC8	28175	0.405537
chr20	44236577	44259907	WFDC9	23330	0.393485
chr20	44258384	44259831	WFDC10A	1447	0.479613
chr20	44277201	44298878	WFDC11	21677	0.396503
chr20	44313289	44333658	WFDC10B	20369	0.415042
chr20	44330654	44337456	WFDC13	6802	0.439577
chr20	44350987	44354335	SPINT4	3348	0.426523
chr20	44402846	44420547	WFDC3	17701	0.473307
chr20	44407336	44407462	U6atac	126	0.476190
chr20	44420575	44440066	DNTTIP1	19491	0.460007
chr20	44441254	44445596	UBE2C	4342	0.512897
chr20	44451854	44455953	TNNC2	4099	0.558673
chr20	44462469	44471914	SNX21	9445	0.523981
chr20	44470359	44486048	ACOT8	15689	0.490598
chr20	44486219	44507769	ZSWIM3	21550	0.465476
chr20	44509847	44513905	ZSWIM1	4058	0.503943
chr20	44515129	44516238	SPATA25	1109	0.588819
chr20	44517110	44519926	NEURL2	2816	0.566051
chr20	44519590	44527458	CTSA	7868	0.548805
chr20	44527258	44541003	PLTP	13745	0.520917
chr20	44563316	44576662	PCIF1	13346	0.538064
chr20	44577291	44600833	ZNF335	23542	0.534746
chr20	44637546	44645200	MMP9	7654	0.569376
chr20	44650328	44688789	SLC12A5	38461	0.532903
chr20	44689625	44718580	NCOA5	28955	0.417683
chr20	44746905	44758384	CD40	11479	0.493945
chr20	44802371	44937137	CDH22	134766	0.511769
chr20	44978176	44993064	SLC35C2	14888	0.541241
chr20	44994689	45035271	ELMO2	40582	0.457912
chr20	45062279	45074923	AK054905	12644	0.440051
chr20	45085131	45086282	ZNF663	1151	0.417029
chr20	45092298	45093931	MKRN7P	1633	0.491733
chr20	45128268	45142198	ZNF334	13930	0.405599
chr20	45169669	45179213	OCSTAMP	9544	0.481664
chr20	45186461	45280100	SLC13A3	93639	0.457576
chr20	45313003	45318276	TP53RK	5273	0.446994
chr20	45338278	45364985	SLC2A10	26707	0.473659
chr20	45523262	45817492	EYA2	294230	0.454389
chr20	45795608	45795700	MIR3616	92	0.543478
chr20	45838380	45985474	ZMYND8	147094	0.461834
chr20	45947245	45949498	LOC100131496	2253	0.519308
chr20	45981304	45983376	BC047609	2072	0.457529
chr20	46130600	46285621	NCOA3	155021	0.411564
chr20	46286149	46414808	SULF2	128659	0.505662
chr20	46585042	46589679	BX648826	4637	0.529868
chr20	46988653	46999381	LINC00494	10728	0.479120
chr20	47240792	47444420	PREX1	203628	0.504621
chr20	47538274	47653230	ARFGEF2	114956	0.432496
chr20	47551777	47552227	FKSG56	450	0.520000
chr20	47662782	47713497	CSE1L	50715	0.413270
chr20	47729875	47804904	STAU1	75029	0.432046
chr20	47835831	47860614	DDX27	24783	0.490457
chr20	47862438	47894756	ZNFX1	32318	0.456371
chr20	47894714	47905795	ZFAS1	11081	0.455555
chr20	47895178	47905795	ZFAS1	10617	0.444758
chr20	47895481	47895560	SNORD12C	79	0.367089
chr20	47896849	47896952	SNORD12B	103	0.427184
chr20	47897219	47897309	SNORD12	90	0.477778
chr20	47980422	47983826	AK055386	3404	0.477380
chr20	47988504	48099183	KCNB1	110679	0.482124
chr20	48120410	48184707	PTGIS	64297	0.461794
chr20	48249482	48330421	B4GALT5	80939	0.423257
chr20	48429249	48508779	SLC9A8	79530	0.455589
chr20	48519928	48532080	SPATA2	12152	0.523371
chr20	48552913	48570422	RNF114	17509	0.465418
chr20	48599512	48605420	SNAI1	5908	0.552471
chr20	48657243	48658166	LINC00651	923	0.555796
chr20	48697660	48770335	TMEM189-UBE2V1	72675	0.484582
chr20	48807119	48809227	CEBPB	2108	0.673624
chr20	48884034	48895368	AK307192	11334	0.563879
chr20	48909256	48931456	LOC284751	22200	0.530270
chr20	49126890	49201086	PTPN1	74196	0.435751
chr20	49202322	49202416	MIR645	94	0.563830
chr20	49202646	49253426	FAM65C	50780	0.534974
chr20	49348080	49370278	PARD6B	22198	0.411749
chr20	49411466	49493714	BCAS4	82248	0.510298
chr20	49506882	49547527	ADNP	40645	0.413729
chr20	49551404	49575060	DPM1	23656	0.398208
chr20	49575350	49578399	MOCS3	3049	0.474582
chr20	49620192	49639675	KCNG1	19483	0.522250
chr20	50003493	50159258	NFATC2	155765	0.479402
chr20	50069441	50069514	MIR3194	73	0.698630
chr20	50213313	50384908	ATP9A	171595	0.466505
chr20	50400582	50419048	SALL4	18466	0.486191
chr20	50767816	50808524	ZFP64	40708	0.450403
chr20	51801821	52111869	TSHZ2	310048	0.426489
chr20	51714190	51714523	7SK	333	0.498498
chr20	52015466	52120860	AK056432	105394	0.429009
chr20	52183609	52199707	ZNF217	16098	0.432600
chr20	52491039	52492248	SUMO1P1	1209	0.389578
chr20	52560078	52687304	BCAS1	127226	0.405978
chr20	52684946	52685024	MIR4756	78	0.512821
chr20	52769987	52790516	CYP24A1	20529	0.433630
chr20	52824501	52836492	PFDN4	11991	0.407139
chr20	53092265	53267710	DOK5	175445	0.398974
chr20	53476226	53476351	U4atac	125	0.488000
chr20	54572412	54580528	CBLN4	8116	0.438393
chr20	54823787	54824871	MC3R	1084	0.566421
chr20	54933982	54943718	FAM210B	9736	0.494043
chr20	54944444	54967351	AURKA	22907	0.429214
chr20	54967426	54979582	CSTF1	12156	0.412553
chr20	54987313	55034396	CASS4	47083	0.453752
chr20	55043646	55093942	RTFDC1	50296	0.436575
chr20	55066547	55100981	GCNT7	34434	0.450195
chr20	55108301	55111574	FAM209B	3273	0.484876
chr20	55204357	55214338	TFAP2C	9981	0.489730
chr20	55743808	55841707	BMP7	97899	0.499903
chr20	55841852	55858053	BC037891	16201	0.499475
chr20	55896557	55896647	MIR4325	90	0.500000
chr20	55904830	55919049	SPO11	14219	0.367185
chr20	55913212	55998278	MIR5095	85066	0.499495
chr20	55926617	55953519	RAE1	26902	0.441380
chr20	55933495	55934878	MTRNR2L3	1383	0.404917
chr20	55966453	55984386	RBM38	17933	0.599788
chr20	56071020	56100183	CTCFL	29163	0.450262
chr20	56136136	56141513	PCK1	5377	0.482053
chr20	56178901	56195632	ZBP1	16731	0.526328
chr20	56223447	56285031	PMEPA1	61584	0.544914
chr20	56285238	56287808	AK056098	2570	0.539689
chr20	56470449	56470500	MIR4532	51	0.666667
chr20	56725982	56736183	C20orf85	10201	0.467993
chr20	56820838	56884495	PPP4R1L	63657	0.418933
chr20	56884770	56942563	RAB22A	57793	0.414497
chr20	56964174	57026156	VAPB	61982	0.428608
chr20	57034425	57089949	APCDD1L	55524	0.482422
chr20	57090434	57101088	APCDD1L-AS1	10654	0.490238
chr20	57226308	57254582	STX16	28274	0.410129
chr20	57267861	57291367	NPEPL1	23506	0.574449
chr20	57329405	57331891	BC007940	2486	0.494771
chr20	57392669	57392749	MIR296	80	0.600000
chr20	57393280	57393368	MIR298	88	0.534091
chr20	57393972	57425958	GNAS-AS1	31986	0.490277
chr20	57428035	57486250	GNAS	58215	0.460654
chr20	57414794	57486250	GNAS	71456	0.470821
chr20	57556262	57570188	NELFCD	13926	0.485710
chr20	57570241	57582309	CTSZ	12068	0.567783
chr20	57594308	57601709	TUBB1	7401	0.444264
chr20	57603732	57607422	ATP5E	3690	0.410840
chr20	57608199	57617901	SLMO2	9702	0.406617
chr20	57766074	57834167	ZNF831	68093	0.443526
chr20	57875498	57901047	EDN3	25549	0.492035
chr20	58179602	58422766	PHACTR3	243164	0.473931
chr20	58201518	58203344	LOC100506384	1826	0.488499
chr20	58438617	58507209	SYCP2	68592	0.328551
chr20	58515443	58523702	FAM217B	8259	0.386851
chr20	58511886	58515352	PPP1R3D	3466	0.504039
chr20	58533470	58588168	CDH26	54698	0.431789
chr20	58630979	58648008	C20orf197	17029	0.473486
chr20	58713547	59228978	LOC284757	515431	0.428183
chr20	59053168	59053239	MIR4533	71	0.591549
chr20	59827481	60515673	CDH4	688192	0.517963
chr20	60292561	60294804	AK097866	2243	0.539456
chr20	60528601	60528718	MIR1257	117	0.649573
chr20	60549853	60640866	TAF4	91013	0.526134
chr20	60697516	60710434	LSM14B	12918	0.541415
chr20	60711782	60718514	PSMA7	6732	0.523470
chr20	60718821	60757566	SS18L1	38745	0.550110
chr20	60758080	60777810	MTG2	19730	0.499189
chr20	60790016	60795323	HRH3	5307	0.661014
chr20	60807015	60811355	AK126744	4340	0.586175
chr20	60813579	60871269	OSBPL2	57690	0.519795
chr20	60878026	60883918	ADRM1	5892	0.630516
chr20	60884120	60942368	LAMA5	58248	0.619283
chr20	60907542	60907613	MIR4758	71	0.746479
chr20	60962120	60963576	RPS21	1456	0.594780
chr20	60963685	60982339	CABLES2	18654	0.596226
chr20	60985292	61002629	RBBP8NL	17337	0.637711
chr20	61038552	61051026	GATA5	12474	0.616562
chr20	61141753	61148768	C20orf166-AS1	7015	0.639772
chr20	61143422	61143882	C20orf166-AS1	460	0.647826
chr20	61147659	61167971	C20orf166	20312	0.616286
chr20	61151512	61151583	MIR1-1	71	0.366197
chr20	61273796	61303647	SLCO4A1	29851	0.602291
chr20	61294378	61297973	LOC100127888	3595	0.609736
chr20	61340188	61394123	NTSR1	53935	0.551683
chr20	61404868	61407369	AX747649	2501	0.583767
chr20	61405472	61408208	LINC00659	2736	0.595760
chr20	61427804	61431945	MRGBP	4141	0.606617
chr20	61431978	61436939	OGFR-AS1	4961	0.602903
chr20	61436176	61445352	OGFR	9176	0.634590
chr20	61448413	61472511	COL9A3	24098	0.615487
chr20	61472466	61493115	TCFL5	20649	0.488837
chr20	61476475	61477543	DPH3P1	1068	0.457865
chr20	61509089	61557903	DIDO1	48814	0.489900
chr20	61569440	61579827	GID8	10387	0.489843
chr20	61583998	61599949	SLC17A9	15951	0.619083
chr20	61637330	61638387	BHLHE23	1057	0.741722
chr20	61640734	61716423	LOC63930	75689	0.549829
chr20	61665568	61668380	LINC00029	2812	0.589972
chr20	61669362	61685215	LOC100144597	15853	0.527345
chr20	61726844	61733671	HAR1B	6827	0.568625
chr20	61732643	61735737	HAR1A	3094	0.638979
chr20	61809851	61809938	MIR124-3	87	0.540230
chr20	61826781	61847538	YTHDF1	20757	0.492942
chr20	61867275	61871854	BIRC7	4579	0.642717
chr20	61870130	61870194	MIR3196	64	0.750000
chr20	61872135	61885892	NKAIN4	13757	0.621502
chr20	61885329	61892967	FLJ16779	7638	0.619010
chr20	61904164	61921142	ARFGAP1	16978	0.597302
chr20	61918159	61918218	MIR4326	59	0.644068
chr20	61924537	61962285	COL20A1	37748	0.597727
chr20	61974661	61992748	CHRNA4	18087	0.647758
chr20	62023922	62026961	AK056267	3039	0.627509
chr20	62031566	62033370	KCNQ2	1804	0.626940
chr20	62037541	62103993	KCNQ2	66452	0.622013
chr20	62119364	62130668	EEF1A2	11304	0.634908
chr20	62152132	62153524	PPDPF	1392	0.709052
chr20	62159775	62168723	PTK6	8948	0.629079
chr20	62172162	62178857	SRMS	6695	0.642420
chr20	62184372	62188035	C20orf195	3663	0.656020
chr20	62189438	62205592	HELZ2	16154	0.660765
chr20	62218954	62258381	GMEB2	39427	0.534000
chr20	62271057	62284963	STMN3	13906	0.605997
chr20	62289162	62328544	RTEL1	39382	0.598370
chr20	62327130	62330051	TNFRSF6B	2921	0.651489
chr20	62329994	62339205	ARFRP1	9211	0.621322
chr20	62339379	62367538	ZGPAT	28159	0.491033
chr20	62367132	62370460	LIME1	3328	0.679087
chr20	62371210	62375403	SLC2A4RG	4193	0.669688
chr20	62375020	62436856	ZBTB46	61836	0.539572
chr20	62439441	62454360	BC002534	14919	0.538575
chr20	62492565	62494341	ABHD16B	1776	0.676802
chr20	62496580	62522898	TPD52L2	26318	0.543620
chr20	62526454	62567384	DNAJC5	40930	0.514293
chr20	62550777	62551006	MIR941-1	229	0.711790
chr20	62551084	62551313	MIR941-3	229	0.711790
chr20	62571181	62587800	UCKL1	16619	0.625609
chr20	62572817	62572897	MIR1914	80	0.712500
chr20	62573983	62574079	MIR647	96	0.666667
chr20	62584736	62588338	UCKL1-AS1	3602	0.618823
chr20	62588056	62601223	ZNF512B	13167	0.634389
chr20	62605465	62610995	SAMD10	5530	0.611031
chr20	62612430	62664453	PRPF6	52023	0.505565
chr20	62665696	62671315	LINC00176	5619	0.631607
chr20	62679078	62680979	SOX18	1901	0.721725
chr20	62694009	62703700	TCEA2	9691	0.631307
chr20	62704534	62711324	RGS19	6790	0.635052
chr20	62716368	62731996	OPRL1	15628	0.589839
chr20	62714732	62715712	C20orf201	980	0.752041
chr20	62737182	62738184	NPBWR2	1002	0.629741
chr20	62795826	62873606	MYT1	77780	0.543122
chr20	62887047	62907579	PCMTD2	20532	0.437366
chr20	62919982	62920072	DQ590432	90	0.577778
chr20	62921737	62934707	LINC00266-1	12970	0.412567
chr21	9690070	9690100	DQ579288	30	0.433333
chr21	9692177	9692207	DQ590589	30	0.566667
chr21	9711934	9769227	BC071797	57293	0.383625
chr21	9825459	9825481	JB074932	22	0.818182
chr21	9825831	9826011	MIR3648	180	0.838889
chr21	9826202	9826263	MIR3687	61	0.786885
chr21	9907188	9968593	TEKT4P2	61405	0.456266
chr21	9932314	9932344	DQ590126	30	0.433333
chr21	10203388	10203418	DQ579288	30	0.433333
chr21	10204661	10204701	DQ590589	40	0.575000
chr21	10450661	10597442	AK311573	146781	0.339785
chr21	10906742	10990920	TPTE	84178	0.389365
chr21	11057795	11098937	BAGE	41142	0.392397
chr21	14410486	14490571	ANKRD30BP2	80085	0.359780
chr21	14778704	14778781	MIR3156-3	77	0.428571
chr21	14982497	15013906	POTED	31409	0.364927
chr21	15022566	15022606	DQ590589	40	0.575000
chr21	15023205	15023235	DQ590589	30	0.566667
chr21	15023909	15023941	DQ591735	32	0.468750
chr21	15215453	15220685	C21orf15	5232	0.506498
chr21	15222896	15222924	DQ586768	28	0.500000
chr21	15278152	15278182	DQ579288	30	0.433333
chr21	15279172	15279210	DQ587539	38	0.578947
chr21	15280199	15280225	DQ579969	26	0.538462
chr21	15349067	15352765	ANKRD20A11P	3698	0.393997
chr21	15399741	15516860	BC024173	117119	0.429298
chr21	15481134	15579254	LIPI	98120	0.360059
chr21	15588465	15600693	RBM11	12228	0.356477
chr21	15646119	15673692	ABCC13	27573	0.370870
chr21	15743436	15755509	HSPA13	12073	0.361385
chr21	15857548	15955723	SAMSN1	98175	0.361711
chr21	15954522	15970624	SAMSN1-AS1	16102	0.346603
chr21	15964483	16015428	LOC388813	50945	0.370341
chr21	16333555	16437126	NRIP1	103571	0.362466
chr21	17102495	17252377	USP25	149882	0.353645
chr21	17442841	17982094	LINC00478	539253	0.352642
chr21	17657016	17657089	SNORD74	73	0.424658
chr21	17911408	17911489	MIR99A	81	0.530864
chr21	17912147	17912231	MIRLET7C	84	0.476190
chr21	17962556	17962645	MIR125B2	89	0.494382
chr21	17962572	17962594	DM119543	22	0.500000
chr21	18811207	18821503	C21orf37	10296	0.395688
chr21	18885223	18942429	CXADR	57206	0.409048
chr21	18965967	18985268	BTG3	19301	0.377442
chr21	19161283	19191703	C21orf91	30420	0.371631
chr21	19207988	19257925	CHODL-AS1	49937	0.386667
chr21	19618191	19639687	CHODL	21496	0.328015
chr21	19641432	19775970	TMPRSS15	134538	0.351588
chr21	19933582	20110343	BC028044	176761	0.350552
chr21	22114912	22175426	LINC00320	60514	0.357141
chr21	22370632	22912517	NCAM2	541885	0.340685
chr21	22657821	22658102	RNU6-67P	281	0.277580
chr21	23095612	23109639	LINC00317	14027	0.329935
chr21	23119304	23169735	BC035642	50431	0.354524
chr21	23381476	23470778	BC039377	89302	0.350966
chr21	23470935	23488847	LINC00308	17912	0.344964
chr21	23539507	23539984	Z49981	477	0.314465
chr21	23540287	23540734	Z49979	447	0.239374
chr21	24733425	24757156	D21S2088E	23731	0.352661
chr21	25801053	25862621	AK124194	61568	0.345066
chr21	26212863	26430056	LOC339622	217193	0.360836
chr21	26758132	26804013	LINC00158	45881	0.378871
chr21	26934456	26947480	MIR155HG	13024	0.374155
chr21	26955086	26955536	LINC00515	450	0.444444
chr21	26957967	26979801	MRPL39	21834	0.378996
chr21	27011593	27086885	JAM2	75292	0.396443
chr21	27096790	27107965	ATP5J	11175	0.423982
chr21	27107328	27144771	GABPA	37443	0.363432
chr21	27252860	27543138	APP	290278	0.396992
chr21	27538214	27539642	AK074469	1428	0.383754
chr21	27838527	27945581	CYYR1	107054	0.372812
chr21	28208605	28217728	ADAMTS1	9123	0.458073
chr21	28290230	28339439	ADAMTS5	49209	0.384564
chr21	28326279	28326362	MIR4759	83	0.313253
chr21	28731203	28820898	BC043580	89695	0.371961
chr21	29094697	29123552	LINC00113	28855	0.360700
chr21	29385681	29395528	LINC00314	9847	0.399513
chr21	29420732	29509928	AX747935	89196	0.356552
chr21	29488412	29600986	BC047600	112574	0.367030
chr21	29911639	29912677	LINC00161	1038	0.405588
chr21	30248385	30257695	N6AMT1	9310	0.364339
chr21	30300465	30365277	LTN1	64812	0.367401
chr21	30378079	30391685	RWDD2B	13606	0.457739
chr21	30396937	30426807	USP16	29870	0.387747
chr21	30428647	30446010	CCT8	17363	0.382250
chr21	30452872	30548202	MAP3K7CL	95330	0.403829
chr21	30552745	30552960	U3	215	0.520930
chr21	30565814	30660526	LINC00189	94712	0.390626
chr21	30671219	30718469	BACH1	47250	0.387746
chr21	30925865	31312282	GRIK1	386417	0.380889
chr21	30968359	31003067	GRIK1-AS2	34708	0.382131
chr21	31120493	31136325	GRIK1-AS1	15832	0.404181
chr21	31538240	31538971	CLDN17	731	0.515732
chr21	31581468	31584101	LINC00307	2633	0.362324
chr21	31586323	31588469	CLDN8	2146	0.376980
chr21	31653626	31655276	KRTAP24-1	1650	0.424848
chr21	31661462	31661832	KRTAP25-1	370	0.413514
chr21	31691449	31692607	KRTAP26-1	1158	0.482729
chr21	31709330	31710012	KRTAP27-1	682	0.473607
chr21	31720716	31720924	KRTAP23-1	208	0.567308
chr21	31743708	31744557	KRTAP13-2	849	0.500589
chr21	31747611	31747696	MIR4327	85	0.541176
chr21	31768391	31769138	KRTAP13-1	747	0.511379
chr21	31797710	31798230	KRTAP13-3	520	0.525000
chr21	31802593	31803076	KRTAP13-4	483	0.554865
chr21	31812645	31813098	KRTAP15-1	453	0.483444
chr21	31852363	31852636	KRTAP19-1	273	0.556777
chr21	31859508	31859667	KRTAP19-2	159	0.522013
chr21	31863781	31864275	KRTAP19-3	494	0.439271
chr21	31869173	31869428	KRTAP19-4	255	0.486275
chr21	31874189	31874408	KRTAP19-5	219	0.557078
chr21	31913853	31914181	KRTAP19-6	328	0.472561
chr21	31933416	31933608	KRTAP19-7	192	0.557292
chr21	31962423	31962716	KRTAP22-2	293	0.392491
chr21	31964758	31965374	KRTAP6-3	616	0.514610
chr21	31971004	31971193	KRTAP6-2	189	0.560847
chr21	31973439	31973586	KRTAP22-1	147	0.517007
chr21	31986004	31986223	KRTAP6-1	219	0.584475
chr21	31988773	31988944	KRTAP20-1	171	0.456140
chr21	31992945	31993169	KRTAP20-4	224	0.535714
chr21	32007582	32007780	KRTAP20-2	198	0.555556
chr21	32015182	32015455	KRTAP20-3	273	0.432234
chr21	32090842	32091095	KRTAP21-3	253	0.363636
chr21	32119268	32119520	KRTAP21-2	252	0.523810
chr21	32127456	32127696	KRTAP21-1	240	0.537500
chr21	32185014	32185570	KRTAP8-1	556	0.516187
chr21	32201357	32202051	KRTAP7-1	694	0.461095
chr21	32252963	32253874	KRTAP11-1	911	0.532382
chr21	32410477	32410795	KRTAP19-8	318	0.490566
chr21	32490735	32931290	TIAM1	440555	0.438022
chr21	32931557	32932601	BC014150	1044	0.603448
chr21	33026870	33031813	BC041449	4943	0.477847
chr21	33031934	33041243	SOD1	9309	0.445161
chr21	33043312	33104431	SCAF4	61119	0.381453
chr21	33245627	33376377	HUNK	130750	0.460344
chr21	33452793	33458608	LINC00159	5815	0.423904
chr21	33640529	33651376	MIS18A	10847	0.407209
chr21	33664123	33684599	MRAP	20476	0.464788
chr21	33678774	33681045	BC034802	2271	0.484808
chr21	33683329	33765312	URB1	81983	0.464060
chr21	33749495	33749631	SNORA80	136	0.558824
chr21	33765441	33766266	C21orf119	825	0.549091
chr21	33784751	33887697	EVA1C	102946	0.463991
chr21	33973983	33984918	C21orf59	10935	0.468679
chr21	34001068	34100351	SYNJ1	99283	0.380770
chr21	34100424	34115433	PAXBP1-AS1	15009	0.396096
chr21	34100424	34105224	PAXBP1-AS1	4800	0.441667
chr21	34106209	34144169	PAXBP1	37960	0.381481
chr21	34144410	34170016	C21orf49	25606	0.408381
chr21	34162983	34186053	C21orf62	23070	0.435457
chr21	34398215	34401503	OLIG2	3288	0.588808
chr21	34442449	34444728	OLIG1	2279	0.645897
chr21	34537775	34542541	C21orf54	4766	0.491397
chr21	34602230	34636820	IFNAR2	34590	0.440995
chr21	34637936	34638565	IL10RB-AS1	629	0.488076
chr21	34697213	34732128	IFNAR1	34915	0.410196
chr21	34775201	34809828	IFNGR2	34627	0.476824
chr21	34804792	34852316	TMEM50B	47524	0.433591
chr21	34821088	34852316	TMEM50B	31228	0.418919
chr21	34860237	34864023	DNAJC28	3786	0.450343
chr21	34876237	34914464	GART	38227	0.410129
chr21	34915349	34949812	SON	34463	0.386821
chr21	34949858	34961267	DONSON	11409	0.420458
chr21	34961647	35014160	CRYZL1	52513	0.407842
chr21	35014783	35261609	ITSN1	246826	0.423128
chr21	35269910	35272163	intersectin 1 long form	2253	0.428318
chr21	35303515	35343487	LINC00649	39972	0.425548
chr21	35445822	35478561	SLC5A3	32739	0.390788
chr21	35445822	35515334	MRPS6	69512	0.401254
chr21	35552977	35562220	LINC00310	9243	0.453965
chr21	35736322	35743440	KCNE2	7118	0.435375
chr21	35747748	35761452	SMIM11	13704	0.466068
chr21	35791012	35796264	BC049386	5252	0.416413
chr21	35818985	35828107	KCNE1	9122	0.480377
chr21	35888783	35987382	RCAN1	98599	0.442966
chr21	36041687	36090519	CLIC6	48832	0.457282
chr21	36096104	36109479	LINC00160	13375	0.439252
chr21	36118121	36157168	LOC100506385	39047	0.430609
chr21	36160097	36421595	RUNX1	261498	0.436099
chr21	36195760	36198703	AX746823	2943	0.426096
chr21	36231770	36231871	AX813477	101	0.534653
chr21	36410232	36411723	RUNX1-IT1	1491	0.480215
chr21	36744804	36953227	LOC100506403	208423	0.403933
chr21	37093012	37093106	MIR802	94	0.372340
chr21	37406838	37432819	SETD4	25981	0.448212
chr21	37441939	37498938	LOC100133286	56999	0.434639
chr21	37442284	37445462	CBR1	3178	0.501259
chr21	37504064	37528606	CBR3-AS1	24542	0.472863
chr21	37507262	37518860	CBR3	11598	0.486032
chr21	37536838	37666572	DOPEY2	129734	0.469723
chr21	37692486	37748944	MORC3	56458	0.418258
chr21	37757688	37789125	CHAF1B	31437	0.466648
chr21	37832919	37838739	CLDN14	5820	0.519072
chr21	38071990	38122510	SIM2	50520	0.507977
chr21	38123188	38353264	HLCS	230076	0.443014
chr21	38378449	38391958	RIPPLY3	13509	0.487971
chr21	38378862	38391958	RIPPLY3	13096	0.481597
chr21	38437663	38445103	PIGP	7440	0.396371
chr21	38445570	38575408	TTC3	129838	0.386951
chr21	38580803	38592989	DSCR9	12186	0.444937
chr21	38595725	38639833	DSCR3	44108	0.440396
chr21	38792600	38887679	DYRK1A	95079	0.377865
chr21	38792600	38845182	DYRK1A	52582	0.376878
chr21	38979765	38982665	AL109792	2900	0.393448
chr21	38996784	39288741	KCNJ6	291957	0.438661
chr21	39426312	39493454	DSCR4	67142	0.405067
chr21	39493544	39528605	DSCR8	35061	0.401843
chr21	39578249	39580738	DSCR10	2489	0.534753
chr21	39644341	39673746	KCNJ15	29405	0.408502
chr21	39645397	39647443	AK027145	2046	0.417889
chr21	39751949	39870428	ERG	118479	0.423518
chr21	40110878	40145401	LINC00114	34523	0.438780
chr21	40177230	40196878	ETS2	19648	0.460454
chr21	40266708	40266791	SNORA62	83	0.433735
chr21	40547371	40555440	PSMG1	8069	0.407981
chr21	40557403	40685712	BRWD1	128309	0.382085
chr21	40685860	40686888	BRWD1-IT2	1028	0.592412
chr21	40687632	40695144	BRWD1-AS1	7512	0.455272
chr21	40714240	40721047	HMGN1	6807	0.402380
chr21	40752212	40769815	WRB	17603	0.482986
chr21	40777769	40816128	LCA5L	38359	0.407936
chr21	40823779	40887433	SH3BGR	63654	0.403352
chr21	41029253	41034815	B3GALT5	5562	0.478425
chr21	40969074	40984749	C21orf88	15675	0.486826
chr21	41117333	41174023	IGSF5	56690	0.424907
chr21	41239346	41301322	PCP4	61976	0.435749
chr21	41384342	42219039	DSCAM	834697	0.409211
chr21	41584278	41584358	MIR4760	80	0.337500
chr21	41755009	41757285	DSCAM-AS1	2276	0.428383
chr21	41990432	42002693	DSCAM-IT1	12261	0.386836
chr21	42513426	42519991	LINC00323	6565	0.492765
chr21	42539483	42539556	MIR3197	73	0.726027
chr21	42539727	42648524	BACE2	108797	0.456860
chr21	42547157	42557166	PLAC4	10009	0.461984
chr21	42688660	42729654	FAM3B	40994	0.442065
chr21	42733949	42780869	MX2	46920	0.497421
chr21	42797977	42831141	MX1	33164	0.462459
chr21	42836477	42879992	TMPRSS2	43515	0.502999
chr21	43099461	43117496	LINC00111	18035	0.499584
chr21	43131679	43135935	LINC00479	4256	0.528665
chr21	43136595	43137742	LINC00112	1147	0.559721
chr21	43159528	43187249	RIPK4	27721	0.534829
chr21	43221153	43299591	PRDM15	78438	0.502907
chr21	43305218	43373999	C2CD2	68781	0.478911
chr21	43406939	43430496	ZBTB21	23557	0.428026
chr21	43442112	43445060	ZNF295-AS1	2948	0.515943
chr21	43491425	43563105	UMODL1	71680	0.526590
chr21	43495003	43496973	AX748362	1970	0.556345
chr21	43522243	43528644	C21orf128	6401	0.552257
chr21	43639266	43717354	ABCG1	78088	0.519632
chr21	43705989	43715445	ABCG1	9456	0.541455
chr21	43719103	43720919	AL355711	1816	0.491189
chr21	43731776	43735706	TFF3	3930	0.543257
chr21	43766466	43771208	TFF2	4742	0.535428
chr21	43782390	43786644	TFF1	4254	0.537847
chr21	43791995	43816955	TMPRSS3	24960	0.504607
chr21	43823970	43867790	UBASH3A	43820	0.493268
chr21	43837605	43837702	U6	97	0.319588
chr21	43892596	43916401	RSPH1	23805	0.460660
chr21	43919741	44001550	SLC37A1	81809	0.487428
chr21	44019513	44035168	BC041455	15655	0.449888
chr21	44068403	44071354	BC033260	2951	0.564216
chr21	44073861	44195618	PDE9A	121757	0.512562
chr21	44263189	44299693	WDR4	36504	0.537092
chr21	44263542	44266080	AX747730	2538	0.518125
chr21	44313377	44329773	NDUFV3	16396	0.466272
chr21	44336912	44345728	HERV-Fb1	8816	0.505558
chr21	44394642	44453688	PKNOX1	59046	0.470650
chr21	44473300	44496472	CBS	23172	0.588469
chr21	44513065	44527688	U2AF1	14623	0.436367
chr21	44589140	44592913	CRYAA	3773	0.631328
chr21	44834397	44847002	SIK1	12605	0.560651
chr21	44869903	44873771	LINC00319	3868	0.631851
chr21	44881973	44898103	LINC00313	16130	0.539244
chr21	44949071	45079374	HSF2BP	130303	0.430151
chr21	44985069	44985529	DQ577420	460	0.602174
chr21	45079431	45115960	RRP1B	36529	0.475102
chr21	45138977	45182188	PDXK	43211	0.572516
chr21	45193545	45196256	CSTB	2711	0.551826
chr21	45209417	45223983	RRP1	14566	0.570507
chr21	45225638	45232448	LOC284837	6810	0.601762
chr21	45345278	45407475	AGPAT3	62197	0.538820
chr21	45432205	45526432	TRAPPC10	94227	0.460123
chr21	45527207	45551063	PWP2	23856	0.569291
chr21	45553493	45565605	C21orf33	12112	0.585370
chr21	45646721	45660834	ICOSLG	14113	0.576206
chr21	45666221	45682099	DNMT3L	15878	0.569971
chr21	45705720	45718102	AIRE	12382	0.644484
chr21	45719924	45747261	PFKL	27337	0.634854
chr21	45748826	45759285	C21orf2	10459	0.604264
chr21	45773483	45862964	TRPM2	89481	0.537690
chr21	45834474	45845446	TRPM2	10972	0.579293
chr21	45870868	45875167	LRRC3-AS1	4299	0.436381
chr21	45875392	45878739	LRRC3	3347	0.607111
chr21	45898221	45898271	DQ598454	50	0.400000
chr21	45903703	45903735	DQ590668	32	0.531250
chr21	45904163	45904216	DQ601137	53	0.509434
chr21	45911601	45911640	DQ599834	39	0.435897
chr21	45913121	45913224	DQ588725	103	0.504854
chr21	45917774	46131495	TSPEAR	213721	0.501214
chr21	45937097	45938860	C21orf90	1763	0.515031
chr21	45959067	45960078	KRTAP10-1	1011	0.671612
chr21	45970317	45971388	KRTAP10-2	1071	0.661998
chr21	45977905	45978643	KRTAP10-3	738	0.681572
chr21	45993605	45994987	KRTAP10-4	1382	0.654848
chr21	45999563	46000481	KRTAP10-5	918	0.661220
chr21	46011148	46012386	KRTAP10-6	1238	0.656704
chr21	46020496	46022091	KRTAP10-7	1595	0.636364
chr21	46031995	46032871	KRTAP10-8	876	0.658676
chr21	46047039	46048295	KRTAP10-9	1256	0.667994
chr21	46057272	46058372	KRTAP10-10	1100	0.641818
chr21	46066330	46067566	KRTAP10-11	1236	0.624595
chr21	46074129	46074576	KRTAP12-4	447	0.653244
chr21	46077848	46078258	KRTAP12-3	410	0.636585
chr21	46086105	46086844	KRTAP12-2	739	0.604871
chr21	46101490	46102078	KRTAP12-1	588	0.603741
chr21	46117086	46117959	KRTAP10-12	873	0.671249
chr21	46188494	46221751	UBE2G2	33257	0.448627
chr21	46225531	46238044	SUMO3	12513	0.531767
chr21	46269499	46293818	PTTG1IP	24319	0.510013
chr21	46305867	46340965	ITGB2	35098	0.592683
chr21	46340949	46349595	ITGB2-AS1	8646	0.491788
chr21	46353198	46359828	C21orf67	6630	0.530920
chr21	46359954	46396888	FAM207A	36934	0.566876
chr21	46409778	46414001	LINC00163	4223	0.633910
chr21	46419126	46424642	LINC00162	5516	0.627810
chr21	46490870	46493126	SSR4P1	2256	0.570035
chr21	46494492	46646478	ADARB1	151986	0.452680
chr21	46654266	46678645	C21orf89	24379	0.494483
chr21	46683842	46707811	POFUT2	23969	0.529434
chr21	46707966	46717269	LOC642852	9303	0.547028
chr21	46875423	46933634	COL18A1	58211	0.602687
chr21	46827300	46829980	COL18A1-AS2	2680	0.597388
chr21	46839630	46844955	COL18A1-AS1	5325	0.606197
chr21	46934628	46962385	SLC19A1	27757	0.572720
chr21	47269874	47362368	PCBP3	92494	0.537613
chr21	47247754	47256333	LOC100129027	8579	0.560905
chr21	47401662	47424963	COL6A1	23301	0.646625
chr21	47518032	47552763	COL6A2	34731	0.558694
chr21	47556175	47575481	FTCD	19306	0.589661
chr21	47581061	47604373	SPATC1L	23312	0.507550
chr21	47587697	47604373	SPATC1L	16676	0.521288
chr21	47608359	47648738	LSS	40379	0.534981
chr21	47649157	47671604	MCM3AP-AS1	22447	0.453379
chr21	47655047	47705236	MCM3AP	50189	0.472374
chr21	47706266	47717665	YBEY	11399	0.530748
chr21	47721046	47743785	C21orf58	22739	0.524078
chr21	47740936	47744424	BC031638	3488	0.560780
chr21	47744035	47865682	PCNT	121647	0.515804
chr21	47878861	47989926	DIP2A	111065	0.448584
chr21	47882383	47889218	DIP2A-IT1	6835	0.401609
chr21	48018530	48025035	S100B	6505	0.447963
chr21	48055506	48085155	PRMT2	29649	0.452393
chr22	16150259	16193004	AK022914	42745	0.420049
chr22	16162065	16172265	LINC00516	10200	0.376569
chr22	16179617	16181004	BC017398	1387	0.329488
chr22	16239287	16239327	DQ590589	40	0.575000
chr22	16240245	16240277	DQ573684	32	0.468750
chr22	16240300	16240340	DQ595048	40	0.575000
chr22	16241085	16241125	DQ590589	40	0.575000
chr22	16242753	16242785	DQ573684	32	0.468750
chr22	16243382	16243414	DQ573684	32	0.468750
chr22	16243447	16243487	DQ587539	40	0.600000
chr22	16243907	16243948	DQ582484	41	0.439024
chr22	16243978	16244015	DQ599820	37	0.540541
chr22	16244205	16244245	DQ590589	40	0.575000
chr22	16244524	16244552	DQ573684	28	0.464286
chr22	16245153	16245185	DQ573684	32	0.468750
chr22	16245218	16245248	DQ587539	30	0.566667
chr22	16245678	16245719	DQ582484	41	0.439024
chr22	16245749	16245786	DQ599820	37	0.540541
chr22	16245997	16246037	DQ590589	40	0.575000
chr22	16251235	16255495	P704P	4260	0.461737
chr22	16256331	16287937	POTEH	31606	0.370752
chr22	16274557	16278600	P712P	4043	0.382884
chr22	16448823	16449804	OR11H1	981	0.434251
chr22	17029615	17029643	DQ571479	28	0.571429
chr22	17071647	17073700	CCT8L2	2053	0.553337
chr22	17082800	17129720	TPTEP1	46920	0.408440
chr22	17134598	17156430	ANKRD62P1-PARP4P3	21832	0.385718
chr22	17227758	17229328	BC038197	1570	0.440764
chr22	17264305	17302584	XKR3	38279	0.358735
chr22	17308363	17310225	HSFY1P1	1862	0.344791
chr22	17385314	17385395	IGKV1-12	81	0.567901
chr22	17442826	17489112	GAB4	46286	0.452318
chr22	17517459	17539682	CECR7	22223	0.437880
chr22	17565848	17596584	IL17RA	30736	0.506735
chr22	17597188	17602213	CECR6	5025	0.602985
chr22	17602484	17612994	BC021738	10510	0.459467
chr22	17618409	17640169	CECR5	21760	0.502344
chr22	17640278	17646335	CECR5-AS1	6057	0.492323
chr22	17660191	17690779	CECR1	30588	0.504413
chr22	17737749	17747623	CECR3	9874	0.516711
chr22	17956629	18033845	CECR2	77216	0.442784
chr22	18043182	18073647	SLC25A18	30465	0.508387
chr22	18074902	18111588	ATP6V1E1	36686	0.450526
chr22	18121349	18213621	BCL2L13	92272	0.425785
chr22	18215565	18217980	DQ570096	2415	0.414493
chr22	18216905	18256808	BID	39903	0.521189
chr22	18246945	18247025	MIR3198-1	80	0.562500
chr22	18270415	18507325	MICAL3	236910	0.497826
chr22	18322716	18325248	BC064400	2532	0.559637
chr22	18463633	18463727	MIR648	94	0.638298
chr22	18512150	18520734	FLJ41941	8584	0.464352
chr22	18560685	18573797	PEX26	13112	0.482077
chr22	18560820	18561541	Em:AC008101.5	721	0.638003
chr22	18593452	18614498	TUBA8	21046	0.509075
chr22	18632757	18660162	USP18	27405	0.481481
chr22	18660804	18685242	AK129567	24438	0.415787
chr22	18721396	18736925	AK302545	15529	0.413678
chr22	18761201	18792992	GGT3P	31791	0.505583
chr22	18834323	18839322	BC112340	4999	0.561312
chr22	18840391	18847477	AL117485	7086	0.565481
chr22	18893735	18899601	DGCR6	5866	0.579782
chr22	18900286	18924066	PRODH	23780	0.589445
chr22	18958010	18982142	DGCR5	24132	0.538497
chr22	18985168	18985205	DQ585141	37	0.486486
chr22	19005346	19007761	DGCR9	2415	0.547412
chr22	19010136	19011063	DGCR10	927	0.497303
chr22	19023794	19109967	DGCR2	86173	0.486301
chr22	19033674	19035888	DGCR11	2214	0.490063
chr22	19117791	19132190	DGCR14	14399	0.559205
chr22	19118320	19120136	TSSK2	1816	0.582048
chr22	19136503	19137796	GSC2	1293	0.730858
chr22	19163087	19166338	SLC25A1	3251	0.674869
chr22	19167711	19279239	CLTCL1	111528	0.463354
chr22	19318223	19419219	HIRA	100996	0.457652
chr22	19420035	19423596	MRPL40	3561	0.484695
chr22	19430672	19435755	C22orf39	5083	0.507968
chr22	19437463	19466738	UFD1L	29275	0.469718
chr22	19459917	19460033	U84523	116	0.655172
chr22	19467413	19508135	CDC45	40722	0.479888
chr22	19510546	19512860	CLDN5	2314	0.677615
chr22	19553652	19554362	LINC00895	710	0.564789
chr22	19704742	19711102	SEPT5-GP1BB	6360	0.661635
chr22	19705991	19712297	SEPT5-GP1BB	6306	0.668252
chr22	19744225	19754855	TBX1	10630	0.659548
chr22	19775933	19842462	GNB1L	66529	0.523261
chr22	19833660	19842371	C22orf29	8711	0.550453
chr22	19863039	19929359	TXNRD2	66320	0.540968
chr22	19929262	19957498	COMT	28236	0.532760
chr22	19951275	19951357	MIR4761	82	0.621951
chr22	19957401	20004309	ARVCF	46908	0.580093
chr22	20008630	20053447	TANGO2	44817	0.542897
chr22	20008632	20044627	TANGO2	35995	0.539992
chr22	20020661	20020743	MIR185	82	0.634146
chr22	20067754	20099400	DGCR8	31646	0.522120
chr22	20099388	20104818	TRMT2A	5430	0.630018
chr22	20105023	20114704	RANBP1	9681	0.566677
chr22	20119363	20135530	ZDHHC8	16167	0.633080
chr22	20136108	20137431	LOC388849	1323	0.684051
chr22	20186252	20192441	LOC284865	6189	0.564712
chr22	20193854	20196060	LINC00896	2206	0.605621
chr22	20228937	20255816	RTN4R	26879	0.603780
chr22	20236656	20236734	MIR1286	78	0.551282
chr22	20291560	20299716	KIAA1653	8156	0.576876
chr22	20301760	20307628	DGCR6L	5868	0.578221
chr22	20326398	20350461	LOC729444	24063	0.424303
chr22	20377668	20380440	TMEM191B	2772	0.678211
chr22	20383730	20400817	PI4KAP1	17087	0.569146
chr22	20390284	20390311	HV593096	27	0.444444
chr22	20397144	20397171	HV593134	27	0.444444
chr22	20397894	20397917	HV593127	23	0.478261
chr22	20398307	20398335	HV593178	28	0.571429
chr22	20398579	20398601	HV593135	22	0.545455
chr22	20455668	20455969	7SK	301	0.491694
chr22	20455993	20461786	RIMBP3	5793	0.632487
chr22	20640677	20656858	AK302545	16181	0.408936
chr22	20695276	20710250	JX456220	14974	0.444370
chr22	20717914	20731542	USP41	13628	0.477106
chr22	20748404	20762753	ZNF74	14349	0.508119
chr22	20778873	20792146	SCARF2	13273	0.632261
chr22	20795805	20850170	KLHL22	54365	0.491051
chr22	20861885	20941919	MED15	80034	0.504548
chr22	20970516	21011201	BC035867	40685	0.496424
chr22	21043842	21046009	POM121L4P	2167	0.609599
chr22	21045981	21046036	DQ571461	55	0.618182
chr22	21055401	21058891	TMEM191A	3490	0.618625
chr22	21061978	21213100	PI4KA	151122	0.477224
chr22	21068761	21068788	HV593096	27	0.444444
chr22	21068942	21068966	HV593183	24	0.541667
chr22	21083681	21083711	HV593110	30	0.500000
chr22	21087290	21087317	HV593134	27	0.444444
chr22	21088040	21088063	HV593127	23	0.478261
chr22	21088453	21088481	HV593178	28	0.571429
chr22	21088725	21088747	HV593135	22	0.545455
chr22	21128382	21142008	SERPIND1	13626	0.464920
chr22	21213291	21245501	SNAP29	32210	0.488451
chr22	21271713	21308037	CRKL	36324	0.457576
chr22	21311690	21318877	BC127858	7187	0.546682
chr22	21336557	21353326	LZTR1	16769	0.582146
chr22	21354060	21356404	THAP7	2344	0.633532
chr22	21355229	21355259	DQ574263	30	0.600000
chr22	21356210	21364663	THAP7-AS1	8453	0.499823
chr22	21362495	21368576	TUBA3FP	6081	0.547278
chr22	21369463	21382302	P2RX6	12839	0.559623
chr22	21383006	21386847	SLC7A4	3841	0.621453
chr22	21396680	21398538	P2RX6P	1858	0.543595
chr22	21400248	21418457	LOC400891	18209	0.519688
chr22	21457304	21476575	BCRP2	19271	0.459343
chr22	21467809	21475980	AL117485	8171	0.545466
chr22	21477049	21482046	POM121L7	4997	0.564539
chr22	21481136	21481174	DQ570150	38	0.631579
chr22	21538002	21546445	AK128837	8443	0.457776
chr22	21562261	21563772	GGT2	1511	0.620119
chr22	21637768	21638950	POM121L7	1182	0.605753
chr22	21637903	21637958	DQ571461	55	0.618182
chr22	21642518	21646214	AX748067	3696	0.560065
chr22	21737662	21743455	RIMBP3C	5793	0.632315
chr22	21743479	21743780	7SK	301	0.491694
chr22	21771692	21805750	HIC2	34058	0.561601
chr22	21821458	21824224	TMEM191C	2766	0.679320
chr22	21830664	21846383	PI4KAP2	15719	0.559578
chr22	21834063	21834090	HV593096	27	0.444444
chr22	21841120	21841147	HV593134	27	0.444444
chr22	21841870	21841893	HV593127	23	0.478261
chr22	21842283	21842311	HV593178	28	0.571429
chr22	21842555	21842577	HV593135	22	0.545455
chr22	21899632	21899933	7SK	301	0.498339
chr22	21899957	21905750	RIMBP3C	5793	0.631797
chr22	21903735	21978323	UBE2L3	74588	0.497265
chr22	21982377	21984340	YDJC	1963	0.674478
chr22	21987085	21991616	CCDC116	4531	0.596998
chr22	21996541	21998588	SDF2L1	2047	0.625305
chr22	22007269	22007347	MIR301B	78	0.525641
chr22	22007592	22007674	MIR130B	82	0.573171
chr22	22020272	22052202	PPIL2	31930	0.544472
chr22	22051825	22090071	YPEL1	38246	0.492705
chr22	22113946	22221970	MAPK1	108024	0.434413
chr22	22273791	22307250	PPM1F	33459	0.553454
chr22	22311402	22337147	TOP3B	25745	0.549621
chr22	22345495	22398332	AK131325	52837	0.446184
chr22	22380461	22380936	BC089413	475	0.543158
chr22	22385571	23265082	abParts	879511	0.453536
chr22	22599199	22599926	VPREB1	727	0.588721
chr22	22838771	22863505	ZNF280B	24734	0.416027
chr22	22868060	22874613	ZNF280A	6553	0.429116
chr22	22890122	22901696	PRAME	11574	0.499395
chr22	22901755	22909007	LOC648691	7252	0.464010
chr22	22974027	22987012	POM121L1P	12985	0.572892
chr22	22984838	22984876	DQ570150	38	0.631579
chr22	22984879	22984909	DQ597441	30	0.566667
chr22	22985767	22985805	DQ570150	38	0.631579
chr22	22988781	22990368	GGTLC2	1587	0.625709
chr22	23165269	23165360	MIR650	91	0.659341
chr22	23229959	23238013	IGLL5	8054	0.487708
chr22	23401592	23484241	RTDR1	82649	0.558313
chr22	23412668	23467221	GNAZ	54553	0.573846
chr22	23487512	23506531	RAB36	19019	0.554446
chr22	23522551	23660224	BCR	137673	0.530322
chr22	23604953	23607186	FBXW4P1	2233	0.588446
chr22	23701792	23724313	CES5AP1	22521	0.472270
chr22	23732791	23744799	ZDHHC8P1	12008	0.625333
chr22	23804431	23829167	LOC388882	24736	0.411344
chr22	23915312	23922495	IGLL1	7183	0.550327
chr22	23950638	23974508	C22orf43	23870	0.448932
chr22	23952777	23952803	DQ586720	26	0.576923
chr22	23980674	24059610	GUSBP11	78936	0.503636
chr22	23980674	24051428	GUSBP11	70754	0.502982
chr22	24032960	24041363	RGL4	8403	0.563489
chr22	24038687	24041357	RGL4	2670	0.579401
chr22	24051972	24059545	GUSBP11	7573	0.514723
chr22	24083771	24093279	ZNF70	9508	0.515671
chr22	24094929	24096630	VPREB3	1701	0.563786
chr22	24105207	24108050	C22orf15	2843	0.591629
chr22	24108020	24110141	CHCHD10	2121	0.627534
chr22	24115035	24126503	MMP11	11468	0.586502
chr22	24129149	24176705	SMARCB1	47556	0.507696
chr22	24176689	24181199	DERL3	4510	0.609756
chr22	24200040	24227725	SLC2A11	27685	0.505978
chr22	24235191	24235227	DQ601926	36	0.555556
chr22	24235896	24241117	LOC284889	5221	0.603333
chr22	24236564	24237409	MIF	845	0.698225
chr22	24238568	24238598	DQ574115	30	0.500000
chr22	24239638	24239678	DQ579704	40	0.500000
chr22	24239748	24239792	DQ584254	44	0.590909
chr22	24239835	24239864	DQ571361	29	0.517241
chr22	24240066	24240132	DQ575315	66	0.515152
chr22	24240744	24240774	DQ597394	30	0.533333
chr22	24245625	24247864	DQ600483	2239	0.518982
chr22	24253496	24253538	DQ596074	42	0.428571
chr22	24255602	24255629	DQ596562	27	0.555556
chr22	24299600	24303393	GSTT2	3793	0.574216
chr22	24309025	24314748	DDTL	5723	0.516338
chr22	24313553	24316680	DDT	3127	0.528622
chr22	24322313	24326106	GSTT2	3793	0.575007
chr22	24340594	24347258	GSTTP1	6664	0.531813
chr22	24373116	24374043	LOC391322	927	0.615965
chr22	24376138	24384284	GSTT1	8146	0.518537
chr22	24385937	24401899	GSTTP2	15962	0.472121
chr22	24407764	24574596	CABIN1	166832	0.501612
chr22	24577443	24585074	SUSD2	7631	0.640807
chr22	24615621	24641110	GGT5	25489	0.520656
chr22	24647952	24649256	UNQ2565	1304	0.605828
chr22	24648706	24648761	DQ571461	55	0.618182
chr22	24658457	24658483	DQ576853	26	0.576923
chr22	24666789	24813708	SPECC1L	146919	0.422838
chr22	24823529	24838325	ADORA2A	14796	0.565829
chr22	24823536	24829704	ADORA2A	6168	0.596628
chr22	24825177	24890783	ADORA2A-AS1	65606	0.467061
chr22	24890076	24922553	UPB1	32477	0.500693
chr22	24936405	24951275	GUCD1	14870	0.547613
chr22	24951617	24968509	SNRPD3	16892	0.468802
chr22	24979717	25024972	GGT1	45255	0.549486
chr22	24981590	24989035	FAM211B	7445	0.601612
chr22	25028881	25049327	BCRP3	20446	0.522694
chr22	25041132	25055114	POM121L10P	13982	0.568231
chr22	25046352	25047058	DKFZp434K191	706	0.586402
chr22	25053012	25053050	DQ570150	38	0.631579
chr22	25115000	25170687	PIWIL3	55687	0.420942
chr22	25160467	25161986	TOP1P2	1519	0.372614
chr22	25202135	25322813	SGSM1	120678	0.476624
chr22	25331207	25335314	TMEM211	4107	0.472608
chr22	25423940	25593415	KIAA1671	169475	0.490816
chr22	25498383	25508659	LOC100128531	10276	0.501752
chr22	25595816	25603326	CRYBB3	7510	0.521039
chr22	25615611	25627836	CRYBB2	12225	0.490470
chr22	25677208	25679061	BC040576	1853	0.584458
chr22	25714223	25716193	IGLL3P	1970	0.612183
chr22	25747384	25777544	LRP5L	30160	0.551459
chr22	25844053	25857645	CRYBB2P1	13592	0.463582
chr22	25960860	26125258	ADRBK2	164398	0.405437
chr22	26138119	26427007	MYO18B	288888	0.459251
chr22	26359948	26360239	7SK	291	0.474227
chr22	26565439	26779563	SEZ6L	214124	0.445639
chr22	26825279	26840978	ASPHD2	15699	0.493789
chr22	26846848	26875647	HPS4	28799	0.455780
chr22	26879849	26887904	SRRD	8055	0.445189
chr22	26887893	26908437	TFIP11	20544	0.449523
chr22	26921713	26986089	TPST2	64376	0.489033
chr22	26951177	26951289	MIR548J	112	0.446429
chr22	26995361	27013991	CRYBB1	18630	0.484380
chr22	27017927	27026636	CRYBA4	8709	0.473533
chr22	27063655	27068617	AK124820	4962	0.528618
chr22	27068848	27114949	AK026502	46101	0.456411
chr22	27444105	27456467	AK055980	12362	0.448471
chr22	27619257	27622760	BC015159	3503	0.458750
chr22	27706611	27713417	CR936633	6806	0.503379
chr22	28144264	28197486	MN1	53222	0.520875
chr22	28247656	28315255	PITPNB	67599	0.394192
chr22	28276021	28277106	AX748308	1085	0.429493
chr22	28315363	28398667	TTC28-AS1	83304	0.427398
chr22	28315363	28320951	TTC28-AS1	5588	0.417323
chr22	28316512	28316600	MIR3199-1	88	0.500000
chr22	28316513	28316599	MIR3199-2	86	0.500000
chr22	28374001	29075853	TTC28	701852	0.399080
chr22	29083730	29137822	CHEK2	54092	0.436719
chr22	29138042	29153496	HSCB	15454	0.467128
chr22	29168661	29185283	CCDC117	16622	0.443328
chr22	29190547	29193033	XBP1	2486	0.410298
chr22	29190547	29196560	XBP1	6013	0.447863
chr22	29279754	29453476	ZNRF3	173722	0.452574
chr22	29420986	29427464	ZNRF3-AS1	6478	0.483019
chr22	29454659	29457907	C22orf31	3248	0.464286
chr22	29469065	29564321	KREMEN1	95256	0.454900
chr22	29601900	29655586	EMID1	53686	0.526040
chr22	29655843	29663914	RHBDD3	8071	0.558047
chr22	29663997	29696515	EWSR1	32518	0.440218
chr22	29702996	29708774	GAS2L1	5778	0.645206
chr22	29708921	29711745	RASL10A	2824	0.652974
chr22	29708921	29711745	RASL10A	2824	0.652974
chr22	29723668	29784572	AP1B1	60904	0.513989
chr22	29729146	29729256	MIR3653	110	0.563636
chr22	29833003	29838118	RFPL1S	5115	0.459629
chr22	29834571	29838444	RFPL1	3873	0.461141
chr22	29876180	29887277	NEFH	11097	0.528521
chr22	29885264	29887277	KIAA0845	2013	0.519126
chr22	29904155	29949644	THOC5	45489	0.470993
chr22	29950797	29977326	NIPSNAP1	26529	0.502318
chr22	29999544	30094589	NF2	95045	0.457920
chr22	30116343	30127820	CABP7	11477	0.623421
chr22	30126944	30162969	ZMAT5	36025	0.527634
chr22	30163357	30166402	UQCR10	3045	0.476190
chr22	30184596	30234293	ASCC2	49697	0.489386
chr22	30279157	30426857	MTMR3	147700	0.406446
chr22	30476452	30573062	HORMAD2	96610	0.375655
chr22	30636435	30642840	LIF	6405	0.587354
chr22	30642198	30642982	MGC20647	784	0.604592
chr22	30658818	30662829	OSM	4011	0.603341
chr22	30687978	30722955	TBC1D10A	34977	0.524259
chr22	30727976	30752913	SF3A1	24937	0.490195
chr22	30752626	30772818	CCDC157	20192	0.545563
chr22	30764799	30773894	KIAA1656	9095	0.587136
chr22	30774802	30783302	RNF215	8500	0.586588
chr22	30792929	30821291	SEC14L2	28362	0.503667
chr22	30855215	30868034	SEC14L3	12819	0.489976
chr22	30877276	30877743	SDC4P	467	0.526767
chr22	30884897	30901698	SEC14L4	16801	0.503482
chr22	30920916	30942669	SEC14L6	21753	0.508482
chr22	30950623	30960876	GAL3ST1	10253	0.536526
chr22	30972611	30987927	PES1	15316	0.538326
chr22	31003069	31023047	TCN2	19978	0.506257
chr22	31031792	31043862	SLC35E4	12070	0.534466
chr22	31058038	31063872	DUSP18	5834	0.500000
chr22	31090792	31303811	OSBP2	213019	0.481168
chr22	31127543	31127628	MIR3200	85	0.564706
chr22	31318294	31322640	MORC2-AS1	4346	0.508514
chr22	31322599	31364187	MORC2	41588	0.448952
chr22	31365633	31375380	TUG1	9747	0.407510
chr22	31478845	31500610	SMTN	21765	0.586079
chr22	31500762	31503551	SELM	2789	0.601649
chr22	31518908	31530683	INPP5J	11775	0.558132
chr22	31530792	31536469	PLA2G3	5677	0.569491
chr22	31556047	31556105	MIR3928	58	0.637931
chr22	31556137	31603005	RNF185	46868	0.449923
chr22	31601248	31601602	BC069815	354	0.500000
chr22	31608249	31676066	LIMK2	67817	0.473421
chr22	31677578	31688520	PIK3IP1	10942	0.512521
chr22	31721789	31742249	PATZ1	20460	0.528495
chr22	31742871	31744504	Em:AC005003.4	1633	0.602572
chr22	31795538	31830172	DRG1	34634	0.446815
chr22	31831222	31834552	AK074476	3330	0.444444
chr22	31835344	31885547	EIF4ENIF1	50203	0.436109
chr22	31892124	32014537	SFI1	122413	0.463668
chr22	32014476	32026810	PISD	12334	0.592833
chr22	32077333	32146120	PRR14L	68787	0.449097
chr22	32150008	32303020	DEPDC5	153012	0.452174
chr22	32329506	32341336	C22orf24	11830	0.526712
chr22	32340478	32353590	YWHAH	13112	0.449664
chr22	32439018	32509011	SLC5A1	69993	0.432329
chr22	32517963	32529456	AP1B1P1	11493	0.494127
chr22	32524336	32524357	JB175027	21	0.666667
chr22	32545518	32555243	C22orf42	9725	0.420257
chr22	32586421	32599464	RFPL2	13043	0.486391
chr22	32614462	32651318	SLC5A4	36856	0.417110
chr22	32744122	32744144	JB153905	22	0.636364
chr22	32750871	32757148	RFPL3	6277	0.477457
chr22	32755892	32767063	RFPL3S	11171	0.414376
chr22	32772650	32780329	LOC339666	7679	0.470113
chr22	32783561	32808274	RTCB	24713	0.413264
chr22	32809833	32853373	BPIFC	43540	0.430179
chr22	32870706	32894818	FBXO7	24112	0.387525
chr22	32896531	32898414	AK123891	1883	0.467339
chr22	32908539	33402809	SYN3	494270	0.460718
chr22	33196801	33259028	TIMP3	62227	0.473540
chr22	33669061	34316416	LARGE	647355	0.444751
chr22	33832567	33832655	MIR4764	88	0.477273
chr22	34100771	34100908	SNORA50	137	0.569343
chr22	34120971	34146803	LARGE-AS1	25832	0.451223
chr22	35462129	35483380	ISX	21251	0.472260
chr22	35653444	35691800	HMGXB4	38356	0.414929
chr22	35695796	35743987	TOM1	48191	0.534623
chr22	35731632	35731751	MIR3909	119	0.596639
chr22	35777059	35790207	HMOX1	13148	0.509355
chr22	35796115	35820495	MCM5	24380	0.527030
chr22	35937351	35950045	RASD2	12694	0.549157
chr22	36002810	36013384	MB	10574	0.514753
chr22	36023037	36031181	LOC284912	8144	0.513139
chr22	36044423	36064456	APOL6	20033	0.415964
chr22	36113918	36125529	APOL5	11611	0.477134
chr22	36134782	36424585	RBFOX2	289803	0.393271
chr22	36536370	36556977	APOL3	20607	0.480468
chr22	36585175	36600879	APOL4	15704	0.490958
chr22	36622254	36636000	APOL2	13746	0.495708
chr22	36633472	36635231	AX747758	1759	0.538943
chr22	36649116	36663577	APOL1	14461	0.499827
chr22	36677322	36784063	MYH9	106741	0.523726
chr22	36730923	36732334	AX748195	1411	0.540751
chr22	36863092	36877687	TXN2	14595	0.512915
chr22	36883232	36903148	FOXRED2	19916	0.526963
chr22	36906896	36925277	EIF3D	18381	0.468854
chr22	36956915	37098690	CACNG2	141775	0.476946
chr22	37099962	37117494	AK123632	17532	0.459160
chr22	37154245	37172177	IFT27	17932	0.511822
chr22	37196744	37215517	PVALB	18773	0.514888
chr22	37257029	37274059	NCF4	17030	0.533999
chr22	37309674	37336479	CSF2RB	26805	0.519605
chr22	37361288	37364213	LOC100506241	2925	0.483077
chr22	37387159	37403877	TEX33	16718	0.473561
chr22	37406899	37415494	TST	8595	0.554159
chr22	37415790	37425863	MPST	10073	0.549588
chr22	37447778	37459430	KCTD17	11652	0.601871
chr22	37451072	37451387	7SK	315	0.587302
chr22	37461478	37499693	TMPRSS6	38215	0.552453
chr22	37521879	37545962	IL2RB	24083	0.568368
chr22	37576205	37584516	C1QTNF6	8311	0.571652
chr22	37602244	37608353	SSTR3	6109	0.594042
chr22	37621309	37640305	RAC2	18996	0.575490
chr22	37678494	37711389	CYTH4	32895	0.554796
chr22	37748230	37750879	AK097787	2649	0.489241
chr22	37751349	37751380	DQ587342	31	0.580645
chr22	37751669	37751701	DQ581393	32	0.468750
chr22	37753888	37753926	DQ577118	38	0.473684
chr22	37754335	37754480	DQ571864	145	0.524138
chr22	37754523	37754581	DQ595731	58	0.465517
chr22	37754870	37754908	DQ581625	38	0.473684
chr22	37755123	37755155	DQ584235	32	0.531250
chr22	37755236	37755266	DQ573975	30	0.400000
chr22	37755506	37755566	DQ593233	60	0.500000
chr22	37755718	37755757	DQ584694	39	0.641026
chr22	37756430	37756466	DQ572877	36	0.472222
chr22	37756486	37756548	DQ580960	62	0.596774
chr22	37756606	37756659	DQ597571	53	0.603774
chr22	37756691	37756734	DQ599403	43	0.511628
chr22	37756836	37756881	DQ574964	45	0.511111
chr22	37756901	37756938	DQ584633	37	0.594595
chr22	37756945	37756982	DQ574365	37	0.648649
chr22	37757138	37757172	DQ570280	34	0.529412
chr22	37757194	37757225	DQ572884	31	0.451613
chr22	37757457	37757487	DQ588058	30	0.633333
chr22	37757558	37757596	DQ596669	38	0.526316
chr22	37758364	37758404	DQ594524	40	0.475000
chr22	37758472	37758522	DQ590895	50	0.460000
chr22	37758976	37759044	DQ595101	68	0.588235
chr22	37759407	37759438	DQ574556	31	0.387097
chr22	37759487	37759517	DQ576685	30	0.466667
chr22	37759935	37759985	DQ575042	50	0.540000
chr22	37760018	37760101	DQ581304	83	0.566265
chr22	37760168	37760236	DQ571088	68	0.529412
chr22	37760254	37760285	DQ592963	31	0.451613
chr22	37760568	37760601	DQ584963	33	0.606061
chr22	37760686	37760760	DQ587429	74	0.445946
chr22	37760768	37760798	DQ574091	30	0.533333
chr22	37760893	37760926	DQ597182	33	0.606061
chr22	37761280	37761317	DQ584932	37	0.351351
chr22	37761389	37761439	DQ589322	50	0.500000
chr22	37761451	37761479	DQ601805	28	0.571429
chr22	37761714	37761755	DQ597697	41	0.585366
chr22	37761799	37761854	DQ576223	55	0.472727
chr22	37762153	37762183	DQ576602	30	0.533333
chr22	37762387	37762419	DQ588809	32	0.593750
chr22	37762487	37762529	DQ576178	42	0.476190
chr22	37762757	37762788	DQ577109	31	0.548387
chr22	37763031	37763060	DQ601762	29	0.551724
chr22	37763100	37763154	DQ574393	54	0.500000
chr22	37763329	37763375	DQ594725	46	0.500000
chr22	37763545	37763576	DQ579677	31	0.580645
chr22	37763675	37763723	DQ594390	48	0.520833
chr22	37763935	37764007	DQ593994	72	0.541667
chr22	37763999	37823505	ELFN2	59506	0.585739
chr22	37767723	37768896	BC033336	1173	0.624893
chr22	37865100	37882478	MFNG	17378	0.567269
chr22	37885887	37888557	CARD10	2670	0.620974
chr22	37885887	37915224	CARD10	29337	0.568599
chr22	37956470	37965410	CDC42EP1	8940	0.588479
chr22	37966252	37976024	LGALS2	9772	0.518011
chr22	38004480	38029571	GGA1	25091	0.566179
chr22	38035056	38052050	SH3BP1	16994	0.577792
chr22	38037838	38054384	AK097791	16546	0.552460
chr22	38071612	38075809	LGALS1	4197	0.567548
chr22	38075645	38075666	DM074112	21	0.476190
chr22	38092994	38172563	TRIOBP	79569	0.543541
chr22	38082343	38089485	NOL12	7142	0.562027
chr22	38201113	38203443	H1F0	2330	0.531330
chr22	38203911	38213183	GCAT	9272	0.542062
chr22	38219388	38221502	GALR3	2114	0.661306
chr22	38226861	38240353	ANKRD54	13492	0.512600
chr22	38243684	38243781	MIR659	97	0.536082
chr22	38245378	38284789	EIF3L	39411	0.458121
chr22	38302154	38338465	MICALL1	36311	0.557462
chr22	38339056	38349654	C22orf23	10598	0.503303
chr22	38349673	38364662	POLR2F	14989	0.504437
chr22	38349673	38365319	POLR2F	15646	0.506391
chr22	38368318	38380539	SOX10	12221	0.575894
chr22	38381941	38384339	AK098727	2398	0.583403
chr22	38384800	38384860	MIR4534	60	0.550000
chr22	38453261	38471708	PICK1	18447	0.547623
chr22	38474143	38479170	SLC16A8	5027	0.629401
chr22	38480895	38506676	BAIAP2L2	25781	0.535860
chr22	38507501	38510194	PLA2G6	2693	0.606387
chr22	38507501	38577761	PLA2G6	70260	0.514162
chr22	38599026	38612517	MAFF	13491	0.548291
chr22	38609541	38612517	MAFF	2976	0.578965
chr22	38615297	38668670	TMEM184B	53373	0.533266
chr22	38615652	38616226	BC127823	574	0.614983
chr22	38686696	38714089	CSNK1E	27393	0.557916
chr22	38742939	38794931	LOC400927	51992	0.422950
chr22	38822332	38840033	KCNJ4	17701	0.554036
chr22	38864082	38877637	KDELR3	13555	0.506160
chr22	38879442	38902345	DDX17	22903	0.423220
chr22	38914953	38966201	DMC1	51248	0.420094
chr22	38974124	39052634	FAM227A	78510	0.457751
chr22	39052657	39069855	CBY1	17198	0.471334
chr22	39066472	39077825	BC036921	11353	0.477935
chr22	39077953	39080766	TOMM22	2813	0.491290
chr22	39081547	39096459	JOSD1	14912	0.459496
chr22	39101806	39129592	GTPBP1	27786	0.501224
chr22	39130718	39152024	SUN2	21306	0.558575
chr22	39174512	39190161	DNAL4	15649	0.512812
chr22	39214455	39240017	NPTXR	25562	0.554495
chr22	39260247	39268258	CBX6	8011	0.596555
chr22	39378403	39388784	APOBEC3B	10381	0.531644
chr22	39410264	39414825	APOBEC3C	4561	0.545933
chr22	39417117	39429256	APOBEC3D	12139	0.543702
chr22	39436672	39451975	APOBEC3F	15303	0.531464
chr22	39493228	39500072	APOBEC3H	6844	0.534337
chr22	39526778	39548538	CBX7	21760	0.562362
chr22	39619684	39640957	PDGFB	21273	0.581488
chr22	39708886	39715670	RPL3	6784	0.529629
chr22	39715056	39715118	SNORD43	62	0.451613
chr22	39795758	39827887	TAB1	32129	0.505400
chr22	39883228	39888199	MGAT3	4971	0.601891
chr22	39898283	39914137	SMCR7L	15854	0.491737
chr22	39916568	39918691	ATF4	2123	0.565238
chr22	39925097	39928860	RPS19BP1	3763	0.548233
chr22	39966757	40085740	CACNA1I	118983	0.560525
chr22	40139048	40289794	ENTHD1	150746	0.384826
chr22	40297085	40367384	GRAP2	70299	0.442368
chr22	40390952	40426043	FAM83F	35091	0.521102
chr22	40428335	40432581	LOC100130899	4246	0.502120
chr22	40573928	40731812	TNRC6B	157884	0.425591
chr22	40742503	40762575	ADSL	20072	0.456507
chr22	40766594	40806293	SGSM3	39699	0.478425
chr22	40806291	41032690	MKL1	226399	0.435775
chr22	41075181	41078818	MCHR1	3637	0.556778
chr22	41077559	41077932	HV452684	373	0.597855
chr22	41165638	41215392	SLC25A17	49754	0.417615
chr22	41209886	41209962	MIR4766	76	0.368421
chr22	41220600	41252687	ST13	32087	0.382741
chr22	41253084	41328823	XPNPEP3	75739	0.414806
chr22	41255553	41258130	DNAJB7	2577	0.366705
chr22	41347350	41369019	RBX1	21669	0.448382
chr22	41488516	41488570	MIR1281	54	0.666667
chr22	41488613	41576081	EP300	87468	0.420154
chr22	41581218	41593505	BC040700	12287	0.460812
chr22	41601312	41627275	L3MBTL2	25963	0.523668
chr22	41605125	41613360	AK057177	8235	0.500304
chr22	41625513	41636935	CHADL	11422	0.580984
chr22	41641614	41682216	RANGAP1	40602	0.532683
chr22	41697506	41756151	ZC3H7B	58645	0.542928
chr22	41777932	41795332	TEF	17400	0.507816
chr22	41829491	41843027	TOB2	13536	0.514554
chr22	41855720	41864708	PHF5A	8988	0.462506
chr22	41865128	41924993	ACO2	59865	0.502664
chr22	41921802	41940476	POLR3H	18674	0.550659
chr22	41957013	41972670	CSDC2	15657	0.556620
chr22	41972889	41985871	PMM1	12982	0.548221
chr22	41994031	42017061	DESI1	23030	0.469171
chr22	42017294	42060052	XRCC6	42758	0.461551
chr22	42069936	42084913	NHP2L1	14977	0.463511
chr22	42086546	42094140	C22orf46	7594	0.512378
chr22	42095517	42195459	MEI1	99942	0.467651
chr22	42120358	42354544	bK250D10.C22.8	234186	0.500568
chr22	42196677	42222303	CCDC134	25626	0.491610
chr22	42222470	42222500	DQ596940	30	0.500000
chr22	42229105	42302375	SREBF2	73270	0.481425
chr22	42296947	42297016	MIR33A	69	0.478261
chr22	42305557	42310671	SHISA8	5114	0.670317
chr22	42321035	42322821	TNFRSF13C	1786	0.673012
chr22	42334740	42343148	CENPM	8408	0.532350
chr22	42372930	42394225	SEPT3	21295	0.508758
chr22	42394728	42424477	WBP2NL	29749	0.428720
chr22	42454337	42466846	NAGA	12509	0.532577
chr22	42470254	42475442	FAM109B	5188	0.558404
chr22	42475694	42480288	SMDT1	4594	0.484110
chr22	42481529	42486888	NDUFA6	5359	0.486471
chr22	42486936	42532702	NDUFA6-AS1	45766	0.481952
chr22	42522500	42526883	CYP2D6	4383	0.626968
chr22	42536213	42540575	CYP2D7P1	4362	0.631820
chr22	42556018	42611445	TCF20	55427	0.461273
chr22	42665758	42670868	LOC388906	5110	0.584931
chr22	42760534	42765180	BC038245	4646	0.561558
chr22	42776413	42828401	NFAM1	51988	0.548954
chr22	42896584	42908566	SERHL	11982	0.555583
chr22	42904340	42915829	RRP7A	11489	0.575246
chr22	42949924	42970388	SERHL2	20464	0.541145
chr22	42951228	42978017	RRP7B	26789	0.548471
chr22	42979726	43010962	POLDIP3	31236	0.490940
chr22	43011250	43011399	RNU12	149	0.523490
chr22	43013845	43040640	CYB5R3	26795	0.549953
chr22	43019890	43019952	DL490307	62	0.677419
chr22	43035808	43036607	ATP5L2	799	0.450563
chr22	43088126	43116876	A4GALT	28750	0.521252
chr22	43172869	43172890	CS330190	21	0.619048
chr22	43182195	43182228	DQ595055	33	0.606061
chr22	43192531	43253408	ARFGAP3	60877	0.448297
chr22	43265771	43411184	PACSIN2	145413	0.487955
chr22	43434590	43448371	BC039353	13781	0.519193
chr22	43435522	43485434	TTLL1	49912	0.512702
chr22	43506753	43525718	BIK	18965	0.547957
chr22	43528211	43539403	MCAT	11192	0.525197
chr22	43547519	43559248	TSPO	11729	0.578140
chr22	43547519	43559248	TSPO	11729	0.578140
chr22	43562627	43566280	TTLL12	3653	0.603340
chr22	43562627	43583137	TTLL12	20510	0.583033
chr22	43593288	43595059	AK056490	1771	0.562959
chr22	43599228	43739394	SCUBE1	140166	0.554286
chr22	43671960	43679832	BC036874	7872	0.570249
chr22	43808019	43902800	MPPED1	94781	0.521117
chr22	43912133	43932485	EFCAB6-AS1	20352	0.494349
chr22	43924623	44208217	EFCAB6	283594	0.429720
chr22	44220386	44258378	SULT4A1	37992	0.560197
chr22	44275557	44287893	PNPLA5	12336	0.573930
chr22	44319618	44343448	PNPLA3	23830	0.517793
chr22	44351260	44392412	SAMM50	41152	0.473367
chr22	44420156	44565112	PARVB	144956	0.513542
chr22	44576769	44604349	PARVG	27580	0.554133
chr22	44639556	44708731	KIAA1644	69175	0.534340
chr22	44888449	44894005	LDOC1L	5556	0.556156
chr22	44965219	44968329	LINC00207	3110	0.541158
chr22	45002207	45021299	LINC00229	19092	0.551749
chr22	45098371	45258664	PRR5-ARHGAP8	160293	0.527191
chr22	45277042	45405809	PHF21B	128767	0.527231
chr22	45529638	45559662	LOC100506714	30024	0.412936
chr22	45559725	45583890	NUP50	24165	0.436168
chr22	45588122	45608347	KIAA0930	20225	0.567763
chr22	45596834	45596900	MIR1249	66	0.651515
chr22	45680867	45691755	UPK3A	10888	0.549320
chr22	45705784	45737836	FAM118A	32052	0.491857
chr22	45724002	45724028	DQ586951	26	0.500000
chr22	45724084	45724110	DQ586951	26	0.500000
chr22	45724166	45724192	DQ586951	26	0.500000
chr22	45724248	45724276	DQ586951	28	0.500000
chr22	45739944	45809500	SMC1B	69556	0.398887
chr22	45809571	45828302	RIBC2	18731	0.503604
chr22	45898718	45997014	FBLN1	98296	0.530062
chr22	46000311	46001501	BC045163	1190	0.499160
chr22	46020410	46020512	U6	102	0.441176
chr22	46067677	46241187	ATXN10	173510	0.405671
chr22	46156403	46156478	MIR4762	75	0.440000
chr22	46316247	46373008	WNT7B	56761	0.602086
chr22	46402495	46406657	LOC730668	4162	0.588659
chr22	46435786	46440748	LINC00899	4962	0.487505
chr22	46446338	46450024	C22orf26	3686	0.595768
chr22	46449725	46501901	MIRLET7BHG	52176	0.558935
chr22	46451619	46454040	LOC554174	2421	0.469641
chr22	46486923	46487006	MIR3619	83	0.650602
chr22	46508628	46508702	MIRLET7A3	74	0.459459
chr22	46508631	46508653	DM119500	22	0.363636
chr22	46509445	46509537	MIR4763	92	0.771739
chr22	46509565	46509648	MIRLET7B	83	0.530120
chr22	46546498	46639653	PPARA	93155	0.463732
chr22	46639909	46646193	CDPF1	6284	0.568587
chr22	46651559	46659219	PKDREJ	7660	0.474674
chr22	46663860	46689905	TTC38	26045	0.541563
chr22	46691039	46692557	GTSE1-AS1	1518	0.556653
chr22	46692637	46726707	GTSE1	34070	0.501291
chr22	46726771	46729595	BC069212	2824	0.537535
chr22	46731297	46753237	TRMU	21940	0.526664
chr22	46756730	46933067	CELSR1	176337	0.539297
chr22	47022647	47075688	GRAMD4	53041	0.585208
chr22	47080306	47134152	CERK	53846	0.514319
chr22	47158517	47571342	TBC1D22A	412825	0.494042
chr22	47309987	47311916	FLJ32756	1929	0.519959
chr22	47857047	47882860	BC037972	25813	0.414442
chr22	48016791	48027318	LINC00898	10527	0.550489
chr22	48027451	48251349	AK093107	223898	0.447668
chr22	48670175	48670227	MIR3201	52	0.384615
chr22	48885287	49147744	FAM19A5	262457	0.563399
chr22	48934711	48943199	LOC284933	8488	0.560438
chr22	49176106	49176165	MIR4535	59	0.559322
chr22	49262581	49294198	LOC100128946	31617	0.514438
chr22	50013289	50051190	C22orf34	37901	0.568613
chr22	50166936	50218452	BRD1	51516	0.534455
chr22	50171537	50173958	LOC90834	2421	0.532012
chr22	50247496	50283726	ZBED4	36230	0.474855
chr22	50296853	50312106	ALG12	15253	0.562840
chr22	50312282	50321186	CRELD2	8904	0.586590
chr22	50354142	50357720	PIM3	3578	0.695920
chr22	50432941	50451055	IL17REL	18114	0.586452
chr22	50497819	50523781	MLC1	25962	0.554888
chr22	50528434	50600116	MOV10L1	71682	0.475935
chr22	50609159	50618724	PANX2	9565	0.641715
chr22	50624359	50638027	TRABD	13668	0.627890
chr22	50639407	50656045	SELO	16638	0.557819
chr22	50656117	50683400	TUBGCP6	27283	0.569109
chr22	50683612	50689834	HDAC10	6222	0.645130
chr22	50688491	50700089	MAPK12	11598	0.651923
chr22	50702141	50708779	MAPK11	6638	0.649895
chr22	50713407	50746001	PLXNB2	32594	0.649414
chr22	50750391	50765489	DENND6B	15098	0.600079
chr22	50781745	50883518	PPP6R2	101773	0.511246
chr22	50862771	50862865	AB372727	94	0.659574
chr22	50883430	50913464	SBF1	30034	0.606846
chr22	50919984	50924866	ADM2	4882	0.636624
chr22	50925212	50928750	MIOX	3538	0.652063
chr22	50941375	50946135	LMF2	4760	0.671639
chr22	50946644	50963209	NCAPH2	16565	0.554845
chr22	50961996	50964033	SCO2	2037	0.636230
chr22	50964180	50968514	TYMP	4334	0.646285
chr22	50968837	50971008	ODF3B	2171	0.694611
chr22	50986461	50989452	KLHDC7B	2991	0.642260
chr22	50989540	51001328	SYCE3	11788	0.498134
chr22	51007289	51016894	CPT1B	9605	0.584383
chr22	51009427	51010882	BC048192	1455	0.579381
chr22	51017386	51021428	CHKB	4042	0.587580
chr22	51021454	51022355	CHKB-AS1	901	0.617092
chr22	51041561	51049979	MAPK8IP2	8418	0.646947
chr22	51061181	51066601	ARSA	5420	0.611993
chr22	51113069	51171640	SHANK3	58571	0.569975
chr22	51174256	51176567	BC050343	2311	0.458243
chr22	51176651	51183727	ACR	7076	0.555540
chr22	51195513	51238065	RPL23AP82	42552	0.446442
chr22	51205919	51222087	RABL2B	16168	0.500371
chr22	51222156	51238065	RPL23AP82	15909	0.412471
chr3	238278	451097	CHL1	212819	0.370197
chr3	405055	427478	BC065754	22423	0.384605
chr3	577913	887698	AK126307	309785	0.357480
chr3	1134628	1445278	CNTN6	310650	0.364565
chr3	2140549	3099645	CNTN4	959096	0.379697
chr3	2152092	2185925	CNTN4-AS2	33833	0.384861
chr3	3108007	3152058	IL5RA	44051	0.419264
chr3	3168599	3190706	TRNT1	22107	0.394219
chr3	3171713	3172360	TRNT1	647	0.353941
chr3	3191316	3221401	CRBN	30085	0.374871
chr3	3841120	3889387	LRRN1	48267	0.408809
chr3	3842004	3842676	BC141932	672	0.656250
chr3	4344987	4358949	SETMAR	13962	0.402593
chr3	4402828	4508966	SUMF1	106138	0.400215
chr3	4535031	4889524	ITPR1	354493	0.429010
chr3	4790877	4793274	EGOT	2397	0.446809
chr3	4792016	4792369	EGOT	353	0.444759
chr3	4939913	5021646	BHLHE40-AS1	81733	0.406898
chr3	5021096	5026865	BHLHE40	5769	0.481019
chr3	5163929	5222601	ARL8B	58672	0.408099
chr3	5229358	5261650	EDEM1	32292	0.433544
chr3	5291861	5291940	MIR4790	79	0.354430
chr3	6532165	6778421	AF279782	246256	0.367626
chr3	6902801	7783218	GRM7	880417	0.378186
chr3	7994491	8057994	AK124857	63503	0.402957
chr3	8262833	8543344	LMCD1-AS1	280511	0.409096
chr3	8406214	8406334	U4atac	120	0.450000
chr3	8543492	8609811	LMCD1	66319	0.440100
chr3	8613467	8616354	LINC00312	2887	0.373744
chr3	8661085	8686484	SSUH2	25399	0.493051
chr3	8775485	8788451	CAV3	12966	0.494601
chr3	8792094	8811300	OXTR	19206	0.500208
chr3	8918879	9005159	RAD18	86280	0.382302
chr3	9022275	9291369	SRGAP3	269094	0.461746
chr3	9234218	9236137	BC041457	1919	0.497134
chr3	9258578	9261192	SRGAP3-AS3	2614	0.454858
chr3	9404716	9428475	THUMPD3	23759	0.399512
chr3	9430536	9439174	SETD5-AS1	8638	0.424520
chr3	9439402	9519838	SETD5	80436	0.390024
chr3	9540044	9595486	LHFPL4	55442	0.466740
chr3	9691116	9744078	MTMR14	52962	0.493656
chr3	9745509	9771592	CPNE9	26083	0.485374
chr3	9773433	9789699	BRPF1	16266	0.516107
chr3	9791627	9799089	OGG1	7462	0.509113
chr3	9799028	9811668	CAMK1	12640	0.512816
chr3	9802397	9805087	AX748417	2690	0.521190
chr3	9821647	9834695	TADA3	13048	0.493639
chr3	9851643	9878040	TTLL3	26397	0.510967
chr3	9879532	9885702	RPUSD3	6170	0.525122
chr3	9908393	9921938	CIDEC	13545	0.471982
chr3	9932270	9936031	JAGN1	3761	0.474608
chr3	9944295	9958084	IL17RE	13789	0.518529
chr3	9958781	9975305	IL17RC	16524	0.511680
chr3	9975524	9987097	CRELD1	11573	0.515769
chr3	9987225	9994078	PRRT3	6853	0.593755
chr3	9989087	9996471	PRRT3-AS1	7384	0.540493
chr3	10005635	10028522	EMC3	22887	0.434832
chr3	10028594	10046928	AX747493	18334	0.435257
chr3	10048101	10052779	LOC401052	4678	0.563916
chr3	10059174	10061778	FW339974	2604	0.487711
chr3	10068112	10141344	FANCD2	73232	0.426617
chr3	10123003	10149915	FANCD2OS	26912	0.443966
chr3	10157332	10168874	BRK1	11542	0.449835
chr3	10183318	10195354	VHL	12036	0.474078
chr3	10206562	10285427	IRAK2	78865	0.488911
chr3	10290176	10322906	TATDN2	32730	0.468225
chr3	10326102	10327430	LINC00852	1328	0.486446
chr3	10327431	10335133	GHRLOS	7702	0.535445
chr3	10327433	10334631	GHRL	7198	0.538205
chr3	10342614	10362858	SEC13	20244	0.476833
chr3	10365706	10547268	ATP2B2	181562	0.516837
chr3	10436172	10436246	MIR885	74	0.581081
chr3	10801168	10805877	LINC00606	4709	0.488214
chr3	10857916	10980146	SLC6A11	122230	0.468993
chr3	11034419	11080935	SLC6A1	46516	0.501118
chr3	11047783	11060910	SLC6A1-AS1	13127	0.508418
chr3	11196213	11304939	HRH1	108726	0.461021
chr3	11314009	11599139	ATG7	285130	0.432645
chr3	11577722	11580151	AX748267	2429	0.533553
chr3	11597543	11685398	VGLL4	87855	0.455956
chr3	11831918	11888352	TAMM41	56434	0.420881
chr3	11952182	11952212	DQ583118	30	0.533333
chr3	12045861	12233532	SYN2	187671	0.409797
chr3	12194567	12200851	TIMP4	6284	0.489815
chr3	12393000	12475855	PPARG	82855	0.390308
chr3	12526009	12574820	TSEN2	48811	0.429965
chr3	12581279	12586963	C3orf83	5684	0.457600
chr3	12598512	12625210	MKRN2	26698	0.451832
chr3	12625099	12705700	RAF1	80601	0.426856
chr3	12775391	12800808	TMEM40	25417	0.475745
chr3	12838170	12876313	CAND2	38143	0.516504
chr3	12876443	12881949	RPL32	5506	0.459136
chr3	12898772	12898808	DQ577646	36	0.472222
chr3	12900320	12900351	DQ583118	31	0.516129
chr3	12900684	12900711	DQ579436	27	0.481481
chr3	12902154	12902187	DQ575652	33	0.424242
chr3	12903754	12903783	DQ574002	29	0.517241
chr3	12903852	12903884	DQ575653	32	0.468750
chr3	12904350	12904396	DQ587889	46	0.456522
chr3	12904922	12904952	DQ587809	30	0.566667
chr3	12915579	12915608	DQ581328	29	0.551724
chr3	12938541	13114617	IQSEC1	176076	0.543470
chr3	13357736	13461809	NUP210	104073	0.526006
chr3	13521714	13547924	HDAC11	26210	0.536818
chr3	13590624	13679922	FBLN2	89298	0.535857
chr3	13652923	13653534	BC152380	611	0.461538
chr3	13652923	13653534	BC152379	611	0.461538
chr3	13692220	13788132	LINC00620	95912	0.487853
chr3	13860081	13921618	WNT7A	61537	0.519297
chr3	13974552	13978444	FGD5P1	3892	0.577081
chr3	14058900	14107481	TPRXL	48581	0.412672
chr3	14058900	14106264	TPRXL	47364	0.409214
chr3	14153576	14166371	CHCHD4	12795	0.481751
chr3	14166439	14185180	TMEM43	18741	0.527293
chr3	14186647	14220172	XPC	33525	0.451782
chr3	14220227	14239869	LSM3	19642	0.406781
chr3	14240059	14241816	AX747368	1757	0.450199
chr3	14444075	14530857	SLC6A6	86782	0.522078
chr3	14530618	14583588	GRIP2	52970	0.517972
chr3	14562198	14567490	GRIP2	5292	0.560280
chr3	14693252	14714166	CCDC174	20914	0.422779
chr3	14716605	14814543	C3orf20	97938	0.440115
chr3	14860468	14976072	FGD5	115604	0.484110
chr3	14961856	14989948	FGD5-AS1	28092	0.454151
chr3	14984285	14989400	FGD5-AS1	5115	0.442620
chr3	14984285	14989012	FGD5-AS1	4727	0.415909
chr3	14989235	15090780	NR2C2	101545	0.417372
chr3	15090018	15106816	MRPS25	16798	0.495952
chr3	15111579	15140655	ZFYVE20	29076	0.443802
chr3	15216269	15222478	COL6A4P1	6209	0.421807
chr3	15247732	15294423	CAPN7	46691	0.370521
chr3	15295690	15306005	SH3BP5-AS1	10315	0.455744
chr3	15295862	15374136	SH3BP5	78274	0.467371
chr3	15451376	15469042	METTL6	17666	0.416903
chr3	15469063	15484120	EAF1	15057	0.413960
chr3	15491639	15563258	COLQ	71619	0.465784
chr3	15537745	15537815	MIR4270	70	0.542857
chr3	15602239	15643130	HACL1	40891	0.389670
chr3	15643254	15687325	BTD	44071	0.415557
chr3	15708743	15901053	ANKRD28	192310	0.370652
chr3	15781726	15803697	BC041363	21971	0.387829
chr3	15915277	15915356	MIR563	79	0.443038
chr3	15920384	15920415	DQ592427	31	0.387097
chr3	15920976	15921006	DQ582763	30	0.466667
chr3	16216183	16271253	GALNT15	55070	0.458671
chr3	16298567	16306496	DPH3	7929	0.404086
chr3	16306666	16347594	OXNAD1	40928	0.392958
chr3	16357351	16555222	RFTN1	197871	0.434581
chr3	16577826	16582880	BC034913	5054	0.373961
chr3	16628300	16647006	DAZL	18706	0.359083
chr3	16974581	17132098	PLCL2	157517	0.389571
chr3	17198653	17784240	TBC1D5	585587	0.368082
chr3	18004063	18310410	LOC339862	306347	0.384113
chr3	18389132	18480265	SATB1	91133	0.359365
chr3	18996434	18996541	U6	107	0.317757
chr3	19190016	19577135	KCNH8	387119	0.360233
chr3	19356339	19356423	MIR4791	84	0.333333
chr3	19920965	19975706	EFHB	54741	0.396577
chr3	19988571	20026667	RAB5A	38096	0.397942
chr3	20026835	20053765	PP2D1	26930	0.401857
chr3	20081523	20195896	KAT2B	114373	0.401992
chr3	20202084	20227698	SGOL1	25614	0.369759
chr3	20215735	20227919	SGOL1-AS1	12184	0.387065
chr3	21447217	21448177	VENTXP7	960	0.622917
chr3	21462489	21792816	ZNF385D	330327	0.370811
chr3	23244783	23632296	UBE2E2	387513	0.376527
chr3	23375625	23648882	MIR548AC	273257	0.380429
chr3	23847383	23933131	UBE2E1	85748	0.414400
chr3	23933571	23958537	NKIRAS1	24966	0.415685
chr3	23958617	23962347	RPL15	3730	0.443968
chr3	23986750	24022109	NR1D2	35359	0.406940
chr3	24141464	24144738	LINC00691	3274	0.443189
chr3	24158644	24536313	THRB	377669	0.387903
chr3	24535577	24541502	THRB-AS1	5925	0.501097
chr3	24562852	24562926	MIR4792	74	0.729730
chr3	25469833	25639422	RARB	169589	0.417498
chr3	25424598	25426409	AK131021	1811	0.422971
chr3	25639395	25705863	TOP2B	66468	0.348303
chr3	25659341	25659405	TRNA	64	0.343750
chr3	25760434	25824989	NGLY1	64555	0.372365
chr3	25831562	25836025	OXSM	4463	0.402420
chr3	25900022	25915186	LINC00692	15164	0.361778
chr3	26664299	26752265	LRRC3B	87966	0.395153
chr3	27257096	27410912	NEK10	153816	0.386332
chr3	27414211	27498245	SLC4A7	84034	0.354214
chr3	27454181	27454202	JB175177	21	0.333333
chr3	27757439	27764206	EOMES	6767	0.479385
chr3	27872378	27875627	BC037254	3249	0.396737
chr3	28283123	28361263	CMC1	78140	0.360865
chr3	28363843	28390618	AZI2	26775	0.340728
chr3	28431988	28566632	ZCWPW2	134644	0.358865
chr3	28615345	28616760	AX746710	1415	0.400707
chr3	28616768	28799828	LINC00693	183060	0.387638
chr3	29322802	30051886	RBMS3	729084	0.362541
chr3	30647993	30735633	TGFBR2	87640	0.408113
chr3	30767691	30936153	GADL1	168462	0.379451
chr3	31574490	31677556	STT3B	103066	0.358634
chr3	31702316	32023342	OSBPL10	321026	0.426327
chr3	31745704	31763078	OSBPL10-AS1	17374	0.441982
chr3	32023265	32033228	ZNF860	9963	0.415939
chr3	32148002	32210207	GPD1L	62205	0.443164
chr3	32280170	32411813	CMTM8	131643	0.430650
chr3	32433162	32496333	CMTM7	63171	0.449051
chr3	32522803	32544403	CMTM6	21600	0.386435
chr3	32567462	32612366	DYNC1LI1	44904	0.391591
chr3	32737032	32815367	CNOT10	78335	0.416519
chr3	32859509	32933771	TRIM71	74262	0.459576
chr3	32937215	32938323	EF565122	1108	0.385379
chr3	32993065	32996403	CCR4	3338	0.465848
chr3	33038099	33138694	GLB1	100595	0.440191
chr3	33131907	33138314	TMPPE	6407	0.500546
chr3	33155449	33189265	CRTAP	33816	0.443015
chr3	33191536	33260707	SUSD5	69171	0.416070
chr3	33318933	33428757	FBXL2	109824	0.385663
chr3	33429828	33481897	UBP1	52069	0.398855
chr3	33537738	33759705	CLASP2	221967	0.367974
chr3	33840062	33911199	PDCD6IP	71137	0.368711
chr3	35721278	35835988	ARPP21	114710	0.366420
chr3	35785967	35786051	MIR128-2	84	0.559524
chr3	36422096	36589496	STAC	167400	0.398005
chr3	36753912	36781352	DCLK3	27440	0.439395
chr3	36868307	36986548	TRANK1	118241	0.431762
chr3	37027356	37034795	EPM2AIP1	7439	0.389300
chr3	37034840	37092337	MLH1	57497	0.418996
chr3	37094116	37217851	LRRFIP2	123735	0.384257
chr3	37181817	37181921	U6	104	0.365385
chr3	37284681	37408370	GOLGA4	123689	0.377988
chr3	37440967	37476988	C3orf35	36021	0.418617
chr3	37493812	37861281	ITGA9	367469	0.446157
chr3	37847333	37903250	BC040563	55917	0.451508
chr3	37903668	38025960	CTDSPL	122292	0.422088
chr3	38010894	38010971	MIR26A1	77	0.558442
chr3	38010903	38010924	DM119520	21	0.428571
chr3	38035077	38048676	VILL	13599	0.561732
chr3	38048986	38066278	PLCD1	17292	0.532732
chr3	38080695	38164228	DLEC1	83533	0.484946
chr3	38164200	38178733	ACAA1	14533	0.508980
chr3	38179968	38184512	MYD88	4544	0.544014
chr3	38207025	38296979	OXSR1	89954	0.385808
chr3	38307297	38319806	SLC22A13	12509	0.497802
chr3	38347444	38359859	SLC22A14	12415	0.535159
chr3	38388250	38456467	XYLB	68217	0.453699
chr3	38492517	38496311	ACVR2B-AS1	3794	0.564839
chr3	38495789	38534633	ACVR2B	38844	0.472789
chr3	38537762	38567796	EXOG	30034	0.389725
chr3	38589552	38674850	SCN5A	85298	0.506155
chr3	38674525	38687267	SCN5A	12742	0.518678
chr3	38738836	38835501	SCN10A	96665	0.424838
chr3	38887259	38992052	SCN11A	104793	0.393900
chr3	39093506	39137881	WDR48	44375	0.399369
chr3	39138090	39149130	GORASP1	11040	0.550362
chr3	39149151	39180394	TTC21A	31243	0.492366
chr3	39183341	39195102	CSRNP1	11761	0.551654
chr3	39224706	39234085	XIRP1	9379	0.583005
chr3	39304984	39323226	CX3CR1	18242	0.461517
chr3	39371196	39375171	CCR8	3975	0.421635
chr3	39424814	39438819	SLC25A38	14005	0.464548
chr3	39448203	39454032	RPSA	5829	0.451535
chr3	39449881	39450030	SNORA6	149	0.483221
chr3	39452544	39452698	SNORA62	154	0.474026
chr3	39509063	39557494	MOBP	48431	0.402717
chr3	39509063	39557494	MOBP	48431	0.402717
chr3	39563760	39570988	MOBP	7228	0.380188
chr3	39851302	40301811	MYRIP	450509	0.401013
chr3	40214637	40351189	EIF1B-AS1	136552	0.412334
chr3	40280098	40280232	SNORA64	134	0.529851
chr3	40351172	40353915	EIF1B	2743	0.417426
chr3	40428672	40470110	ENTPD3	41438	0.417684
chr3	40432441	40494799	ENTPD3-AS1	62358	0.416370
chr3	40487070	40487905	BC035465	835	0.429940
chr3	40498782	40503863	RPL14	5081	0.451683
chr3	40518603	40531728	ZNF619	13125	0.452267
chr3	40547529	40559712	ZNF620	12183	0.438398
chr3	40566375	40581043	ZNF621	14668	0.432097
chr3	41240941	41281939	CTNNB1	40998	0.383921
chr3	41262337	41266542	AK311005	4205	0.375505
chr3	41288089	42003660	ULK4	715571	0.393860
chr3	41988103	41988123	JA660634	20	0.400000
chr3	42132745	42267382	TRAK1	134637	0.452194
chr3	42263331	42263457	U4	126	0.420635
chr3	42299317	42305439	CCK	6122	0.452140
chr3	42438574	42452065	LYZL4	13491	0.433845
chr3	42544103	42579065	VIPR1	34962	0.536382
chr3	42589458	42623520	SEC22C	34062	0.414333
chr3	42632297	42636490	SS18L2	4193	0.453136
chr3	42642146	42690233	NKTR	48087	0.375237
chr3	42695175	42709072	ZBTB47	13897	0.612578
chr3	42727010	42733938	KLHL40	6928	0.585017
chr3	42734154	42744319	HHATL	10165	0.564781
chr3	42749873	42814745	CCDC13	64872	0.468985
chr3	42774066	42786650	CCDC13-AS1	12584	0.501033
chr3	42824399	42845934	HIGD1A	21535	0.422382
chr3	42850964	42908775	CCBP2	57811	0.431527
chr3	42913683	42917633	CYP8B1	3950	0.516709
chr3	42947657	42960825	ZNF662	13168	0.444259
chr3	42977833	42984283	KRBOX1	6450	0.397985
chr3	43020758	43099207	FAM198A	78449	0.467335
chr3	43120720	43147575	GTDC2	26855	0.476894
chr3	43328003	43392634	SNRK	64631	0.389875
chr3	43388410	43393454	SNRK-AS1	5044	0.431007
chr3	43407817	43663560	ANO10	255743	0.402424
chr3	43732374	43764217	ABHD5	31843	0.392677
chr3	44155703	44155802	MIR138-1	99	0.585859
chr3	44159797	44163857	DQ592230	4060	0.455665
chr3	44283377	44373590	TOPAZ1	90213	0.366433
chr3	44379943	44450940	TCAIM	70997	0.393467
chr3	44481261	44519162	ZNF445	37901	0.440331
chr3	44540461	44552128	ZNF852	11667	0.427873
chr3	44596712	44613650	ZKSCAN7	16938	0.448872
chr3	44626455	44637557	ZNF660	11102	0.430103
chr3	44666510	44686752	ZNF197	20242	0.400059
chr3	44690232	44702283	ZNF35	12051	0.425857
chr3	44754134	44765323	ZNF502	11189	0.406203
chr3	44771097	44778575	ZNF501	7478	0.393956
chr3	44790235	44803173	KIAA1143	12938	0.408641
chr3	44803208	44894748	KIF15	91540	0.402982
chr3	44903407	44907154	TMEM42	3747	0.519082
chr3	44916097	44956088	TGM4	39991	0.467305
chr3	44956752	45017674	ZDHHC3	60922	0.472621
chr3	45017740	45052962	EXOSC7	35222	0.450627
chr3	45067758	45077563	CLEC3B	9805	0.524936
chr3	45123768	45187914	CDCP1	64146	0.451875
chr3	45265955	45267814	TMEM158	1859	0.669177
chr3	45430074	45590328	LARS2	160254	0.421381
chr3	45524186	45551037	LARS2-AS1	26851	0.419053
chr3	45636322	45722755	LIMD1	86433	0.462532
chr3	45719656	45730374	LIMD1-AS1	10718	0.446445
chr3	45730753	45786900	SACM1L	56147	0.379094
chr3	45796940	45838035	SLC6A20	41095	0.479645
chr3	45864809	45883650	LZTFL1	18841	0.386232
chr3	45927995	45944667	CCR9	16672	0.439659
chr3	45959390	46037316	FYCO1	77926	0.470793
chr3	45984972	45989845	CXCR6	4873	0.441001
chr3	46058515	46062157	AX747832	3642	0.475014
chr3	46062290	46068979	XCR1	6689	0.429212
chr3	46283871	46308197	CCR3	24326	0.408246
chr3	46243199	46249832	CCR1	6633	0.466456
chr3	46395234	46402413	CCR2	7179	0.440730
chr3	46411632	46417697	CCR5	6065	0.429349
chr3	46448720	46451014	CCRL2	2294	0.461203
chr3	46477495	46506598	LTF	29103	0.470742
chr3	46539484	46542439	RTP3	2955	0.517428
chr3	46556877	46608040	LRRC2	51163	0.429998
chr3	46598887	46601178	LRRC2-AS1	2291	0.453950
chr3	46616044	46623952	TDGF1	7908	0.454350
chr3	46653924	46668033	LOC100132146	14109	0.424126
chr3	46710484	46735194	ALS2CL	24710	0.579401
chr3	46742822	46752413	TMIE	9591	0.585966
chr3	46742822	46752201	TMIE	9379	0.587163
chr3	46753605	46759796	PRSS50	6191	0.594896
chr3	46761072	46777921	PRSS46	16849	0.430767
chr3	46783580	46786280	PRSS45	2700	0.574074
chr3	46871893	46875585	PRSS42	3692	0.513543
chr3	46899356	46904973	MYL3	5617	0.570589
chr3	46923738	46945289	PTH1R	21551	0.578395
chr3	46963219	47023500	CCDC12	60281	0.514424
chr3	47021172	47051194	NBEAL2	30022	0.598994
chr3	47053031	47054957	NRADDP	1926	0.540498
chr3	47057897	47205467	SETD2	147570	0.402331
chr3	47205859	47285606	KIF9-AS1	79747	0.443327
chr3	47269515	47324337	KIF9	54822	0.482781
chr3	47324329	47388306	KLHL18	63977	0.449083
chr3	47422490	47454931	PTPN23	32441	0.515336
chr3	47455183	47517445	SCAP	62262	0.478847
chr3	47455557	47457107	BC067356	1550	0.570323
chr3	47537129	47555199	ELP6	18070	0.486829
chr3	47603727	47620359	CSPG5	16632	0.504570
chr3	47627377	47823405	SMARCC1	196028	0.415670
chr3	47844398	47891686	DHX30	47288	0.500275
chr3	47891044	47891119	MIR1226	75	0.640000
chr3	47892179	48130769	MAP4	238590	0.434356
chr3	48198667	48229801	CDC25A	31134	0.449830
chr3	48238053	48238106	MIR4443	53	0.566038
chr3	48264836	48266981	CAMP	2145	0.558042
chr3	48282595	48312479	ZNF589	29884	0.451211
chr3	48335588	48342848	NME6	7260	0.477410
chr3	48348335	48369831	SPINK8	21496	0.399795
chr3	48413708	48436190	FBXW12	22482	0.413575
chr3	48445260	48470872	PLXNB1	25612	0.594487
chr3	48473579	48481529	CCDC51	7950	0.513962
chr3	48481685	48485537	TMA7	3852	0.478453
chr3	48488113	48507708	ATRIP	19595	0.479969
chr3	48506918	48509044	TREX1	2126	0.623236
chr3	48509196	48514941	SHISA5	5745	0.554569
chr3	48509196	48541682	SHISA5	32486	0.506095
chr3	48510063	48514742	SHISA5	4679	0.550972
chr3	48555116	48594227	PFKFB4	39111	0.511723
chr3	48599150	48601201	UCN2	2051	0.580205
chr3	48601505	48632593	COL7A1	31088	0.600971
chr3	48636431	48647098	UQCRC1	10667	0.530983
chr3	48658274	48659189	TMEM89	915	0.628415
chr3	48662830	48709981	CELSR3	47151	0.578015
chr3	48711277	48723334	NCKIPSD	12057	0.561168
chr3	48725435	48754920	IP6K2	29485	0.467221
chr3	48788092	48885270	PRKAR2A	97178	0.434100
chr3	48885389	48889414	AK127190	4025	0.515280
chr3	48894355	48936426	SLC25A20	42071	0.473961
chr3	48955220	48956818	ARIH2OS	1598	0.614518
chr3	48956280	49022971	ARIH2	66691	0.444033
chr3	49027340	49044581	P4HTM	17241	0.545502
chr3	49044636	49053386	WDR6	8750	0.562057
chr3	49052920	49056041	DALRD3	3121	0.591157
chr3	49057580	49057667	MIR425	87	0.574713
chr3	49059073	49060926	NDUFAF3	1853	0.627631
chr3	49058050	49058142	MIR191	92	0.597826
chr3	49061761	49066875	IMPDH2	5114	0.534415
chr3	49067141	49131504	QRICH1	64363	0.460078
chr3	49133364	49142562	QARS	9198	0.534138
chr3	49146105	49158371	USP19	12266	0.561552
chr3	49158546	49170599	LAMB2	12053	0.573799
chr3	49190291	49191834	LAMB2P1	1543	0.543746
chr3	49199967	49203785	CCDC71	3818	0.564170
chr3	49209017	49213919	KLHDC8B	4902	0.581599
chr3	49215068	49229291	LOC646498	14223	0.498629
chr3	49236932	49295537	CCDC36	58605	0.456668
chr3	49306029	49314508	C3orf62	8479	0.474584
chr3	49311552	49311619	MIR4271	67	0.507463
chr3	49314576	49377536	USP4	62960	0.472093
chr3	49394608	49395791	GPX1	1183	0.622147
chr3	49396578	49449526	RHOA	52948	0.463681
chr3	49449638	49453909	TCTA	4271	0.532194
chr3	49454210	49460111	AMT	5901	0.543976
chr3	49459765	49466757	NICN1	6992	0.530034
chr3	49507564	49573051	DAG1	65487	0.472872
chr3	49586738	49591799	BSN-AS2	5061	0.509978
chr3	49591921	49708982	BSN	117061	0.488130
chr3	49711434	49720934	APEH	9500	0.581368
chr3	49721379	49726196	MST1	4817	0.606809
chr3	49726949	49758962	RNF123	32013	0.564115
chr3	49754266	49757238	AMIGO3	2972	0.637954
chr3	49758931	49761384	GMPPB	2453	0.610273
chr3	49761727	49823973	IP6K1	62246	0.448141
chr3	49828166	49837254	CDHR4	9088	0.550176
chr3	49840686	49842463	FAM212A	1777	0.646033
chr3	49842637	49851391	UBA7	8754	0.580877
chr3	49866027	49893992	TRAIP	27965	0.498230
chr3	49895421	49907369	CAMKV	11948	0.558504
chr3	49924435	49941306	MST1R	16871	0.558355
chr3	49946301	49967445	MON1A	21144	0.511351
chr3	49977476	50114685	RBM6	137209	0.435139
chr3	50126340	50156397	RBM5	30057	0.444389
chr3	50137035	50138421	LUST	1386	0.411977
chr3	50153454	50193518	AK125500	40064	0.563374
chr3	50192847	50226508	SEMA3F	33661	0.574968
chr3	50229042	50235129	GNAT1	6087	0.589617
chr3	50242691	50258406	SLC38A3	15715	0.583837
chr3	50273646	50296786	GNAI2	23140	0.577528
chr3	50297734	50300789	BC033528	3055	0.584943
chr3	50305039	50314572	SEMA3B	9533	0.607469
chr3	50316517	50325545	LSMEM2	9028	0.524369
chr3	50325162	50330026	IFRD2	4864	0.592722
chr3	50330258	50336320	HYAL3	6062	0.581491
chr3	50337319	50341032	HYAL1	3713	0.566658
chr3	50355220	50360281	HYAL2	5061	0.610354
chr3	50362340	50365668	TUSC2	3328	0.560697
chr3	50367216	50378367	RASSF1	11151	0.545063
chr3	50378510	50383956	AB209621	5446	0.584098
chr3	50378536	50383156	ZMYND10	4620	0.585281
chr3	50384918	50388486	NPRL2	3568	0.573711
chr3	50388296	50391496	CYB561D2	3200	0.547188
chr3	50392179	50396939	TMEM115	4760	0.573109
chr3	50400230	50540892	CACNA2D2	140662	0.564324
chr3	50595455	50605223	C3orf18	9768	0.563575
chr3	50595455	50608458	C3orf18	13003	0.559794
chr3	50606908	50622421	HEMK1	15513	0.550248
chr3	50643884	50649262	CISH	5378	0.569543
chr3	50654561	50686728	MAPKAPK3	32167	0.534865
chr3	50712510	50712594	MIR4787	84	0.797619
chr3	50712671	51421629	DOCK3	708958	0.401471
chr3	51422691	51426828	MANF	4137	0.511482
chr3	51428698	51435336	RBM15B	6638	0.559355
chr3	51433297	51534018	VPRBP	100721	0.433415
chr3	51575595	51697612	RAD54L2	122017	0.442979
chr3	51705289	51738339	TEX264	33050	0.550469
chr3	51741080	51752625	GRM2	11545	0.558337
chr3	51812576	51813203	IQCF6	627	0.567783
chr3	51928891	51937386	IQCF1	8495	0.441672
chr3	51851618	51853651	IQCF4	2033	0.490900
chr3	51860898	51864874	IQCF3	3976	0.433350
chr3	51895644	51897440	IQCF2	1796	0.471604
chr3	51907736	51909600	IQCF5	1864	0.516631
chr3	51967441	51975957	RRP9	8516	0.551433
chr3	51976360	51982883	PARP3	6523	0.591906
chr3	51989329	51991520	GPR62	2191	0.657234
chr3	51991469	52001482	PCBP4	10013	0.594727
chr3	52002525	52008646	ABHD14B	6121	0.554158
chr3	52017299	52023218	ACY1	5919	0.574759
chr3	52009041	52015216	ABHD14A	6175	0.541538
chr3	52027643	52029958	RPL29	2315	0.539093
chr3	52082936	52090461	DUSP7	7525	0.590033
chr3	52096109	52099128	LINC00696	3019	0.575025
chr3	52109248	52188706	POC1A	79458	0.516650
chr3	52232098	52248343	ALAS1	16245	0.454786
chr3	52255095	52265247	TLR9	10152	0.601261
chr3	52273279	52275113	BC039681	1834	0.544166
chr3	52279808	52284615	PPM1M	4807	0.581444
chr3	52288437	52312659	WDR82	24222	0.439477
chr3	52302293	52302377	MIRLET7G	84	0.500000
chr3	52321835	52329272	GLYCTK	7437	0.570257
chr3	52328234	52328324	MIR135A1	90	0.522222
chr3	52350334	52434513	DNAH1	84179	0.552466
chr3	52435019	52444121	BAP1	9102	0.559328
chr3	52444526	52457657	PHF7	13131	0.454573
chr3	52467267	52479043	SEMA3G	11776	0.598081
chr3	52485106	52488057	TNNC1	2951	0.595391
chr3	52489523	52527088	NISCH	37565	0.531745
chr3	52529355	52558511	STAB1	29156	0.606462
chr3	52558384	52567793	NT5DC2	9409	0.604209
chr3	52570620	52574586	SMIM4	3966	0.499748
chr3	52579367	52713739	PBRM1	134372	0.407205
chr3	52594585	52594723	U6atac	138	0.456522
chr3	52719935	52728510	GNL3	8575	0.431603
chr3	52723255	52723331	SNORD19	76	0.460526
chr3	52724753	52724846	SNORD19B	93	0.311828
chr3	52726751	52726828	SNORD69	77	0.415584
chr3	52728503	52737714	GLT8D1	9211	0.416893
chr3	52739856	52742197	SPCS1	2341	0.496369
chr3	52744795	52804965	NEK4	60170	0.427987
chr3	52811601	52826084	ITIH1	14483	0.549265
chr3	52828783	52843025	ITIH3	14242	0.557155
chr3	52844727	52846754	AX746575	2027	0.531820
chr3	52847005	52864717	ITIH4	17712	0.556911
chr3	52867130	52931597	TMEM110-MUSTN1	64467	0.487784
chr3	52937582	53080089	SFMBT1	142507	0.405349
chr3	53122500	53164470	RFT1	41970	0.457684
chr3	53195222	53226733	PRKCD	31511	0.563454
chr3	53259652	53290130	TKT	30478	0.543540
chr3	53317444	53381654	DCP1A	64210	0.411883
chr3	53421739	53421863	SNORA26	124	0.362903
chr3	53529075	53846492	CACNA1D	317417	0.447868
chr3	53850323	53880420	CHDH	30097	0.497093
chr3	53880576	53899827	IL17RB	19251	0.454106
chr3	53901093	53916229	ACTR8	15136	0.421115
chr3	53919225	53925989	SELK	6764	0.403755
chr3	54100701	54101014	7SK	313	0.428115
chr3	54156692	55108584	CACNA2D3	951892	0.421786
chr3	54666150	54673884	ESRG	7734	0.463667
chr3	54908631	54935282	CACNA2D3-AS1	26651	0.437432
chr3	54952380	54962072	LRTM1	9692	0.433450
chr3	55499742	55515426	WNT5A	15684	0.427697
chr3	55542335	56502391	ERC2	960056	0.406770
chr3	55691242	55693497	ERC2-IT1	2255	0.464302
chr3	55886519	55886622	MIR3938	103	0.359223
chr3	56591183	56655848	CCDC66	64665	0.398005
chr3	56654159	56717135	FAM208A	62976	0.386322
chr3	56761445	57113336	ARHGEF3	351891	0.436141
chr3	56974067	56994880	ARHGEF3-AS1	20813	0.428386
chr3	57094468	57109460	SPATA12	14992	0.454376
chr3	57124009	57199403	IL17RD	75394	0.447502
chr3	57231943	57234280	HESX1	2337	0.377407
chr3	57261764	57307498	APPL1	45734	0.373770
chr3	57310555	57326132	ASB14	15577	0.399371
chr3	57327726	57530071	DNAH12	202345	0.390916
chr3	57541980	57547768	PDE12	5788	0.438148
chr3	57557089	57583215	ARF4	26126	0.413726
chr3	57611180	57678816	DENND6A	67636	0.397244
chr3	57743173	57914894	SLMAP	171721	0.387320
chr3	57994126	58157982	FLNB	163856	0.466056
chr3	58148275	58156345	BC041347	8070	0.503841
chr3	58178352	58196730	DNASE1L3	18378	0.470236
chr3	58223258	58280461	ABHD6	57203	0.451462
chr3	58291971	58305920	RPP14	13949	0.448204
chr3	58291971	58305920	RPP14	13949	0.448204
chr3	58318616	58410878	PXK	92262	0.437049
chr3	58413356	58419579	PDHB	6223	0.435160
chr3	58477822	58488087	KCTD6	10265	0.408475
chr3	58490862	58522929	ACOX2	32067	0.471856
chr3	58549844	58563491	FAM107A	13647	0.495713
chr3	58619669	58652561	FAM3D	32892	0.510823
chr3	58727736	59035715	C3orf67	307979	0.384377
chr3	58810196	59004819	AK090895	194623	0.383809
chr3	59735035	61237133	FHIT	1502098	0.389105
chr3	59956575	59958982	NPCR	2407	0.429165
chr3	60842060	60842277	U3	217	0.428571
chr3	61547242	62280573	PTPRG	733331	0.408168
chr3	62247493	62304622	PTPRG-AS1	57129	0.362338
chr3	62305395	62319320	C3orf14	13925	0.350592
chr3	62355346	62359190	FEZF2	3844	0.581946
chr3	62384020	62861064	CADPS	477044	0.399963
chr3	62936132	63110737	LINC00698	174605	0.390161
chr3	63263913	63602597	SYNPR	338684	0.386788
chr3	63409271	63535727	SYNPR-AS1	126456	0.388950
chr3	63638343	63650891	SNTN	12548	0.399665
chr3	63805040	63834312	C3orf49	29272	0.382072
chr3	63819545	63849597	THOC7	30052	0.399275
chr3	63884074	63989136	ATXN7	105062	0.412242
chr3	63989697	63997917	PSMD6-AS2	8220	0.386253
chr3	63996224	64009282	PSMD6	13058	0.390489
chr3	64053639	64088807	PRICKLE2-AS1	35168	0.419330
chr3	64064036	64073039	LOC100287879	9003	0.428635
chr3	64079525	64211131	PRICKLE2	131606	0.422914
chr3	64089145	64092034	PRICKLE2-AS2	2889	0.433714
chr3	64173219	64187236	PRICKLE2-AS3	14017	0.413926
chr3	64501330	64673365	ADAMTS9	172035	0.400337
chr3	64547386	64574862	AK125532	27476	0.392634
chr3	64573030	64575760	BC071789	2730	0.371062
chr3	64670545	64997143	ADAMTS9-AS2	326598	0.399289
chr3	64705682	64941858	MIR548A2	236176	0.400125
chr3	65339905	66024509	MAGI1	684604	0.403034
chr3	65879490	65910972	MAGI1-AS1	31482	0.406645
chr3	66119284	66429351	SLC25A26	310067	0.269474
chr3	66429220	66550845	LRIG1	121625	0.458573
chr3	67048726	67061632	KBTBD8	12906	0.367039
chr3	67275887	67275951	MIR4272	64	0.296875
chr3	67425140	67705038	SUCLG2	279898	0.394826
chr3	67705120	67998136	AL832184	293016	0.383153
chr3	68040733	68594771	FAM19A1	554038	0.381355
chr3	68055132	68057522	AX747367	2390	0.482845
chr3	68780914	68981761	FAM19A4	200847	0.395794
chr3	69024367	69062774	EOGT	38407	0.415393
chr3	69068977	69101484	TMF1	32507	0.365952
chr3	69098108	69098186	MIR3136	78	0.384615
chr3	69103880	69129524	UBA3	25644	0.369989
chr3	69134089	69155239	ARL6IP5	21150	0.424775
chr3	69156038	69171746	LMOD3	15708	0.405017
chr3	69219145	69435430	FRMD4B	216285	0.416215
chr3	69788585	70017488	MITF	228903	0.385696
chr3	70048894	70064451	BC015590	15557	0.384843
chr3	71003864	71180092	FOXP1	176228	0.400549
chr3	71338919	71355005	BC040624	16086	0.385242
chr3	71591120	71591240	MIR1284	120	0.300000
chr3	71619435	71623608	AK025793	4173	0.368799
chr3	71728439	71774526	EIF4E3	46087	0.420531
chr3	71803200	71804328	GPR27	1128	0.737589
chr3	71820805	71834357	PROK2	13552	0.393743
chr3	72084669	72149578	AK097190	64909	0.449583
chr3	72200407	72223490	LINC00870	23083	0.469826
chr3	72423743	72495774	RYBP	72031	0.380461
chr3	72798427	72897598	SHQ1	99171	0.391677
chr3	72937384	73024522	GXYLT2	87138	0.431304
chr3	73046118	73115011	PPP4R2	68893	0.391230
chr3	73110809	73112471	EBLN2	1662	0.421781
chr3	73431651	73674072	PDZRN3	242421	0.415084
chr3	74311721	74570343	CNTN3	258622	0.369006
chr3	75263626	75263699	MIR4444-1	73	0.589041
chr3	75469026	75469052	DQ584669	26	0.538462
chr3	75470702	75484266	FAM86DP	13564	0.527942
chr3	75679913	75680009	MIR1324	96	0.572917
chr3	75713480	75716368	FLJ20518	2888	0.443560
chr3	75721431	75728454	LOC401074	7023	0.410366
chr3	75786028	75834255	ZNF717	48227	0.419993
chr3	75787430	75787514	MIR4273	84	0.452381
chr3	77089293	77699114	ROBO2	609821	0.357366
chr3	77141207	77141314	U6	107	0.401869
chr3	78646387	79817059	ROBO1	1170672	0.351013
chr3	81538849	81810950	GBE1	272101	0.352766
chr3	81558626	81558815	U2	189	0.333333
chr3	82035288	82512826	BC031255	477538	0.357546
chr3	84687555	84918726	LOC440970	231171	0.355447
chr3	85008132	86123579	CADM2	1115447	0.340048
chr3	85434859	85434942	MIR5688	83	0.325301
chr3	85849136	85877200	CADM2-AS2	28064	0.357326
chr3	86987122	87040257	VGLL3	53135	0.362962
chr3	87138429	87147852	BC050344	9423	0.403481
chr3	87275338	87275427	MIR4795	89	0.292135
chr3	87276412	87304698	CHMP2B	28286	0.347805
chr3	87308782	87325737	POU1F1	16955	0.323680
chr3	87959369	87959495	U6atac	126	0.420635
chr3	88031725	88042919	HTR1F	11194	0.355190
chr3	88101099	88108146	CGGBP1	7047	0.372641
chr3	88188261	88193814	ZNF654	5553	0.335314
chr3	88198892	88207115	C3orf38	8223	0.390247
chr3	89156673	89531284	EPHA3	374611	0.345999
chr3	90079433	90079645	U3	212	0.429245
chr3	93562607	93562706	U6	99	0.353535
chr3	93591880	93692934	PROS1	101054	0.388565
chr3	93698982	93774522	ARL13B	75540	0.362007
chr3	93733214	93747454	STX19	14240	0.351053
chr3	93776765	93782067	DHFRL1	5302	0.407016
chr3	93781854	93845630	NSUN3	63776	0.380315
chr3	93817350	93817410	U7	60	0.400000
chr3	94657106	94895083	LINC00879	237977	0.344407
chr3	95373266	95402037	LOC100287639	28771	0.348823
chr3	96533424	97467786	EPHA6	934362	0.354211
chr3	97483594	97517373	ARL6	33779	0.343823
chr3	97540883	97663830	CRYBG3	122947	0.371079
chr3	97660660	97691295	MINA	30635	0.415342
chr3	97716287	97754148	GABRR3	37861	0.377222
chr3	97806016	97806946	OR5AC2	930	0.396774
chr3	97851541	97852483	OR5H1	942	0.376858
chr3	97868229	97869162	OR5H14	933	0.377278
chr3	97887543	97888485	OR5H15	942	0.373673
chr3	97983128	97984106	OR5H6	978	0.375256
chr3	98001731	98002676	OR5H2	945	0.369312
chr3	98072697	98073663	OR5K4	966	0.383023
chr3	98109509	98110475	OR5K3	966	0.373706
chr3	98188420	98189372	OR5K1	952	0.389706
chr3	98216524	98217475	OR5K2	951	0.392219
chr3	98234316	98241910	CLDND1	7594	0.391493
chr3	98250742	98251994	GPR15	1252	0.468051
chr3	98298289	98312455	CPOX	14166	0.402866
chr3	98433176	98451495	ST3GAL6-AS1	18319	0.411758
chr3	98451547	98514689	ST3GAL6	63142	0.395173
chr3	98514813	98620533	DCBLD2	105720	0.385859
chr3	99273152	99717059	MIR548G	443907	0.387146
chr3	99357439	99515577	COL8A1	158138	0.384803
chr3	99536677	99897476	CMSS1	360799	0.387180
chr3	99551987	99833349	FILIP1L	281362	0.385166
chr3	99652068	99654107	AF090939	2039	0.377636
chr3	99683157	99683242	MIR3921	85	0.470588
chr3	99904667	99913030	TMEM30C	8363	0.428554
chr3	99979660	100044096	TBC1D23	64436	0.365277
chr3	100053561	100074478	NIT2	20917	0.437969
chr3	100082302	100120242	TOMM70A	37940	0.386215
chr3	100120036	100175170	LNP1	55134	0.393151
chr3	100211462	100296285	TMEM45A	84823	0.400139
chr3	100328432	100414323	GPR128	85891	0.380214
chr3	100428385	100467811	TFG	39426	0.362629
chr3	100468178	100712334	ABI3BP	244156	0.370259
chr3	100671470	100671577	U6	107	0.420561
chr3	100941389	101039419	IMPG2	98030	0.376038
chr3	101043117	101232085	SENP7	188968	0.375646
chr3	101237710	101242731	FAM172BP	5021	0.413663
chr3	101280679	101285290	TRMT10C	4611	0.414010
chr3	101293041	101313281	PCNP	20240	0.396937
chr3	101368282	101395988	ZBTB11	27706	0.402440
chr3	101395273	101398057	ZBTB11-AS1	2784	0.525503
chr3	101399933	101405563	RPL24	5630	0.423446
chr3	101431277	101432260	PDCL3P4	983	0.413021
chr3	101443493	101486181	CEP97	42688	0.410701
chr3	101498028	101547075	NXPE3	49047	0.395886
chr3	101568357	101579869	NFKBIZ	11512	0.407140
chr3	101659702	101716770	LOC152225	57068	0.383560
chr3	102153858	102198685	ZPLD1	44827	0.356437
chr3	102669695	102669715	DD413615	20	0.250000
chr3	103646038	103730578	BC070396	84540	0.340253
chr3	103903475	103946105	MIR548A3	42630	0.342083
chr3	105085556	105295757	ALCAM	210201	0.353200
chr3	105377108	105587887	CBLB	210779	0.353512
chr3	106555657	106959485	LINC00882	403828	0.378102
chr3	106726414	106726517	U6	103	0.339806
chr3	106959538	106967719	LINC00883	8181	0.395428
chr3	106967787	106970300	AX747913	2513	0.446080
chr3	107096187	107097481	CCDC54	1294	0.394900
chr3	107149776	107182759	BC042024	32983	0.397902
chr3	107241782	107530176	BBX	288394	0.369508
chr3	107560508	107596915	LINC00635	36407	0.396957
chr3	107602051	107647753	LINC00636	45702	0.399282
chr3	107761940	107809935	CD47	47995	0.368893
chr3	107879658	107941417	IFT57	61759	0.352855
chr3	108021331	108097126	HHLA2	75795	0.391226
chr3	108099215	108248169	MYH15	148954	0.388704
chr3	108268717	108308491	KIAA1524	39774	0.341555
chr3	108308336	108413693	DZIP3	105357	0.357565
chr3	108474485	108476130	RETNLB	1645	0.484498
chr3	108541630	108573714	TRAT1	32084	0.364418
chr3	108626641	108672677	GUCA1C	46036	0.390542
chr3	108677086	108836993	MORC1	159907	0.375606
chr3	108855560	108868951	FLJ22763	13391	0.375252
chr3	108897011	108904108	LINC00488	7097	0.405383
chr3	109012634	109035364	DPPA2	22730	0.438891
chr3	109044987	109056419	DPPA4	11432	0.438506
chr3	109128836	109214014	FLJ25363	85178	0.383151
chr3	110270691	110270812	U6atac	121	0.471074
chr3	110359088	110359163	TRNA	75	0.413333
chr3	110610986	110612323	LOC151760	1337	0.486911
chr3	110764162	110788806	PVRL3-AS1	24644	0.380093
chr3	110790605	110856407	PVRL3	65802	0.353667
chr3	111260925	111371206	CD96	110281	0.390539
chr3	111311746	111314182	ZBED2	2436	0.474138
chr3	111393522	111565294	PLCXD2	171772	0.393708
chr3	111442569	111445740	AX747104	3171	0.379060
chr3	111578567	111695364	PHLDB2	116797	0.383161
chr3	111697722	111712215	ABHD10	14493	0.360312
chr3	111718006	111732735	TAGLN3	14729	0.454206
chr3	111758464	111800116	TMPRSS7	41652	0.399044
chr3	111805181	111837073	C3orf52	31892	0.427537
chr3	111831647	111831745	MIR567	98	0.316327
chr3	111839687	111852152	GCSAM	12465	0.408584
chr3	111859751	112013074	SLC9C1	153323	0.372345
chr3	112021324	112051598	BC041484	30274	0.369888
chr3	112051915	112081658	CD200	29743	0.384763
chr3	112182812	112218408	BTLA	35596	0.384678
chr3	112251358	112280485	ATG3	29127	0.358293
chr3	112280856	112303284	SLC35A5	22428	0.379213
chr3	112323408	112359977	CCDC80	36569	0.397960
chr3	112534555	112564797	CD200R1L	30242	0.396964
chr3	112641531	112693937	CD200R1	52406	0.359405
chr3	112709799	112720221	GTPBP8	10422	0.369315
chr3	112721291	112738555	C3orf17	17264	0.388033
chr3	112931374	113006305	BOC	74931	0.467030
chr3	113005776	113160361	WDR52	154585	0.384649
chr3	113122844	113152839	WDR52-AS1	29995	0.369528
chr3	113161564	113234034	SPICE1	72470	0.380240
chr3	113251217	113348422	SIDT1	97205	0.407891
chr3	113313722	113313789	MIR4446	67	0.537313
chr3	113367232	113415493	KIAA2018	48261	0.406125
chr3	113435306	113465120	NAA50	29814	0.373684
chr3	113465865	113530905	ATP6V1A	65040	0.382196
chr3	113557680	113666021	GRAMD1C	108341	0.393120
chr3	113666747	113681827	ZDHHC23	15080	0.443899
chr3	113682983	113775460	KIAA1407	92477	0.380646
chr3	113775581	113807268	QTRTD1	31687	0.397324
chr3	113847556	113897899	DRD3	50343	0.424369
chr3	113933237	113955051	AX747798	21814	0.425094
chr3	113953479	113956425	ZNF80	2946	0.418534
chr3	114012153	114029135	TIGIT	16982	0.429572
chr3	114035321	114035416	MIR568	95	0.242105
chr3	114056946	114102489	ZBTB20	45543	0.401818
chr3	114070657	114107825	ZBTB20-AS1	37168	0.397385
chr3	114462291	114462372	MIR4796	81	0.345679
chr3	115342150	115440334	GAP43	98184	0.386081
chr3	115521209	116164385	LSAMP	643176	0.374089
chr3	116428634	116435887	TUSC7	7253	0.361368
chr3	116640277	116651083	BC040587	10806	0.401629
chr3	116746374	116746400	JB175279	26	0.346154
chr3	118227372	118529680	EU250752	302308	0.390522
chr3	118619478	118753676	IGSF11	134198	0.378068
chr3	118661922	118667088	IGSF11-AS1	5166	0.355014
chr3	118864996	118870302	C3orf30	5306	0.384093
chr3	118892424	118924000	UPK1B	31576	0.418577
chr3	118930588	118959752	B4GALT4	29164	0.415752
chr3	119013219	119138323	ARHGAP31	125104	0.434598
chr3	119147806	119182529	TMEM39A	34723	0.387726
chr3	119187784	119213554	POGLUT1	25770	0.411797
chr3	119217367	119243125	TIMMDC1	25758	0.385084
chr3	119243139	119278481	CD80	35342	0.424000
chr3	119298522	119308792	ADPRH	10270	0.457254
chr3	119316694	119348658	PLA1A	31964	0.452009
chr3	119360907	119396243	POPDC2	35336	0.423732
chr3	119360907	119379404	POPDC2	18497	0.442775
chr3	119388371	119396243	COX17	7872	0.403836
chr3	119389610	119391185	AK095366	1575	0.358095
chr3	119421868	119485949	MAATS1	64081	0.382251
chr3	119501556	119537332	NR1I2	35776	0.463020
chr3	119540801	119582452	GSK3B	41651	0.374373
chr3	119540801	119813264	GSK3B	272463	0.371434
chr3	119813741	119855630	BC035247	41889	0.416219
chr3	119884327	119963325	GPR156	78998	0.414732
chr3	120043575	120068186	LRRC58	24611	0.390069
chr3	120113060	120169918	FSTL1	56858	0.440026
chr3	120315127	120321258	NDUFB4	6131	0.394552
chr3	120347014	120401418	HGD	54404	0.412709
chr3	120405527	120461384	RABL3	55857	0.377929
chr3	120461557	120501916	GTF2E1	40359	0.380113
chr3	120552286	120555204	BC032918	2918	0.400617
chr3	120627049	121143608	STXBP5L	516559	0.363422
chr3	121150272	121264853	POLQ	114581	0.390309
chr3	121286777	121309469	ARGFX	22692	0.413626
chr3	121312169	121349139	FBXO40	36970	0.439627
chr3	121350245	121379791	HCLS1	29546	0.414506
chr3	121382045	121468614	GOLGB1	86569	0.380714
chr3	121488609	121553926	IQCB1	65317	0.365234
chr3	121554033	121605373	EAF2	51340	0.361395
chr3	121613170	121663034	SLC15A2	49864	0.399547
chr3	121706169	121741127	ILDR1	34958	0.441844
chr3	121774208	121839988	CD86	65780	0.407677
chr3	121903180	122005344	CASR	102164	0.408843
chr3	121964612	121964684	SNORD112	72	0.388889
chr3	122044010	122060815	CSTA	16805	0.418090
chr3	122078435	122102074	CCDC58	23639	0.391514
chr3	122103022	122128961	FAM162A	25939	0.387910
chr3	122130699	122134882	WDR5B	4183	0.398040
chr3	122140747	122233786	KPNA1	93039	0.382614
chr3	122246759	122283523	PARP9	36764	0.425389
chr3	122283184	122294049	DTX3L	10865	0.442246
chr3	122296448	122355536	PARP15	59088	0.405632
chr3	122399671	122449687	PARP14	50016	0.408789
chr3	122458843	122512666	HSPBAP1	53823	0.399718
chr3	122513900	122599986	DIRC2	86086	0.380503
chr3	122597947	122600320	BC042374	2373	0.402444
chr3	122605359	122611263	LOC100129550	5904	0.436314
chr3	122628039	122694981	SEMA5B	66942	0.502196
chr3	122785855	122880953	PDIA5	95098	0.490168
chr3	122920773	122992982	SEC22A	72209	0.377155
chr3	123001142	123167392	ADCY5	166250	0.510965
chr3	123213362	123303924	PTPLB	90562	0.405479
chr3	123304402	123349666	MYLK-AS1	45264	0.423648
chr3	123331142	123603149	MYLK	272007	0.453948
chr3	123632273	123680255	CCDC14	47982	0.355487
chr3	123687878	123710199	ROPN1	22321	0.419470
chr3	123752541	123883533	KALRN	130992	0.429583
chr3	123813557	124440036	KALRN	626479	0.426875
chr3	123851775	123851872	MIR5002	97	0.484536
chr3	124449212	124468119	UMPS	18907	0.428095
chr3	124481794	124606144	ITGB5	124350	0.467575
chr3	124624288	124653595	MUC13	29307	0.436415
chr3	124684553	124774802	HEG1	90249	0.449767
chr3	124801479	124931609	SLC12A8	130130	0.452432
chr3	124870308	124870396	MIR5092	88	0.522727
chr3	124944512	125094198	ZNF148	149686	0.368678
chr3	125165487	125239058	SNX4	73571	0.400960
chr3	125247701	125314381	OSBPL11	66680	0.393896
chr3	125509246	125509395	MIR548I1	149	0.389262
chr3	125635443	125648867	FAM86JP	13424	0.530766
chr3	125648117	125655887	ALG1L	7770	0.519176
chr3	125688027	125702296	ROPN1B	14269	0.434298
chr3	125725199	125803134	SLC41A3	77935	0.469455
chr3	125822403	125900029	ALDH1L1	77626	0.483858
chr3	125822482	125826912	ALDH1L1-AS1	4430	0.579233
chr3	125898907	125929011	ALDH1L1-AS2	30104	0.446452
chr3	126061477	126076236	KLF15	14759	0.577681
chr3	126111877	126113604	BC033989	1727	0.504343
chr3	126113781	126155398	CCDC37	41617	0.508855
chr3	126156443	126194762	ZXDC	38319	0.486834
chr3	126167059	126169613	UNQ2790	2554	0.543853
chr3	126200007	126236616	UROC1	36609	0.543446
chr3	126243130	126262134	CHST13	19004	0.543833
chr3	126268518	126277758	C3orf22	9240	0.581277
chr3	126290621	126327476	TXNRD3NB	36855	0.418424
chr3	126325894	126373967	TXNRD3	48073	0.394899
chr3	126380923	126390782	NUP210P1	9859	0.514454
chr3	126423062	126679263	CHCHD6	256201	0.462449
chr3	126707436	126756235	PLXNA1	48799	0.617533
chr3	126911973	126917025	C3orf56	5052	0.531275
chr3	127041149	127109513	BC015846	68364	0.476333
chr3	127199532	127255803	BX537548	56271	0.453395
chr3	127291906	127309602	TPRA1	17696	0.560353
chr3	127317199	127341278	MCM2	24079	0.505876
chr3	127348001	127391653	PODXL2	43652	0.486599
chr3	127391780	127399769	ABTB1	7989	0.603580
chr3	127407904	127542093	MGLL	134189	0.493178
chr3	127641901	127706514	KBTBD12	64613	0.389767
chr3	127771211	127790526	SEC61A1	19315	0.466425
chr3	127799799	127842671	RUVBL1	42872	0.447355
chr3	127872312	128127489	EEFSEC	255177	0.478730
chr3	128181274	128186091	DNAJB8	4817	0.551381
chr3	128182436	128191160	DNAJB8-AS1	8724	0.550321
chr3	128198264	128212030	GATA2	13766	0.604606
chr3	128226677	128229429	LOC90246	2752	0.471657
chr3	128290842	128294929	C3orf27	4087	0.539760
chr3	128338812	128369719	RPN1	30907	0.457307
chr3	128433413	128433548	SNORA24	135	0.429630
chr3	128444978	128533641	RAB7A	88663	0.440556
chr3	128561599	128561627	DQ583119	28	0.500000
chr3	128566713	128566755	DQ598665	42	0.547619
chr3	128567926	128567957	DQ570601	31	0.612903
chr3	128568030	128568095	DQ579267	65	0.492308
chr3	128568311	128568344	DQ572301	33	0.393939
chr3	128571009	128571040	DQ576681	31	0.516129
chr3	128580350	128590384	LOC653712	10034	0.490433
chr3	128598332	128631957	ACAD9	33625	0.492164
chr3	128689781	128712986	KIAA1257	23205	0.461151
chr3	128651611	128690276	AK125726	38665	0.480719
chr3	128720471	128759585	EFCC1	39114	0.524850
chr3	128779644	128781253	GP9	1609	0.634556
chr3	128806411	128840647	RAB43	34236	0.501723
chr3	128806411	128880073	ISY1-RAB43	73662	0.482040
chr3	128886657	128902810	CNBP	16153	0.427289
chr3	128968452	128996616	COPG1	28164	0.481821
chr3	128997683	129024135	C3orf37	26452	0.442764
chr3	129033613	129035120	H1FX	1507	0.686131
chr3	129035113	129043412	H1FX-AS1	8299	0.562116
chr3	129101676	129118282	RPL32P3	16606	0.501505
chr3	129106259	129109437	BX641154	3178	0.487099
chr3	129116052	129116191	SNORA7B	139	0.568345
chr3	129120163	129147494	EFCAB12	27331	0.492225
chr3	129149786	129159022	MBD4	9236	0.398982
chr3	129158967	129239191	IFT122	80224	0.475519
chr3	129247481	129254187	RHO	6706	0.549806
chr3	129262056	129270204	H1FOO	8148	0.538905
chr3	129274055	129325582	PLXND1	51527	0.583442
chr3	129286896	129286931	U7	35	0.428571
chr3	129366634	129599402	TMCC1	232768	0.392837
chr3	129612713	129627755	LOC100507032	15042	0.424744
chr3	129693235	129696781	TRH	3546	0.603215
chr3	129800673	129817233	ALG1L2	16560	0.497403
chr3	129816624	129830276	FAM86HP	13652	0.530838
chr3	129931662	129992649	COL6A4P2	60987	0.392461
chr3	130064358	130203690	COL6A5	139332	0.387047
chr3	130279177	130395888	COL6A6	116711	0.392945
chr3	130397777	130465696	PIK3R4	67919	0.366775
chr3	130569368	130735555	ATP2C1	166187	0.375643
chr3	130732720	130745646	ASTE1	12926	0.388983
chr3	130745693	131069309	NEK11	323616	0.387067
chr3	131043935	131100319	LOC339874	56384	0.414621
chr3	131080688	131083966	NUDT16P1	3278	0.479561
chr3	131100608	131101641	NUDT16	1033	0.587609
chr3	131181044	131221860	MRPL3	40816	0.359614
chr3	131197841	131198077	SNORA58	236	0.381356
chr3	131253576	131754286	CPNE4	500710	0.388786
chr3	131704698	131704775	MIR5704	77	0.428571
chr3	132036210	132087146	ACPP	50936	0.403919
chr3	132136552	132257876	DNAJC13	121324	0.367454
chr3	132399452	132441303	NPHP3	41851	0.367948
chr3	132316093	132321382	CCRL1	5289	0.355833
chr3	132379139	132396944	UBA5	17805	0.354339
chr3	132441185	132593050	NPHP3-AS1	151865	0.389148
chr3	132757170	133116619	TMEM108	359449	0.402140
chr3	132965287	132975965	BC037929	10678	0.377224
chr3	133118789	133194056	BFSP2	75267	0.456136
chr3	133148129	133174620	BC007984	26491	0.437960
chr3	133292433	133309118	CDV3	16685	0.426311
chr3	133319448	133380737	TOPBP1	61289	0.376087
chr3	133464799	133497850	TF	33051	0.452059
chr3	133502876	133540336	SRPRB	37460	0.402589
chr3	133543079	133614691	RAB6B	71612	0.495922
chr3	133646989	133648656	C3orf36	1667	0.553689
chr3	133651539	133748920	SLCO2A1	97381	0.479488
chr3	133875977	133969586	RYK	93609	0.384418
chr3	134074189	134093406	AMOTL2	19217	0.546079
chr3	134156668	134156748	MIR4788	80	0.462500
chr3	134196545	134204863	ANAPC13	8318	0.435441
chr3	134205046	134283870	CEP63	78824	0.379187
chr3	134318764	134369864	KY	51100	0.482975
chr3	134499368	134499469	U6	101	0.396040
chr3	134514098	134979307	EPHB1	465209	0.448181
chr3	134666047	134666068	JB149101	21	0.285714
chr3	135684514	135866752	PPP2R3A	182238	0.390654
chr3	135867759	135914688	MSL2	46929	0.415543
chr3	135969166	136049013	PCCB	79847	0.418313
chr3	136055998	136471245	STAG1	415247	0.389351
chr3	136537860	136574734	SLC35G2	36874	0.411428
chr3	136581049	136667968	NCK1	86919	0.394977
chr3	136676706	136729926	IL20RB	53220	0.430271
chr3	136730687	136732150	AX746877	1463	0.447027
chr3	136734712	136735851	AX746877	1139	0.406497
chr3	137483133	137485172	SOX14	2039	0.567435
chr3	137493369	137499719	BC038725	6350	0.399213
chr3	137717657	137752494	CLDN18	34837	0.429141
chr3	137780826	137834451	DZIP1L	53625	0.456615
chr3	137842559	137851229	A4GNT	8670	0.426528
chr3	137879829	137893791	DBR1	13962	0.394213
chr3	137906114	138017228	ARMC8	111114	0.392759
chr3	137980278	138048728	NME9	68450	0.424529
chr3	138067507	138124377	MRAS	56870	0.482574
chr3	138153414	138197256	ESYT3	43842	0.495347
chr3	138213186	138313129	CEP70	99943	0.394815
chr3	138327541	138352213	FAIM	24672	0.403697
chr3	138371539	138478201	PIK3CB	106662	0.380773
chr3	138654030	138662862	AK128202	8832	0.538610
chr3	138663065	138665982	FOXL2	2917	0.646212
chr3	138666075	138672830	C3orf72	6755	0.516654
chr3	138666453	138669670	AK304483	3217	0.549580
chr3	138722803	138725110	PRR23A	2307	0.513221
chr3	138737872	138739768	PRR23B	1896	0.556435
chr3	138760943	138763734	PRR23C	2791	0.506987
chr3	138823026	138844005	BPESC1	20979	0.445207
chr3	138951833	138952364	PISRT1	531	0.414313
chr3	139062797	139075887	MRPS22	13090	0.402521
chr3	139076432	139108522	COPB2	32090	0.375195
chr3	139171725	139195352	RBP2	23627	0.447073
chr3	139236275	139258671	RBP1	22396	0.480086
chr3	139279022	139396885	NMNAT3	117863	0.416679
chr3	139654026	140286919	CLSTN2	632893	0.426823
chr3	140396865	140419992	TRIM42	23127	0.416872
chr3	140660661	140698785	SLC25A36	38124	0.354737
chr3	140770742	140867453	SPSB4	96711	0.468985
chr3	140950681	141013486	ACPL2	62805	0.460632
chr3	141043054	141168632	ZBTB38	125578	0.422893
chr3	141205925	141331197	RASA2	125272	0.364152
chr3	141457050	141465645	RNF7	8595	0.395928
chr3	141497042	141535892	GRK7	38850	0.454337
chr3	141595469	141645382	ATP1B3	49913	0.403121
chr3	141655548	141657389	AX748420	1841	0.556763
chr3	141663269	141868386	TFDP2	205117	0.398870
chr3	141876368	141944449	GK5	68081	0.387950
chr3	142025448	142166853	XRN1	141405	0.369640
chr3	142168076	142297668	ATR	129592	0.371404
chr3	142342265	142432505	PLS1	90240	0.376906
chr3	142443265	142526729	TRPC1	83464	0.354165
chr3	142536701	142608045	PCOLCE2	71344	0.408780
chr3	142645516	142661378	LOC100507389	15862	0.399382
chr3	142680073	142682178	PAQR9	2105	0.528266
chr3	142719686	142720309	LOC100289361	623	0.465490
chr3	142720371	142779567	U2SURP	59196	0.364264
chr3	142838617	142842856	CHST2	4239	0.576079
chr3	142984063	143567373	SLC9A9	583310	0.392750
chr3	143061087	143065913	SLC9A9-AS1	4826	0.368628
chr3	143690639	143711210	C3orf58	20571	0.376258
chr3	145787227	145879282	PLOD2	92055	0.360361
chr3	145910123	145968966	PLSCR4	58843	0.358038
chr3	146151074	146213778	PLSCR2	62704	0.376180
chr3	146232966	146262628	PLSCR1	29662	0.362990
chr3	146303624	146324003	PLSCR5	20379	0.327150
chr3	146936849	146937041	7SK	192	0.453125
chr3	147103834	147122071	ZIC4	18237	0.488677
chr3	147127180	147134506	ZIC1	7326	0.484712
chr3	147657791	147660801	AK098763	3010	0.359136
chr3	148415657	148460790	AGTR1	45133	0.373208
chr3	148545587	148577972	CPB1	32385	0.375482
chr3	148583042	148614872	CPA3	31830	0.370751
chr3	148709194	148745456	GYG1	36262	0.420275
chr3	148747903	148804341	HLTF	56438	0.359527
chr3	148804118	148820610	HLTF-AS1	16492	0.438819
chr3	148847370	148891305	HPS3	43935	0.387390
chr3	148890289	148939832	CP	49543	0.374483
chr3	149036284	149051259	TM4SF18	14975	0.374758
chr3	149086804	149095568	TM4SF1	8764	0.377910
chr3	149192367	149221181	TM4SF4	28814	0.416291
chr3	149235021	149375812	WWTR1	140791	0.410310
chr3	149243417	149243513	U6	96	0.406250
chr3	149374806	149376098	AK309441	1292	0.621517
chr3	149375996	149379149	WWTR1-AS1	3153	0.497938
chr3	149456256	149470286	COMMD2	14030	0.379116
chr3	149478889	149510610	ANKUB1	31721	0.397056
chr3	149530474	149679925	RNF13	149451	0.363939
chr3	149682690	149688741	PFN2	6051	0.424062
chr3	149689065	149691029	LOC646903	1964	0.415988
chr3	150126787	150177615	TSC22D2	50828	0.361474
chr3	150259779	150264964	SERP1	5185	0.421601
chr3	150264573	150303803	EIF2A	39230	0.375631
chr3	150284566	150320961	BC039424	36395	0.389861
chr3	150321065	150348234	SELT	27169	0.376385
chr3	150377674	150421742	FAM194A	44068	0.394322
chr3	150458909	150481263	SIAH2	22354	0.449718
chr3	150570270	150797617	CLRN1-AS1	227347	0.407201
chr3	150601486	150659548	CLRN1	58062	0.422721
chr3	150644353	150690786	CLRN1	46433	0.403355
chr3	150690464	150797617	CLRN1-AS1	107153	0.398001
chr3	150804584	151154465	MED12L	349881	0.386989
chr3	150915618	150920988	GPR171	5370	0.368156
chr3	150929904	150996230	P2RY14	66326	0.393224
chr3	151011875	151034636	GPR87	22761	0.398664
chr3	151044095	151047337	P2RY13	3242	0.375386
chr3	151055375	151058585	P2RY12	3210	0.345794
chr3	151153777	151176497	IGSF10	22720	0.403301
chr3	151283663	151283783	MIR5186	120	0.475000
chr3	151347319	151542394	MIR548H2	195075	0.370299
chr3	151451703	151475556	AADACL2	23853	0.356307
chr3	151488243	151502682	LOC201651	14439	0.339636
chr3	151531860	151546276	AADAC	14416	0.353011
chr3	151591430	151599876	SUCNR1	8446	0.340871
chr3	151980404	151987415	MBNL1-AS1	7011	0.420197
chr3	152017193	152183569	MBNL1	166376	0.356319
chr3	152057486	152058779	TMEM14E	1293	0.404486
chr3	152552735	152555843	P2RY1	3108	0.501930
chr3	152880028	152886263	RAP2B	6235	0.420369
chr3	153102722	153105157	AK092619	2435	0.367967
chr3	153202283	153220486	C3orf79	18203	0.362413
chr3	153742189	153838999	ARHGEF26-AS1	96810	0.379641
chr3	153838791	153975616	ARHGEF26	136825	0.389688
chr3	153993456	154042286	DHX36	48830	0.354106
chr3	154055460	154147504	GPR149	92044	0.367368
chr3	154797952	154901518	MME	103566	0.378049
chr3	154958733	154960798	BC037382	2065	0.375303
chr3	155008020	155011489	LOC100507537	3469	0.321418
chr3	155197670	155394105	PLCH1	196435	0.391463
chr3	155480400	155524055	C3orf33	43655	0.406758
chr3	155544300	155572248	SLC33A1	27948	0.398025
chr3	155588324	155655520	GMPS	67196	0.388848
chr3	155838336	156256927	KCNAB1	418591	0.401502
chr3	155933348	155945672	KCNAB1-AS2	12324	0.412772
chr3	156158945	156164694	KCNAB1-AS1	5749	0.411202
chr3	156257928	156272973	SSR3	15045	0.387238
chr3	156390959	156393502	TIPARP-AS1	2543	0.577664
chr3	156394452	156424557	TIPARP	30105	0.364690
chr3	156465131	156534851	LINC00886	69720	0.397088
chr3	156527059	156529810	PA2G4P4	2751	0.440931
chr3	156544095	156763918	LEKR1	219823	0.360058
chr3	156799455	156840791	LINC00880	41336	0.448423
chr3	156807669	156818924	LINC00881	11255	0.448689
chr3	156865585	156878482	CCNL1	12897	0.375359
chr3	156977531	157221136	VEPH1	243605	0.384873
chr3	157154579	157161417	PTX3	6838	0.427464
chr3	157261132	157287701	C3orf55	26569	0.363996
chr3	157261132	157319021	C3orf55	57889	0.381817
chr3	157648280	157648514	7SK	234	0.525641
chr3	157813799	157823952	SHOX2	10153	0.461735
chr3	157827840	158262624	RSRC1	434784	0.353907
chr3	158263008	158288855	AK097794	25847	0.400279
chr3	158288952	158324249	MLF1	35297	0.374933
chr3	158362316	158410360	GFM1	48044	0.368371
chr3	158384202	158390482	LXN	6280	0.372930
chr3	158414896	158450275	RARRES1	35379	0.438367
chr3	158458205	158461305	AY070437	3100	0.416452
chr3	158519714	158547508	MFSD1	27794	0.378391
chr3	158787040	159615155	IQCJ-SCHIP1	828115	0.390643
chr3	159000434	159000523	MIR3919	89	0.438202
chr3	159526204	159526359	U2	155	0.393548
chr3	159631188	159924879	AK097161	293691	0.428879
chr3	159706622	159713806	IL12A	7184	0.431236
chr3	159943422	159946000	C3orf80	2578	0.506982
chr3	159974773	160117320	IFT80	142547	0.364757
chr3	160117429	160152741	SMC4	35312	0.360982
chr3	160122375	160122473	MIR15B	98	0.367347
chr3	160122532	160122613	MIR16-2	81	0.370370
chr3	160122541	160122563	DM119508	22	0.454545
chr3	160153290	160167626	TRIM59	14336	0.386858
chr3	160190135	160190204	U7	69	0.376812
chr3	160212782	160283376	KPNA4	70594	0.372043
chr3	160232694	160233024	SCARNA7	330	0.372727
chr3	160285456	160287034	BC125159	1578	0.551331
chr3	160394947	160396235	ARL14	1288	0.387422
chr3	160473995	160788817	PPM1L	314822	0.384255
chr3	160792440	160796689	AK055323	4249	0.351612
chr3	160801670	160822683	B3GALNT1	21013	0.394946
chr3	160939098	160969795	NMD3	30697	0.356680
chr3	161062579	161089871	SPTSSB	27292	0.370805
chr3	161144214	161166030	LOC101243545	21816	0.385084
chr3	161214595	161221730	OTOL1	7135	0.391310
chr3	162442526	162949936	BC073807	507410	0.342650
chr3	162895030	163021089	CT64	126059	0.335327
chr3	164696685	164796283	SI	99598	0.312567
chr3	164904507	164914469	SLITRK3	9962	0.448906
chr3	165490691	165555253	BCHE	64562	0.322945
chr3	166387816	166387910	7SK	94	0.361702
chr3	166958076	167098085	ZBBX	140009	0.363548
chr3	167159576	167191920	SERPINI2	32344	0.354131
chr3	167196472	167371287	WDR49	174815	0.365157
chr3	167401694	167452651	PDCD10	50957	0.357772
chr3	167453431	167543357	SERPINI1	89926	0.367013
chr3	167613735	167641797	LOC646168	28062	0.355000
chr3	167727653	167813417	GOLIM4	85764	0.383214
chr3	168269641	168269737	MIR551B	96	0.531250
chr3	168530082	168548374	EGFEM1P	18292	0.362454
chr3	168801286	169381563	MECOM	580277	0.374494
chr3	169114967	169114987	DD413694	20	0.300000
chr3	169482397	169482848	TERC	451	0.674058
chr3	169484710	169487683	ACTRT3	2973	0.494450
chr3	169492052	169507504	MYNN	15452	0.355423
chr3	169511215	169530574	LRRC34	19359	0.388037
chr3	169539709	169555560	LRRIQ4	15851	0.419784
chr3	169557028	169587723	LRRC31	30695	0.416192
chr3	169629481	169656948	SAMD7	27467	0.419048
chr3	169661771	169684522	LOC100128164	22751	0.408905
chr3	169684579	169716161	SEC62	31582	0.364321
chr3	169755734	169803183	GPR160	47449	0.423655
chr3	169805367	169899537	PHC3	94170	0.377838
chr3	169858399	169859958	AY940074	1559	0.406029
chr3	169940219	170023770	PRKCI	83551	0.397925
chr3	169962636	169962714	JA611273	78	0.346154
chr3	170077410	170114637	SKIL	37227	0.388374
chr3	170136652	170152479	CLDN11	15827	0.445820
chr3	170177341	170303863	SLC7A14	126522	0.421500
chr3	170582664	170588045	RPL22L1	5381	0.394908
chr3	170606203	170626426	EIF5A2	20223	0.381941
chr3	170712658	170712822	U1	164	0.512195
chr3	170714136	170744768	SLC2A2	30632	0.369842
chr3	170780291	171178197	TNIK	397906	0.395681
chr3	170824452	170824548	MIR569	96	0.322917
chr3	171318194	171528504	PLD1	210310	0.388474
chr3	171561138	171577108	TMEM212	15970	0.380589
chr3	171757417	172118492	FNDC3B	361075	0.397375
chr3	172161080	172166246	GHSR	5166	0.399342
chr3	172163368	172164159	GU289929	791	0.333755
chr3	172223297	172241297	TNFSF10	18000	0.408278
chr3	172308502	172312373	AK127557	3871	0.485404
chr3	172348434	172429008	NCEH1	80574	0.417157
chr3	172420913	172421015	U6	102	0.441176
chr3	172468474	172539264	ECT2	70790	0.349640
chr3	172607146	172859058	SPATA16	251912	0.366719
chr3	173116243	174001116	NLGN1	884873	0.354670
chr3	173775430	173775654	7SK	224	0.410714
chr3	174156362	174455536	NAALADL2	299174	0.355091
chr3	174349612	174349892	7SK	280	0.385714
chr3	174577110	175523428	NAALADL2	946318	0.350811
chr3	174797101	174833032	NAALADL2-AS3	35931	0.345941
chr3	175087328	175087410	MIR4789	82	0.378049
chr3	175327274	175327401	U4	127	0.377953
chr3	176738541	176915048	TBL1XR1	176507	0.382823
chr3	177159708	177470492	LINC00578	310784	0.403959
chr3	177534652	177617012	AK056252	82360	0.388405
chr3	177725459	177725567	U6	108	0.342593
chr3	178051326	178103184	AX747163	51858	0.364669
chr3	178254223	178562217	KCNMB2	307994	0.381102
chr3	178243274	178578185	AF279780	334911	0.381101
chr3	178735010	178789656	ZMAT3	54646	0.405647
chr3	178819154	178865761	BC032034	46607	0.398631
chr3	178866310	178952497	PIK3CA	86187	0.358662
chr3	178960553	178969403	KCNMB3	8850	0.424746
chr3	179041550	179053320	ZNF639	11770	0.390739
chr3	179065479	179111008	MFN1	45529	0.384129
chr3	179113875	179169371	GNB4	55496	0.391560
chr3	179280707	179306193	ACTL6A	25486	0.392333
chr3	179306254	179322434	MRPL47	16180	0.386527
chr3	179322574	179342288	NDUFB5	19714	0.396267
chr3	179370932	179507189	USP13	136257	0.426312
chr3	179512746	179754841	PEX5L	242095	0.381425
chr3	180319917	180328918	TTC14	9001	0.355405
chr3	180331795	180397283	CCDC39	65488	0.358020
chr3	180425376	180587966	DKFZp434A128	162590	0.374605
chr3	180586548	180588578	BC034416	2030	0.478818
chr3	180630233	180700539	FXR1	70306	0.372315
chr3	180701497	180707562	DNAJC19	6065	0.391756
chr3	180774467	181460013	SOX2-OT	685546	0.374631
chr3	180949524	180949631	U6	107	0.457944
chr3	181413636	181413690	JA611300	54	0.796296
chr3	181429711	181432223	SOX2	2512	0.507166
chr3	181670166	181721828	BC036236	51662	0.392068
chr3	181686246	181686469	7SK	223	0.381166
chr3	181723101	181725535	DQ571917	2434	0.440838
chr3	182164757	182204150	FLJ46066	39393	0.380474
chr3	182511290	182639421	ATP11B	128131	0.360209
chr3	182660558	182698326	DCUN1D1	37768	0.392290
chr3	182733005	182817365	MCCC1	84360	0.409448
chr3	182840002	182880667	LAMP3	40665	0.438313
chr3	182895830	183145855	MCF2L2	250025	0.423094
chr3	182971031	182991179	B3GNT5	20148	0.428281
chr3	183005267	183015456	BC013229	10189	0.420944
chr3	183015456	183016292	BC040935	836	0.399522
chr3	183165438	183173800	LINC00888	8362	0.397273
chr3	183205318	183273499	KLHL6	68181	0.452355
chr3	183353410	183402304	KLHL24	48894	0.389884
chr3	183415605	183530413	YEATS2	114808	0.425841
chr3	183521771	183524378	AX746590	2607	0.505946
chr3	183533663	183543393	MAP6D1	9730	0.546249
chr3	183547172	183602693	PARL	55521	0.417932
chr3	183637723	183735727	ABCC5	98004	0.446839
chr3	183724125	183729207	ABCC5-AS1	5082	0.421684
chr3	183750618	183757157	HTR3D	6539	0.478972
chr3	183770834	183778461	HTR3C	7627	0.494952
chr3	183817966	183824783	HTR3E	6817	0.484671
chr3	183852809	183863099	EIF2B5	10290	0.487949
chr3	183873283	183891314	DVL3	18031	0.528091
chr3	183892633	183901879	AP2M1	9246	0.539585
chr3	183903862	183911795	ABCF3	7933	0.517963
chr3	183948316	183960117	VWA5B2	11801	0.579103
chr3	183959192	183959277	MIR1224	85	0.705882
chr3	183960116	183966759	ALG3	6643	0.514075
chr3	183967444	184010819	ECE2	43375	0.510963
chr3	183977002	183979251	CAMK2N2	2249	0.682970
chr3	184017021	184026840	PSMD2	9819	0.483349
chr3	184032282	184053146	EIF4G1	20864	0.527703
chr3	184043483	184043559	SNORD66	76	0.513158
chr3	184055275	184064063	FAM131A	8788	0.553027
chr3	184063972	184079439	CLCN2	15467	0.554859
chr3	184081193	184086363	POLR2H	5170	0.477950
chr3	184089772	184095932	THPO	6160	0.506331
chr3	184097860	184107617	CHRD	9757	0.600287
chr3	184279586	184300196	EPHB3	20610	0.584425
chr3	184428154	184429836	MAGEF1	1682	0.536266
chr3	184529930	184770402	VPS8	240472	0.384502
chr3	184795837	184870802	C3orf70	74965	0.398212
chr3	184880688	184909743	EHHADH-AS1	29055	0.425331
chr3	184908411	184971886	EHHADH	63475	0.389917
chr3	185080835	185206882	MAP3K13	126047	0.407150
chr3	185207388	185216845	TMEM41A	9457	0.476261
chr3	185225569	185270369	LIPH	44800	0.435737
chr3	185304030	185348885	SENP2	44855	0.421514
chr3	185361526	185542827	IGF2BP2	181301	0.425353
chr3	185431039	185435955	C3orf65	4916	0.444670
chr3	185632357	185655924	TRA2B	23567	0.387194
chr3	185677757	185698665	LOC344887	20908	0.446097
chr3	185764105	185826901	ETV5	62796	0.424725
chr3	185864989	186080023	DGKG	215034	0.444190
chr3	186172769	186211450	LOC253573	38681	0.424058
chr3	186256231	186262167	CRYGS	5936	0.391172
chr3	186263855	186285141	TBCCD1	21286	0.396458
chr3	186287951	186303589	DNAJB11	15638	0.389308
chr3	186330849	186339107	AHSG	8258	0.477234
chr3	186358148	186370797	FETUB	12649	0.400585
chr3	186383797	186396023	HRG	12226	0.426059
chr3	186435097	186460678	KNG1	25581	0.419999
chr3	186501360	186507685	EIF4A2	6325	0.410277
chr3	186502584	186502654	SNORD2	70	0.400000
chr3	186504460	186504641	SNORA81	181	0.381215
chr3	186505087	186505222	SNORA63	135	0.429630
chr3	186507681	186524290	RFC4	16609	0.398519
chr3	186560462	186576252	ADIPOQ	15790	0.438822
chr3	186569675	186573912	ADIPOQ-AS1	4237	0.469908
chr3	186739664	186796341	ST6GAL1	56677	0.431357
chr3	186838740	186857263	RPL39L	18523	0.413270
chr3	186915273	186919253	RTP1	3980	0.508040
chr3	186951869	187009810	MASP1	57941	0.443658
chr3	187009059	187015721	BX648496	6662	0.416992
chr3	187086167	187089369	RTP4	3202	0.425359
chr3	187386693	187388201	SST	1508	0.486074
chr3	187416046	187420345	RTP2	4299	0.527565
chr3	187420153	187450203	LOC100131635	30050	0.442196
chr3	187439164	187463513	BCL6	24349	0.476816
chr3	187868993	187871876	LPP-AS2	2883	0.481790
chr3	187930720	188608460	LPP	677740	0.387482
chr3	187896330	187898596	FLJ42393	2266	0.473963
chr3	188889762	189041271	TPRG1	151509	0.389693
chr3	188956474	188958383	TPRG1-AS2	1909	0.400210
chr3	189349215	189615068	TP63	265853	0.371329
chr3	189547710	189547798	MIR944	88	0.329545
chr3	189674516	189838908	LEPREL1	164392	0.381010
chr3	190023489	190040235	CLDN1	16746	0.373641
chr3	190105660	190129932	CLDN16	24272	0.360374
chr3	190146443	190167665	TMEM207	21222	0.377014
chr3	190231839	190374986	IL1RAP	143147	0.379428
chr3	190359951	190360292	7SK	341	0.501466
chr3	190570525	190580465	GMNC	9940	0.350402
chr3	190595718	190595839	SNAR-I	121	0.578512
chr3	190930321	190967910	OSTN	37589	0.371412
chr3	190984943	191048325	UTS2B	63382	0.395002
chr3	191046873	191116459	CCDC50	69586	0.365893
chr3	191178951	191179245	PYDC2	294	0.520408
chr3	191857181	192126838	FGF12	269657	0.367315
chr3	192447343	192447505	U1	162	0.462963
chr3	192514604	192635950	MB21D2	121346	0.427315
chr3	192958916	192988644	HRASLS	29728	0.378767
chr3	192959567	192961761	MGC2889	2194	0.423883
chr3	192992830	193096514	ATP13A5	103684	0.394584
chr3	193119865	193272696	ATP13A4	152831	0.386780
chr3	193310932	193415600	OPA1	104668	0.369826
chr3	193336387	193345121	OPA1-AS1	8734	0.335585
chr3	193559838	193561813	AK091265	1975	0.503797
chr3	193675160	193721448	LOC647323	46288	0.443009
chr3	193710882	193712027	DPPA2P3	1145	0.434934
chr3	193766708	193787318	BC038368	20610	0.437215
chr3	193853930	193856401	HES1	2471	0.545528
chr3	194018988	194030593	LINC00887	11605	0.481344
chr3	194060493	194072057	CPN2	11564	0.527326
chr3	194075975	194090472	LRRC15	14497	0.526799
chr3	194115549	194119995	GP5	4446	0.525191
chr3	194123402	194188968	ATP13A3	65566	0.368087
chr3	194207868	194239008	LINC00884	31140	0.452665
chr3	194207868	194209455	LINC00884	1587	0.559546
chr3	194217052	194222232	AX746839	5180	0.424517
chr3	194254231	194254312	U6	81	0.382716
chr3	194304996	194311561	TMEM44-AS1	6565	0.479513
chr3	194308401	194354150	TMEM44	45749	0.507421
chr3	194361516	194393206	LSG1	31690	0.416882
chr3	194406621	194409766	FAM43A	3145	0.620350
chr3	194429149	194502897	LOC100507391	73748	0.466955
chr3	194789012	194991895	XXYLT1	202883	0.488927
chr3	194868599	194873585	XXYLT1-AS2	4986	0.453470
chr3	194995464	195163817	ACAP2	168353	0.381757
chr3	195208644	195208667	MIR5692C1	23	0.304348
chr3	195241220	195270224	PPP1R2	29004	0.390222
chr3	195249884	195250019	U6atac	135	0.511111
chr3	195295572	195311076	APOD	15504	0.460010
chr3	195370803	195371637	BC044310	834	0.559952
chr3	195375289	195378976	BC053580	3687	0.450773
chr3	195384909	195400858	SDHAP2	15949	0.480720
chr3	195384909	195398654	SDHAP2	13745	0.478647
chr3	195426271	195426368	MIR570	97	0.371134
chr3	195426821	195438745	AK128346	11924	0.465112
chr3	195447752	195464540	MUC20	16788	0.510662
chr3	195473637	195538844	MUC4	65207	0.537151
chr3	195590235	195622432	TNK2	32197	0.598596
chr3	195634946	195638128	AK127609	3182	0.675361
chr3	195689975	195694861	SDHAP1	4886	0.488129
chr3	195701267	195717150	SDHAP1	15883	0.481332
chr3	195776154	195809032	TFRC	32878	0.431322
chr3	195869625	195887761	LINC00885	18136	0.478992
chr3	195924322	195938300	ZDHHC19	13978	0.543497
chr3	195943382	195960301	SLC51A	16919	0.508541
chr3	195961239	195964785	AF088041	3546	0.456289
chr3	195965252	196014584	PCYT1A	49332	0.447458
chr3	196018089	196045165	TCTEX1D2	27076	0.451470
chr3	196045220	196052441	AK124973	7221	0.514195
chr3	196050416	196065291	TM4SF19	14875	0.476504
chr3	196080368	196159345	UBXN7	78977	0.425896
chr3	196158234	196160242	AX747828	2008	0.582171
chr3	196195656	196230639	RNF168	34983	0.423663
chr3	196233749	196242237	C3orf43	8488	0.447220
chr3	196281058	196295413	WDR53	14355	0.428422
chr3	196295724	196315930	FBXO45	20206	0.408295
chr3	196366655	196388874	LRRC33	22219	0.505018
chr3	196433147	196439123	CEP19	5976	0.421352
chr3	196435729	196435835	U6	106	0.500000
chr3	196439244	196462876	PIGX	23632	0.400643
chr3	196466727	196559518	PAK2	92791	0.416980
chr3	196594726	196661584	SENP5	66858	0.420309
chr3	196662272	196669464	NCBP2	7192	0.440072
chr3	196669493	196670884	NCBP2-AS2	1391	0.579439
chr3	196673213	196695704	PIGZ	22491	0.484283
chr3	196728611	196756687	MFI2	28076	0.572304
chr3	196729776	196731615	MFI2-AS1	1839	0.667210
chr3	196769430	197025447	DLG1	256017	0.365351
chr3	197020748	197020819	MIR4797	71	0.436620
chr3	197025117	197030621	DLG1-AS1	5504	0.464571
chr3	197236653	197282858	BDH1	46205	0.508105
chr3	197340897	197354752	LOC220729	13855	0.446409
chr3	197371037	197373038	BC040733	2001	0.533733
chr3	197398258	197463773	KIAA0226	65515	0.461299
chr3	197476623	197511317	FYTTD1	34694	0.416787
chr3	197518144	197598456	LRCH3	80312	0.402206
chr3	197615945	197676796	IQCG	60851	0.436920
chr3	197677051	197682721	RPL35A	5670	0.451675
chr3	197687070	197770591	LMLN	83521	0.402366
chr3	197774001	197774029	DQ586768	28	0.500000
chr3	197784403	197807542	ANKRD18DP	23139	0.368037
chr3	197879236	197907735	FAM157A	28499	0.436121
chr3	197937115	197955678	AL137655	18563	0.525993
chr3	197945366	197945397	DQ574670	31	0.580645
chr3	197945397	197945429	DQ597235	32	0.468750
chr3	197945476	197945537	DQ599768	61	0.557377
chr3	197945703	197945729	DQ572955	26	0.538462
chr3	197945990	197946021	DQ577349	31	0.516129
chr3	197946093	197946138	DQ575955	45	0.644444
chr4	53226	156490	ZNF718	103264	0.400798
chr4	124401	156490	ZNF718	32089	0.382623
chr4	206388	249773	ZNF876P	43385	0.387369
chr4	264463	289944	ZNF732	25481	0.360857
chr4	331595	367691	ZNF141	36096	0.409519
chr4	419603	467998	ABCA11P	48395	0.398326
chr4	433772	492960	ZNF721	59188	0.415608
chr4	492988	533320	PIGG	40332	0.501339
chr4	619362	664681	PDE6B	45319	0.568194
chr4	647011	649434	BC020343	2423	0.639290
chr4	666224	668127	ATP5I	1903	0.573305
chr4	671710	675817	MYL5	4107	0.661797
chr4	675617	682973	MFSD7	7356	0.651169
chr4	699572	764427	PCGF3	64855	0.560743
chr4	773936	775636	LOC100129917	1700	0.600588
chr4	778744	819945	CPLX1	41201	0.552487
chr4	843064	926174	GAK	83110	0.565046
chr4	926261	952443	TMEM175	26182	0.517722
chr4	952671	967348	DGKQ	14677	0.659740
chr4	981444	987224	SLC26A1	5780	0.662976
chr4	980784	998317	IDUA	17533	0.653853
chr4	1005759	1020686	FGFRL1	14927	0.656327
chr4	1050036	1056744	AK124578	6708	0.510733
chr4	1065265	1107352	RNF212	42087	0.507591
chr4	1108984	1116952	TMED11P	7968	0.372364
chr4	1145159	1147489	AX747945	2330	0.506867
chr4	1160720	1166657	SPON2	5937	0.646960
chr4	1193485	1195204	AX747178	1719	0.634671
chr4	1205821	1224816	HV535487	18995	0.598368
chr4	1205227	1242908	CTBP1	37681	0.606964
chr4	1243227	1246795	CTBP1-AS1	3568	0.550729
chr4	1283671	1333925	MAEA	50254	0.550165
chr4	1341103	1381837	UVSSA	40734	0.590637
chr4	1385339	1389782	CRIPAK	4443	0.475129
chr4	1575787	1577966	AX748388	2179	0.608536
chr4	1641607	1685988	FAM53A	44381	0.551632
chr4	1694526	1714030	SLBP	19504	0.466110
chr4	1717678	1723084	TMEM129	5406	0.624491
chr4	1723216	1746905	TACC3	23689	0.560682
chr4	1795038	1810599	FGFR3	15561	0.658120
chr4	1813205	1857974	LETM1	44769	0.538341
chr4	1873122	1983934	WHSC1	110812	0.471510
chr4	1976362	1976487	SCARNA22	125	0.560000
chr4	1984440	2010962	NELFA	26522	0.509351
chr4	2043719	2045697	C4orf48	1978	0.692113
chr4	2061238	2070816	NAT8L	9578	0.660367
chr4	2073644	2230970	POLN	157326	0.444911
chr4	2230095	2243860	HAUS3	13765	0.375518
chr4	2249159	2263739	MXD4	14580	0.626406
chr4	2271323	2420370	ZFYVE28	149047	0.525197
chr4	2420700	2464690	LOC402160	43990	0.551875
chr4	2470794	2517586	RNF4	46792	0.483288
chr4	2597827	2734302	FAM193A	136475	0.454406
chr4	2743386	2758103	TNIP2	14717	0.540599
chr4	2819911	2842823	SH3BP2	22912	0.574502
chr4	2845583	2931802	ADD1	86219	0.448393
chr4	2932287	2936586	MFSD10	4299	0.675506
chr4	2937277	2952794	NOP14-AS1	15517	0.534124
chr4	2939663	2965118	NOP14	25455	0.499980
chr4	2965342	3042474	GRK4	77132	0.463854
chr4	2965342	2968577	GRK4	3235	0.512210
chr4	3064972	3076241	HTT-AS1	11269	0.497116
chr4	3076407	3245687	HTT	169280	0.455228
chr4	3088666	3088687	CS644968	21	0.380952
chr4	3250766	3258342	MSANTD1	7576	0.600449
chr4	3315873	3441640	RGS12	125767	0.504139
chr4	3443725	3451213	HGFAC	7488	0.674145
chr4	3465032	3496209	DOK7	31177	0.622927
chr4	3505323	3534224	LRPAP1	28901	0.572818
chr4	3578595	3592712	LINC00955	14117	0.493306
chr4	3675319	3679582	LOC100133461	4263	0.581985
chr4	3768295	3770253	ADRA2C	1958	0.680797
chr4	3941972	3941998	DQ584669	26	0.538462
chr4	3943668	3957148	FAM86EP	13480	0.531380
chr4	4034896	4076783	BC042823	41887	0.425478
chr4	4190529	4228621	OTOP1	38092	0.455502
chr4	4237268	4249934	TMEM128	12666	0.416785
chr4	4269428	4291896	LYAR	22468	0.440137
chr4	4291923	4323513	ZBTB49	31590	0.440013
chr4	4387583	4420785	NSG1	33202	0.542979
chr4	4420695	4543775	STX18	123080	0.411245
chr4	4543857	4712664	LOC100507266	168807	0.456213
chr4	4763531	4789101	AK056081	25570	0.475518
chr4	4861391	4865660	MSX1	4269	0.569923
chr4	4922496	4922791	7SK	295	0.532203
chr4	5016313	5021197	CYTL1	4884	0.430590
chr4	5053526	5502725	STK32B	449199	0.426537
chr4	5526882	5529527	C4orf6	2645	0.447259
chr4	5564145	5710294	EVC2	146149	0.452976
chr4	5712923	5816031	EVC	103108	0.473988
chr4	5822490	5894785	CRMP1	72295	0.494571
chr4	5899317	5991374	FLJ46481	92057	0.479018
chr4	5925001	5925055	MIR378D1	54	0.407407
chr4	6027925	6202318	JAKMIP1	174393	0.493345
chr4	6202459	6235663	LOC285484	33204	0.468347
chr4	6271576	6304992	WFS1	33416	0.570356
chr4	6322304	6383597	PPP2R2C	61293	0.543031
chr4	6576901	6624188	MAN2B2	47287	0.545985
chr4	6641817	6644470	MRFAP1	2653	0.531474
chr4	6675802	6677774	LOC93622	1972	0.527890
chr4	6695565	6698897	S100P	3332	0.535414
chr4	6709428	6711606	MRFAP1L1	2178	0.449036
chr4	6717841	6719387	BLOC1S4	1546	0.536869
chr4	6784458	6885899	KIAA0232	101441	0.420441
chr4	6911494	7034845	TBC1D14	123351	0.493891
chr4	6945337	6947476	AX747238	2139	0.505844
chr4	7032280	7047958	LOC100129931	15678	0.527363
chr4	7042575	7044728	CCDC96	2153	0.578727
chr4	7045155	7059677	TADA2B	14522	0.552266
chr4	7061779	7069800	GRPEL1	8021	0.479491
chr4	7099150	7105103	FLJ36777	5953	0.479254
chr4	7194373	7744564	SORCS2	550191	0.536968
chr4	7312176	7312251	MIR4798	75	0.360000
chr4	7432020	7436700	PSAPL1	4680	0.606410
chr4	7461754	7461845	MIR4274	91	0.659341
chr4	7608584	7608614	DQ572409	30	0.333333
chr4	7755816	7780654	AFAP1-AS1	24838	0.529109
chr4	7760439	7941653	AFAP1	181214	0.463899
chr4	7967036	8160559	ABLIM2	193523	0.539946
chr4	8201059	8242830	SH3TC1	41771	0.578894
chr4	8271488	8308838	HTRA3	37350	0.560830
chr4	8357036	8359103	AX746755	2067	0.469279
chr4	8368008	8442452	ACOX3	74444	0.519303
chr4	8442531	8481260	TRMT44	38729	0.500219
chr4	8582216	8591750	GPR78	9534	0.570589
chr4	8594386	8621488	CPZ	27102	0.582725
chr4	8868772	8873543	HMX1	4771	0.648501
chr4	8951476	8952127	LOC650293	651	0.456221
chr4	9212382	9213975	USP17L10	1593	0.519774
chr4	9217130	9218723	USP17L11	1593	0.524168
chr4	9221877	9223470	USP17L12	1593	0.521657
chr4	9226621	9228214	USP17L13	1593	0.522285
chr4	9236110	9238060	USP17L15	1950	0.516923
chr4	9245604	9247197	USP17L17	1593	0.522913
chr4	9250355	9251948	USP17L11	1593	0.522913
chr4	9255103	9256696	USP17L19	1593	0.521657
chr4	9259849	9261442	USP17L11	1593	0.524168
chr4	9264597	9266190	USP17L12	1593	0.522285
chr4	9269344	9270937	USP17L20	1593	0.522913
chr4	9326890	9328483	USP17L27	1593	0.523540
chr4	9331636	9333229	USP17L27	1593	0.523540
chr4	9336383	9337976	USP17L24	1593	0.523540
chr4	9341128	9342721	USP17L24	1593	0.524168
chr4	9345873	9347466	USP17L28	1593	0.523540
chr4	9350618	9352211	USP17L30	1593	0.523540
chr4	9355363	9356956	USP17L5	1593	0.523540
chr4	9360107	9361700	USP17L9P	1593	0.521030
chr4	9364854	9366447	USP17L24	1593	0.523540
chr4	9369599	9370796	USP17L6P	1197	0.517126
chr4	9446259	9452240	DEFB131	5981	0.339743
chr4	9557788	9557937	MIR548I2	149	0.369128
chr4	9668529	9668652	AB059369	123	0.479675
chr4	9707632	9707661	DQ584669	29	0.586207
chr4	9783257	9785633	DRD5	2376	0.585859
chr4	9827847	10023114	SLC2A9	195267	0.454608
chr4	10075962	10118573	WDR1	42611	0.549788
chr4	10080234	10080316	MIR3138	82	0.670732
chr4	10122105	10122135	DQ589421	30	0.433333
chr4	10122826	10122861	DQ583133	35	0.457143
chr4	10124402	10124435	DQ581767	33	0.454545
chr4	10125235	10125264	DQ584082	29	0.413793
chr4	10127121	10127151	DQ573667	30	0.533333
chr4	10137431	10137474	DQ591515	43	0.488372
chr4	10145243	10145285	DQ599898	42	0.428571
chr4	10441503	10459032	ZNF518B	17529	0.421587
chr4	10491837	10686386	CLNK	194549	0.415690
chr4	11370450	11370545	MIR572	95	0.789474
chr4	11399987	11430537	HS3ST1	30550	0.434435
chr4	12225105	12252909	BC042433	27804	0.369156
chr4	13369346	13485989	RAB28	116643	0.358899
chr4	13527942	13533041	LOC285547	5099	0.514218
chr4	13542453	13546114	NKX3-2	3661	0.618137
chr4	13547699	13549448	LOC285548	1749	0.553459
chr4	13570365	13629328	BOD1L1	58963	0.388735
chr4	13629488	13629581	MIR5091	93	0.634409
chr4	13656802	13932852	AK091889	276050	0.400460
chr4	14113591	14141676	LOC152742	28085	0.397650
chr4	14472089	14473364	BC070495	1275	0.381961
chr4	14473677	14889793	MGC4836	416116	0.394861
chr4	14692333	14692456	SNORA63	123	0.333333
chr4	14978523	14996129	LOC441009	17606	0.366466
chr4	15003372	15004060	BC113726	688	0.736919
chr4	15004297	15071777	CPEB2	67480	0.349689
chr4	15429628	15447791	C1QTNF7	18163	0.389859
chr4	15471488	15603180	CC2D2A	131692	0.402082
chr4	15520622	15523368	AX746699	2746	0.395120
chr4	15606006	15657035	FBXL5	51029	0.374904
chr4	15683351	15692070	FAM200B	8719	0.362886
chr4	15704572	15733796	BST1	29224	0.432863
chr4	15779930	15850706	CD38	70776	0.410803
chr4	15937192	15940363	FGFBP1	3171	0.464522
chr4	15961862	15964859	FGFBP2	2997	0.452119
chr4	15969848	16077741	PROM1	107893	0.424291
chr4	16010298	16010410	U6	112	0.410714
chr4	16162127	16228161	TAPT1	66034	0.384135
chr4	16228285	16230285	BC010030	2000	0.571000
chr4	16503164	16900424	LDB2	397260	0.402067
chr4	16595985	16623654	MIR548AX	27669	0.394882
chr4	17173379	17187680	BC029598	14301	0.400252
chr4	17488015	17513857	QDPR	25842	0.451320
chr4	17516787	17528727	CLRN2	11940	0.429146
chr4	17578926	17609590	LAP3	30664	0.440745
chr4	17616272	17626160	MED28	9888	0.454389
chr4	17629878	17633666	CR936688	3788	0.420803
chr4	17633695	17635559	CR936688	1864	0.454936
chr4	17633708	17783135	FAM184B	149427	0.441594
chr4	17802277	17812381	DCAF16	10104	0.393705
chr4	17812435	17846487	NCAPG	34052	0.354781
chr4	17882217	18023483	LCORL	141266	0.359301
chr4	20255234	20620788	SLIT2	365554	0.359895
chr4	20393811	20396479	SLIT2-IT1	2668	0.360945
chr4	20529897	20530007	MIR218-1	110	0.445455
chr4	20702035	20729980	PACRGL	27945	0.379603
chr4	20730238	21699318	KCNIP4	969080	0.377385
chr4	21844963	21854811	KCNIP4-IT1	9848	0.367486
chr4	22328989	22341289	LOC100505912	12300	0.389431
chr4	22388996	22517677	GPR125	128681	0.392303
chr4	22694536	22821195	GBA3	126659	0.384789
chr4	23464695	23464726	MIR548AJ2	31	0.322581
chr4	23793643	23891700	PPARGC1A	98057	0.379596
chr4	24521814	24521913	MIR573	99	0.434343
chr4	24529087	24586184	DHX15	57097	0.371736
chr4	24797084	24802467	SOD3	5383	0.545421
chr4	24807738	24914600	CCDC149	106862	0.437602
chr4	25000470	25032414	LGI2	31944	0.439550
chr4	25121626	25162204	SEPSECS	40578	0.363128
chr4	25235652	25280831	PI4K2B	45179	0.417229
chr4	25314395	25372005	ZCCHC4	57610	0.389342
chr4	25378847	25420120	ANAPC4	41273	0.379570
chr4	25657434	25680368	SLC34A2	22934	0.478983
chr4	25749048	25864610	SEL1L3	115562	0.434632
chr4	25915813	25931501	SMIM20	15688	0.434281
chr4	26322428	26436752	RBPJ	114324	0.387478
chr4	26483017	26492042	CCKAR	9025	0.428698
chr4	26585545	26756918	TBC1D19	171373	0.363920
chr4	26703930	26704010	SNORD74	80	0.425000
chr4	26862312	27027003	STIM2	164691	0.363821
chr4	27732096	27732127	DQ571874	31	0.451613
chr4	28821203	28821290	MIR4275	87	0.379310
chr4	30722036	31148423	PCDH7	426387	0.355663
chr4	33893553	33908510	AK093205	14957	0.318714
chr4	33897960	34041515	BC036345	143555	0.343875
chr4	36067619	36245979	ARAP2	178360	0.354014
chr4	36245737	36275841	BC037904	30104	0.376993
chr4	36258139	36275841	BC030111	17702	0.366625
chr4	36285643	36346407	DTHD1	60764	0.371931
chr4	37243531	37243613	MIR4801	82	0.292683
chr4	37246689	37451087	KIAA1239	204398	0.387641
chr4	37455551	37595132	C4orf19	139581	0.407742
chr4	37461170	37463042	AX748249	1872	0.385150
chr4	37592421	37687999	RELL1	95578	0.428289
chr4	37828281	37864559	PGM2	36278	0.398892
chr4	37892704	38140796	TBC1D1	248092	0.428422
chr4	37962055	37962631	PTTG2	576	0.461806
chr4	38614321	38666249	FLJ13197	51928	0.431328
chr4	38628025	38666430	FLJ13197	38405	0.434735
chr4	38665789	38703129	KLF3	37340	0.418800
chr4	38773859	38784611	TLR10	10752	0.387649
chr4	38797875	38806412	TLR1	8537	0.412674
chr4	38825328	38858438	TLR6	33110	0.397523
chr4	38869353	38947365	FAM114A1	78012	0.425345
chr4	38869652	38869748	MIR574	96	0.656250
chr4	38968440	39034041	TMEM156	65601	0.389979
chr4	39046450	39127853	KLHL5	81403	0.370183
chr4	39184023	39287430	WDR19	103407	0.393039
chr4	39289068	39368001	RFC1	78933	0.392624
chr4	39408472	39453153	KLB	44681	0.421119
chr4	39455744	39460207	RPL9	4463	0.397042
chr4	39460664	39479271	LIAS	18607	0.399581
chr4	39481874	39483523	LOC401127	1649	0.476046
chr4	39500374	39529218	UGDH	28844	0.411767
chr4	39529458	39596327	UGDH-AS1	66869	0.423171
chr4	39552545	39640481	SMIM14	87936	0.415586
chr4	39640759	39653681	BC040333	12922	0.439793
chr4	39699663	39784410	UBE2K	84747	0.420204
chr4	39824482	39979576	PDS5A	155094	0.403529
chr4	40044536	40058819	LOC344967	14283	0.457327
chr4	40058523	40159872	N4BP2	101349	0.404947
chr4	40198526	40246281	RHOH	47755	0.423265
chr4	40309201	40332436	JN120858	23235	0.443082
chr4	40337345	40357234	CHRNA9	19889	0.429283
chr4	40425271	40631883	RBM47	206612	0.431417
chr4	40504056	40504136	MIR4802	80	0.475000
chr4	40751913	40812002	NSUN7	60089	0.395397
chr4	40812043	41216635	APBB2	404592	0.423382
chr4	41222090	41258744	UCHL1-AS1	36654	0.403912
chr4	41258897	41270446	UCHL1	11549	0.443415
chr4	41540190	41702061	LIMCH1	161871	0.397446
chr4	41746098	41750987	PHOX2B	4889	0.520965
chr4	41881538	41884569	BC025350	3031	0.585615
chr4	41937136	41962824	TMEM33	25688	0.352772
chr4	41983712	41988484	DCAF4L1	4772	0.415339
chr4	41992522	42089551	SLC30A9	97029	0.369292
chr4	42112869	42154895	BEND4	42026	0.422715
chr4	42399855	42404504	SHISA3	4649	0.502904
chr4	42410391	42659122	ATP8A1	248731	0.381464
chr4	42894412	42894635	7SK	223	0.372197
chr4	42895282	43032675	GRXCR1	137393	0.374328
chr4	44175919	44450824	KCTD8	274905	0.356418
chr4	44624353	44653658	YIPF7	29305	0.360723
chr4	44680432	44702697	GUF1	22265	0.338019
chr4	44703811	44728651	GNPDA2	24840	0.344968
chr4	45683334	45685041	BC048420	1707	0.346221
chr4	46037786	46126082	GABRG1	88296	0.326040
chr4	46251580	46392056	GABRA2	140476	0.353420
chr4	46736846	46911252	COX7B2	174406	0.368382
chr4	46920916	46995522	GABRA4	74606	0.349878
chr4	47033294	47428447	GABRB1	395153	0.368963
chr4	47452810	47465676	COMMD8	12866	0.362817
chr4	47487409	47595503	ATP10D	108094	0.375849
chr4	47596017	47840059	CORIN	244042	0.385159
chr4	47849257	47916633	NFXL1	67376	0.355319
chr4	47916243	47992754	BC041434	76511	0.389539
chr4	47937993	47983550	CNGA1	45557	0.386439
chr4	48018790	48039080	NIPAL1	20290	0.391868
chr4	48068409	48136273	TXK	67864	0.394598
chr4	48108097	48108205	U6	108	0.361111
chr4	48137799	48271814	TEC	134015	0.404223
chr4	48343612	48428215	SLAIN2	84603	0.378166
chr4	48485359	48491541	SLC10A4	6182	0.435781
chr4	48492308	48496422	ZAR1	4114	0.528926
chr4	48499379	48782316	FRYL	282937	0.369407
chr4	48833322	48863834	OCIAD1	30512	0.373492
chr4	48887404	48908815	OCIAD2	21411	0.416001
chr4	48988264	49064095	CWH43	75831	0.393797
chr4	49205061	49205091	DQ579288	30	0.433333
chr4	49236278	49236308	DQ583161	30	0.466667
chr4	49236341	49236371	DQ587539	30	0.566667
chr4	49237369	49237396	DQ579969	27	0.555556
chr4	49562075	49562102	DQ593719	27	0.555556
chr4	49563100	49563130	DQ590589	30	0.566667
chr4	49563163	49563193	DQ583161	30	0.466667
chr4	49580189	49580217	DQ596206	28	0.500000
chr4	49589311	49589341	DQ587539	30	0.566667
chr4	49591418	49591448	DQ590126	30	0.433333
chr4	52709275	52783003	DCUN1D4	73728	0.400282
chr4	52859865	52883786	LRRC66	23921	0.388989
chr4	52886860	52904485	SGCB	17625	0.383433
chr4	52917592	52963458	SPATA18	45866	0.402215
chr4	53457126	53525502	USP46	68376	0.413873
chr4	53578620	53580305	DANCR	1685	0.540653
chr4	53578848	53578914	MIR4449	66	0.863636
chr4	53579415	53579537	SNORA26	122	0.459016
chr4	53609683	53617807	ERVMER34-1	8124	0.466027
chr4	53656160	53681631	LOC152578	25471	0.417023
chr4	53728494	53733002	RASL11B	4508	0.475599
chr4	53739150	54232242	SCFD2	493092	0.397818
chr4	53811820	53824254	AK055055	12434	0.429387
chr4	55095263	55164412	PDGFRA	69149	0.436521
chr4	54294193	54326103	FIP1L1	31910	0.347885
chr4	54326436	54457753	LNX1	131317	0.418689
chr4	54366243	54389443	LNX1-AS1	23200	0.429052
chr4	54459122	54471548	LNX1-AS2	12426	0.433124
chr4	54851665	54853449	RPL21P44	1784	0.429933
chr4	54875957	54930815	CHIC2	54858	0.367203
chr4	54966247	54968122	GSX2	1875	0.629867
chr4	55469377	55473298	BC044946	3921	0.408569
chr4	55524094	55606881	KIT	82787	0.408687
chr4	55898131	55898238	U6	107	0.420561
chr4	55944425	55991762	KDR	47337	0.407187
chr4	56212387	56239266	SRD5A3	26879	0.446408
chr4	56230139	56249563	SRD5A3-AS1	19424	0.422158
chr4	56232767	56251747	SRD5A3-AS1	18980	0.417229
chr4	56262079	56292342	TMEM165	30263	0.404487
chr4	56294067	56413076	CLOCK	119009	0.373745
chr4	56406668	56407002	7SK	334	0.505988
chr4	56422691	56458379	PDCL2	35688	0.389991
chr4	56461397	56502465	NMU	41068	0.378616
chr4	56664801	56664897	U6	96	0.354167
chr4	56686236	56703430	LOC644145	17194	0.357218
chr4	56719815	56771244	EXOC1	51429	0.349764
chr4	56751760	56751867	U6	107	0.364486
chr4	56814973	56899529	CEP135	84556	0.378365
chr4	57036360	57196890	KIAA1211	160530	0.417093
chr4	57204456	57253638	AASDH	49182	0.389655
chr4	57259528	57301802	PPAT	42274	0.374604
chr4	57302268	57327534	PAICS	25266	0.394720
chr4	57333761	57369847	SRP72	36086	0.377930
chr4	57371374	57390058	ARL9	18684	0.422126
chr4	57396774	57469489	THEGL	72715	0.406642
chr4	57514153	57522688	HOPX	8535	0.470650
chr4	57676025	57687908	SPINK2	11883	0.446436
chr4	57775078	57802010	REST	26932	0.416085
chr4	57829515	57843826	NOA1	14311	0.451191
chr4	57845108	57897334	POLR2B	52226	0.399035
chr4	57868857	57868958	U6	101	0.386139
chr4	57897236	57976551	IGFBP7	79315	0.424623
chr4	57975927	58071465	LOC255130	95538	0.432310
chr4	58292037	58332152	BC034799	40115	0.393120
chr4	62362838	62938168	LPHN3	575330	0.354614
chr4	62941883	62944051	BC039452	2168	0.303967
chr4	65144176	65275178	TECRL	131002	0.336712
chr4	65779998	65870218	LOC401134	90220	0.340357
chr4	66185280	66535653	EPHA5	350373	0.333584
chr4	66535678	66559104	LOC100144602	23426	0.346154
chr4	66931099	66931170	TRNA	71	0.338028
chr4	67762979	67763089	U6	110	0.354545
chr4	68283022	68333969	AK093203	50947	0.372780
chr4	68337988	68411256	CENPC1	73268	0.367268
chr4	68424445	68472616	STAP1	48171	0.378028
chr4	68481478	68566889	UBA6	85411	0.354872
chr4	68566995	68588222	LOC550112	21227	0.419513
chr4	68603098	68621804	GNRHR	18706	0.341227
chr4	68608242	68609312	BC045560	1070	0.377570
chr4	68686593	68749716	TMPRSS11D	63123	0.357730
chr4	68776018	68829232	TMPRSS11A	53214	0.372045
chr4	68857529	68863157	TMPRSS11GP	5628	0.345238
chr4	68918915	68995587	TMPRSS11F	76672	0.357093
chr4	68919225	68938951	LOC550113	19726	0.360185
chr4	68927539	68928987	SYT14L	1448	0.366713
chr4	69048009	69078188	FTLP10	30179	0.381093
chr4	69054241	69083798	TMPRSS11BNL	29557	0.367358
chr4	69092370	69111412	TMPRSS11B	19042	0.354059
chr4	69176104	69215824	YTHDC1	39720	0.354079
chr4	69313166	69363322	TMPRSS11E	50156	0.366915
chr4	69402902	69434245	UGT2B17	31343	0.356858
chr4	69512314	69536494	UGT2B15	24180	0.348801
chr4	69681712	69697741	UGT2B10	16029	0.330339
chr4	69794176	69817509	UGT2A3	23333	0.340633
chr4	69870294	69886113	UGT2B10	15819	0.328592
chr4	69962192	69978705	UGT2B7	16513	0.332950
chr4	70066050	70080449	UGT2B11	14399	0.323703
chr4	70066137	70082484	AK124272	16347	0.324096
chr4	70146216	70160768	UGT2B28	14552	0.325179
chr4	70345882	70361626	UGT2B4	15744	0.340320
chr4	70454134	70518967	UGT2A1	64833	0.340907
chr4	70592685	70626430	SULT1B1	33745	0.367343
chr4	70706929	70725870	SULT1E1	18941	0.332401
chr4	70796798	70812288	CSN1S1	15490	0.314396
chr4	70820973	70826726	CSN2	5753	0.320007
chr4	70861647	70868173	STATH	6526	0.320104
chr4	70894129	70902255	HTN3	8126	0.323529
chr4	70916158	70924559	HTN1	8401	0.327580
chr4	70934768	70950988	CSN1S2AP	16220	0.332922
chr4	70999320	71012421	CSN1S2BP	13101	0.331730
chr4	71019903	71032326	C4orf40	12423	0.354021
chr4	71062243	71070293	ODAM	8050	0.329938
chr4	71091787	71100968	FDCSP	9181	0.335911
chr4	71108332	71117145	CSN3	8813	0.313514
chr4	71200670	71202833	CABS1	2163	0.374480
chr4	71226492	71232823	SMR3A	6331	0.365029
chr4	71263598	71275914	PROL1	12316	0.359126
chr4	71337833	71348714	MUC7	10881	0.386637
chr4	71384297	71398459	AMTN	14162	0.376077
chr4	71457974	71473004	AMBN	15030	0.372854
chr4	71494460	71512536	ENAM	18076	0.383049
chr4	71521257	71532348	IGJ	11091	0.368677
chr4	71554195	71556268	UTP3	2073	0.448143
chr4	71567471	71567575	U6	104	0.346154
chr4	71587695	71674336	RUFY3	86641	0.391327
chr4	71681498	71705627	GRSF1	24129	0.434829
chr4	71768056	71853891	MOB1B	85835	0.399697
chr4	71859264	71896629	DCK	37365	0.386404
chr4	72053002	72437804	SLC4A4	384802	0.374891
chr4	72607410	72669758	GC	62348	0.364599
chr4	72897520	73013918	NPFFR2	116398	0.367755
chr4	73146685	73434516	ADAMTS3	287831	0.357748
chr4	73920415	73935472	COX18	15057	0.408714
chr4	73940501	74124502	ANKRD17	184001	0.362237
chr4	74269971	74287129	ALB	17158	0.353946
chr4	74301932	74321492	AFP	19560	0.345450
chr4	74347461	74369718	AFM	22257	0.362538
chr4	74374519	74394250	LOC728040	19731	0.391921
chr4	74437266	74486348	RASSF6	49082	0.370828
chr4	74606222	74609433	IL8	3211	0.320461
chr4	74702272	74704477	CXCL6	2205	0.406349
chr4	74719012	74720198	PF4V1	1186	0.492411
chr4	74735108	74737019	CXCL1	1911	0.494505
chr4	74846541	74847841	PF4	1300	0.497692
chr4	74852155	74853907	PPBP	1752	0.382991
chr4	74861358	74864446	CXCL5	3088	0.383744
chr4	74902311	74904490	CXCL3	2179	0.474989
chr4	74902785	74904490	CXCL3	1705	0.516716
chr4	74919754	74921116	PPBPP2	1362	0.441997
chr4	74962753	74964997	CXCL2	2244	0.481283
chr4	75023828	75168814	MTHFD2L	144986	0.360573
chr4	75022231	75024087	LOC541467	1856	0.473599
chr4	75144013	75196255	BC016361	52242	0.361070
chr4	75174186	75182520	EPGN	8334	0.359731
chr4	75230859	75254477	EREG	23618	0.366373
chr4	75310852	75490485	AREG	179633	0.316757
chr4	75671447	75719882	BTC	48435	0.375699
chr4	75858284	75975325	PARM1	117041	0.404756
chr4	75881183	75895572	AK027257	14389	0.380013
chr4	76279285	76287776	LOC441025	8491	0.388882
chr4	76404246	76439640	RCHY1	35394	0.347008
chr4	76439653	76455236	THAP6	15583	0.367195
chr4	76481257	76491103	C4orf26	9846	0.426163
chr4	76501703	76555721	CDKL2	54018	0.390592
chr4	76567952	76598667	G3BP2	30715	0.383721
chr4	76648696	76649795	AK311578	1099	0.473157
chr4	76649828	76735366	USO1	85538	0.373366
chr4	76781025	76823681	PPEF2	42656	0.434335
chr4	76834808	76862166	NAAA	27358	0.443673
chr4	76871067	76912113	SDAD1	41046	0.404010
chr4	76922622	76928641	CXCL9	6019	0.387107
chr4	76995847	77033955	ART3	38108	0.392962
chr4	76942268	76944689	CXCL10	2421	0.369682
chr4	76954839	76957350	CXCL11	2511	0.340502
chr4	77035816	77069655	NUP54	33839	0.367948
chr4	77079891	77135052	SCARB2	55161	0.412465
chr4	77172852	77204936	FAM47E	32084	0.410672
chr4	77227178	77232283	STBD1	5105	0.515769
chr4	77234191	77328458	CCDC158	94267	0.381321
chr4	77244661	77244705	U7	44	0.295455
chr4	77356252	77704405	SHROOM3	348153	0.412672
chr4	77494720	77494785	MIR4450	65	0.584615
chr4	77806697	77807718	DQ576800	1021	0.483839
chr4	77816081	77819002	SOWAHB	2921	0.593290
chr4	77870894	77959768	SEPT11	88874	0.406351
chr4	77969176	77997125	CCNI	27949	0.392393
chr4	78078356	78091213	CCNG2	12857	0.412771
chr4	78432906	78532988	CXCL13	100082	0.407496
chr4	78634540	78740544	CNOT6L	106004	0.361666
chr4	78783804	78873944	MRPL1	90140	0.378112
chr4	78978723	79465423	FRAS1	486700	0.397532
chr4	79178464	79178484	DL491209	20	0.500000
chr4	79472741	79531605	ANXA3	58864	0.399854
chr4	79567147	79605655	LOC100505702	38508	0.395528
chr4	79697531	79833341	BMP2K	135810	0.357617
chr4	79839093	79860582	PAQR3	21489	0.372563
chr4	79892901	80229953	LOC100505875	337052	0.369038
chr4	80238271	80247171	NAA11	8900	0.390112
chr4	80327506	80329372	GK2	1866	0.430332
chr4	80413746	80497614	LOC100506035	83868	0.362296
chr4	80748624	80784401	PCAT4	35777	0.354697
chr4	80898661	80994477	ANTXR2	95816	0.355452
chr4	81118656	81125482	PRDM8	6826	0.491650
chr4	81187741	81212171	FGF5	24430	0.359190
chr4	81256873	81884910	C4orf22	628037	0.357423
chr4	81952118	81978685	BMP3	26567	0.372643
chr4	82009836	82126214	PRKG2	116378	0.370147
chr4	82348218	82393061	RASGEF1B	44843	0.397966
chr4	83095699	83095806	U6	107	0.383178
chr4	83274466	83295149	HNRNPD	20683	0.383648
chr4	83343716	83351378	HNRPDL	7662	0.415557
chr4	83351725	83382244	ENOPH1	30519	0.431600
chr4	83405603	83483126	TMEM150C	77523	0.417231
chr4	83534265	83542590	LINC00575	8325	0.466426
chr4	83550689	83720010	SCD5	169321	0.435711
chr4	83674489	83674583	MIR575	94	0.542553
chr4	83739813	83812419	SEC31A	72606	0.385671
chr4	83814701	83820460	AK128593	5759	0.365341
chr4	83821836	83841284	THAP9	19448	0.369395
chr4	83845755	83931982	LIN54	86227	0.391061
chr4	83956238	83996971	COPS4	40733	0.398718
chr4	84011210	84031012	PLAC8	19802	0.411777
chr4	84184976	84206067	COQ2	21091	0.392964
chr4	84213613	84256034	HPSE	42421	0.410457
chr4	84328498	84377025	HELQ	48527	0.384652
chr4	84377117	84382929	MRPS18C	5812	0.376635
chr4	84382093	84406290	FAM175A	24197	0.397611
chr4	84457259	84527027	AGPAT9	69768	0.400155
chr4	84889234	85220322	AK095285	331088	0.376093
chr4	85414435	85419387	NKX6-1	4952	0.522617
chr4	85504056	85572493	CDS1	68437	0.384310
chr4	85590692	85887544	WDFY3	296852	0.368786
chr4	85887970	85928168	WDFY3-AS2	40198	0.376462
chr4	86396283	86923823	ARHGAP24	527540	0.367477
chr4	86643620	86643686	MIR4451	66	0.515152
chr4	86936275	87374283	MAPK10	438008	0.368799
chr4	87040961	87141079	BC038746	100118	0.357159
chr4	87257470	87257767	7SK	297	0.420875
chr4	87515467	87736328	PTPN13	220861	0.361549
chr4	87744620	87770416	SLC10A6	25796	0.409792
chr4	87797357	87813575	C4orf36	16218	0.415033
chr4	87846045	87856002	LOC100506746	9957	0.422216
chr4	87856153	88062206	AFF1	206053	0.411850
chr4	88082213	88141674	KLHL8	59461	0.376465
chr4	88221646	88221735	MIR5705	89	0.561798
chr4	88224940	88244056	HSD17B13	19116	0.392028
chr4	88257690	88312455	HSD17B11	54765	0.398740
chr4	88343727	88380606	NUDT9	36879	0.389327
chr4	88394487	88450655	SPARCL1	56168	0.398323
chr4	88529680	88538025	DSPP	8345	0.410665
chr4	88571453	88585512	DMP1	14059	0.383811
chr4	88720701	88733601	IBSP	12900	0.361163
chr4	88754120	88767968	MEPE	13848	0.380849
chr4	88896801	88904563	SPP1	7762	0.363695
chr4	88928798	88998931	PKD2	70133	0.405130
chr4	89011415	89080011	ABCG2	68596	0.409514
chr4	89178760	89205983	PPM1K	27223	0.399662
chr4	89206093	89252573	BC027846	46480	0.412823
chr4	89299890	89364249	HERC6	64359	0.396666
chr4	89378267	89427319	HERC5	49052	0.394010
chr4	89442128	89444952	PYURF	2824	0.446176
chr4	89442724	89442940	PIGY	216	0.444444
chr4	89504816	89505123	7SK	307	0.442997
chr4	89513573	89629693	HERC3	116120	0.390432
chr4	89617065	89619023	NAP1L5	1958	0.435649
chr4	89642865	89651254	FAM13A-AS1	8389	0.406604
chr4	89647104	89978346	FAM13A	331242	0.379312
chr4	90033967	90036052	TIGD2	2085	0.383693
chr4	90162420	90164636	AK026379	2216	0.358303
chr4	90165428	90229161	GPRIN3	63733	0.393564
chr4	90645249	90759447	SNCA	114198	0.361162
chr4	90653059	90653090	DQ571524	31	0.451613
chr4	90757551	90763142	LOC644248	5591	0.419424
chr4	90816051	90875780	MMRN1	59729	0.340488
chr4	91048683	92523370	CCSER1	1474687	0.351548
chr4	91291273	91291578	7SK	305	0.416393
chr4	93183648	93198453	EF565118	14805	0.384600
chr4	93225549	94693649	GRID2	1468100	0.347436
chr4	94750077	94751142	ATOH1	1065	0.641315
chr4	95128758	95212443	SMARCAD1	83685	0.360160
chr4	95219706	95264027	HPGDS	44321	0.385348
chr4	95373007	95589378	PDLIM5	216371	0.368927
chr4	95972829	96079601	BMPR1B	106772	0.360104
chr4	96083655	96470361	UNC5C	386706	0.374067
chr4	96761238	96762625	PDHA2	1387	0.465032
chr4	97269888	97270189	7SK	301	0.508306
chr4	98288076	98411315	STPG2-AS1	123239	0.364260
chr4	98480024	99064391	STPG2	584367	0.357469
chr4	99182526	99365012	RAP1GDS1	182486	0.360093
chr4	99391517	99579812	TSPAN5	188295	0.419337
chr4	99792835	99795886	AK098333	3051	0.398230
chr4	99799606	99850243	EIF4E	50637	0.389044
chr4	99916787	99983960	METAP1	67173	0.390886
chr4	99918537	99918611	MIR3684	74	0.364865
chr4	99992129	100009931	ADH5	17802	0.403269
chr4	100010007	100222513	LOC100507053	212506	0.389010
chr4	100010007	100023944	LOC100507053	13937	0.407692
chr4	100044832	100065449	ADH4	20617	0.367464
chr4	100081750	100082804	PCNAP1	1054	0.364326
chr4	100123794	100140403	ADH6	16609	0.374255
chr4	100175085	100196208	BC038532	21123	0.391422
chr4	100197522	100212185	ADH1A	14663	0.355589
chr4	100227526	100242572	ADH1B	15046	0.353981
chr4	100257648	100273917	ADH1C	16269	0.355646
chr4	100333417	100356291	ADH7	22874	0.369677
chr4	100432160	100463460	C4orf17	31300	0.375879
chr4	100467863	100485189	TRMT10A	17326	0.350341
chr4	100485239	100545154	MTTP	59915	0.358625
chr4	100557687	100571614	AL832378	13927	0.385941
chr4	100737980	100791346	DAPP1	53366	0.386969
chr4	100799494	100815703	LAMTOR3	16209	0.351471
chr4	100817406	100867883	DNAJB14	50477	0.348060
chr4	100869243	100871512	H2AFZ	2269	0.492287
chr4	100871635	100873620	LOC256880	1985	0.471537
chr4	101107026	101111655	DDIT4L	4629	0.416937
chr4	101316497	101439250	EMCN	122753	0.351967
chr4	101581435	101596270	EMCN-IT3	14835	0.353151
chr4	101944586	102268628	PPP3CA	324042	0.357160
chr4	102268933	102270040	FLJ20021	1107	0.621500
chr4	102711763	102995969	BANK1	284206	0.352016
chr4	103182820	103266655	SLC39A8	83835	0.379531
chr4	103422485	103538459	NFKB1	115974	0.378628
chr4	103552642	103682151	MANBA	129509	0.392521
chr4	103717132	103748708	UBE2D3	31576	0.372435
chr4	103749290	103765255	AK093356	15965	0.389728
chr4	103790134	103813963	CISD2	23829	0.389525
chr4	103822084	103940896	SLC9B1	118812	0.374861
chr4	103946651	103998170	SLC9B2	51519	0.372018
chr4	103998781	104021024	BDH2	22243	0.382727
chr4	104026962	104119566	CENPE	92604	0.346724
chr4	104510624	104640973	TACR3	130349	0.357456
chr4	105389462	105416058	CXXC4	26596	0.353136
chr4	105412121	105597345	AK094561	185224	0.367685
chr4	106067841	106200960	TET2	133119	0.360985
chr4	106290233	106395227	PPA2	104994	0.366459
chr4	106473776	106602070	ARHGEF38	128294	0.364865
chr4	106482747	106491392	ARHGEF38-IT1	8645	0.370503
chr4	106603784	106629881	INTS12	26097	0.364525
chr4	106631969	106768882	GSTCD	136913	0.355598
chr4	106816596	106892828	NPNT	76232	0.369005
chr4	106967232	107237423	TBCK	270191	0.358606
chr4	107236766	107270381	AIMP1	33615	0.366830
chr4	107279339	107288592	GIMD1	9253	0.358911
chr4	107842958	107957453	DKK2	114495	0.362243
chr4	108534821	108641419	PAPSS1	106598	0.384623
chr4	108745720	108836204	SGMS2	90484	0.380222
chr4	108784634	108853275	AK123292	68641	0.376583
chr4	108852716	108874613	CYP2U1	21897	0.401516
chr4	108910869	108956331	HADH	45462	0.431261
chr4	108968700	109090112	LEF1	121412	0.400208
chr4	109088680	109097586	LEF1-AS1	8906	0.517179
chr4	109093275	109097586	LEF1-AS1	4311	0.502900
chr4	109459345	109541613	RPL34-AS1	82268	0.400545
chr4	109541721	109551639	RPL34	9918	0.414801
chr4	109571740	109588978	OSTC	17238	0.395696
chr4	109663201	109684235	AGXT2L1	21034	0.397119
chr4	109731876	110223799	COL25A1	491923	0.369161
chr4	110268630	110335566	AK058136	66936	0.403609
chr4	110351118	110354973	SEC24B-AS1	3855	0.436576
chr4	110354970	110461615	SEC24B	106645	0.378424
chr4	110481354	110608872	CCDC109B	127518	0.410805
chr4	110609784	110624629	CASP6	14845	0.444325
chr4	110631144	110651242	PLA2G12A	20098	0.390188
chr4	110661847	110723335	CFI	61488	0.379944
chr4	110736665	110745893	GAR1	9228	0.393693
chr4	110749149	110765861	RRH	16712	0.373624
chr4	110769339	110793471	LRIT3	24132	0.378916
chr4	110834039	110934118	EGF	100079	0.391441
chr4	110970228	111119771	ELOVL6	149543	0.397812
chr4	111397228	111484493	ENPEP	87265	0.369163
chr4	111538579	111563279	PITX2	24700	0.493684
chr4	113066552	113110237	C4orf32	43685	0.370264
chr4	113152894	113191211	AP1AR	38317	0.364877
chr4	113196781	113207059	TIFA	10278	0.405916
chr4	113218498	113363764	ALPK1	145266	0.402758
chr4	113434671	113437328	NEUROG2	2657	0.565676
chr4	113460488	113558151	C4orf21	97663	0.379939
chr4	113558611	113578748	LARP7	20137	0.375081
chr4	113569029	113569713	MIR302B	684	0.381579
chr4	113970784	114304896	ANK2	334112	0.365581
chr4	114028018	114028111	MIR1243	93	0.301075
chr4	114372187	114683083	CAMK2D	310896	0.359866
chr4	114793924	114799347	AX747415	5423	0.382076
chr4	114821439	114900878	ARSJ	79439	0.364040
chr4	115519610	115598202	UGT8	78592	0.362403
chr4	115577914	115578010	MIR577	96	0.395833
chr4	115748926	116035032	NDST4	286106	0.345812
chr4	117220880	117220924	MIR1973	44	0.477273
chr4	118004709	118006736	TRAM1L1	2027	0.407499
chr4	118955499	119179789	NDST3	224290	0.361862
chr4	119199916	119200978	SNHG8	1062	0.454802
chr4	119200344	119200475	SNORA24	131	0.450382
chr4	119201192	119273922	PRSS12	72730	0.363784
chr4	119434236	119435886	AK308309	1650	0.387273
chr4	119437494	119475359	CEP170P1	37865	0.358643
chr4	119512927	119554881	AK024248	41954	0.466058
chr4	119555287	119555319	DQ575010	32	0.562500
chr4	119585242	119605621	BC035733	20379	0.392365
chr4	119606573	119632077	METTL14	25504	0.369236
chr4	119643977	119757326	SEC24D	113349	0.387635
chr4	119809995	119982402	SYNPO2	172407	0.384149
chr4	120056938	120108944	MYOZ2	52006	0.366381
chr4	120114527	120133799	AK309988	19272	0.384703
chr4	120133781	120216673	USP53	82892	0.360180
chr4	120217573	120225600	C4orf3	8027	0.428927
chr4	120238404	120243316	FABP2	4912	0.322068
chr4	120299286	120326770	AK097701	27484	0.412858
chr4	120326677	120331815	FLJ14186	5138	0.584663
chr4	120370724	120375783	BC070391	5059	0.447519
chr4	120375937	120420747	LOC645513	44810	0.374492
chr4	120415549	120549981	PDE5A	134432	0.364020
chr4	120433527	120473183	AF085995	39656	0.360526
chr4	120548944	120551908	AX746903	2964	0.501687
chr4	120720260	120725670	BC038750	5410	0.371349
chr4	120980578	120988013	MAD2L1	7435	0.371486
chr4	121615928	121844013	PRDM5	228085	0.376298
chr4	121731623	121731724	U6	101	0.405941
chr4	121956781	121993673	NDNF	36892	0.385043
chr4	121982326	121982633	7SK	307	0.521173
chr4	122052563	122148621	TNIP3	96058	0.371432
chr4	122113951	122114058	U6	107	0.373832
chr4	122249796	122302181	QRFPR	52385	0.386752
chr4	122589151	122618147	ANXA5	28996	0.389709
chr4	122680084	122686340	TMEM155	6256	0.417519
chr4	122685739	122687963	PP12613	2224	0.544065
chr4	122722471	122738176	EXOSC9	15705	0.377141
chr4	122737598	122745088	CCNA2	7490	0.394393
chr4	122745483	122791652	BBS7	46169	0.356235
chr4	122800182	122872909	TRPC3	72727	0.378333
chr4	123091757	123283914	KIAA1109	192157	0.343568
chr4	123300594	123350947	ADAD1	50353	0.363454
chr4	123372625	123377650	IL2	5025	0.318806
chr4	123533782	123542212	IL21	8430	0.386240
chr4	123540137	123610315	BC045668	70178	0.400396
chr4	123651343	123653613	CETN4P	2270	0.338767
chr4	123653856	123666098	BBS12	12242	0.396831
chr4	123747862	123819390	FGF2	71528	0.387401
chr4	123813798	123843761	NUDT6	29963	0.376164
chr4	123844224	124240604	SPATA5	396380	0.373944
chr4	124317949	124324915	SPRY1	6966	0.487080
chr4	124571421	124589231	LOC285419	17810	0.382313
chr4	125421096	125479589	AK057455	58493	0.350982
chr4	125585203	125633887	ANKRD50	48684	0.351491
chr4	126237566	126414087	FAT4	176521	0.344333
chr4	126428413	126428462	MIR2054	49	0.163265
chr4	128554086	128637934	INTU	83848	0.367963
chr4	128651554	128695447	SLC25A31	43893	0.365753
chr4	128703452	128754526	HSPA4L	51074	0.349512
chr4	128758921	128761884	AK090904	2963	0.370570
chr4	128802015	128820377	PLK4	18362	0.363196
chr4	128813145	128813237	U6	92	0.402174
chr4	128838959	128887139	MFSD8	48180	0.392051
chr4	128886460	128952455	C4orf29	65995	0.399015
chr4	128982502	129132289	LARP1B	149787	0.391029
chr4	129190391	129209984	PGRMC2	19593	0.386362
chr4	129349224	129440549	AK093416	91325	0.401927
chr4	129730778	129796379	PHF17	65601	0.442051
chr4	129805151	130014764	SCLT1	209613	0.359739
chr4	130017281	130033843	C4orf33	16562	0.349354
chr4	130645325	130692633	BC035172	47308	0.346686
chr4	130701164	130876523	BC041448	175359	0.356298
chr4	132649252	132651166	BC131768	1914	0.638453
chr4	134015015	134070268	BC040219	55253	0.343094
chr4	134070469	134112732	PCDH10	42263	0.333743
chr4	134114523	134115760	BC042378	1237	0.294260
chr4	135117488	135122903	PABPC4L	5415	0.360295
chr4	135226556	135248601	BC032916	22045	0.345566
chr4	138114909	138119521	BC031238	4612	0.329792
chr4	138440073	138453629	PCDH18	13556	0.365963
chr4	138948576	139051839	LINC00616	103263	0.385947
chr4	139010167	139099331	SLC7A11-AS1	89164	0.373301
chr4	139085247	139163503	SLC7A11	78256	0.355142
chr4	139230864	139345498	LINC00499	114634	0.376267
chr4	139936942	139967095	CCRN4L	30153	0.448115
chr4	139978870	140005568	ELF2	26698	0.381751
chr4	140187316	140201492	MGARP	14176	0.407026
chr4	140211070	140223705	NDUFC1	12635	0.435378
chr4	140222675	140311935	NAA15	89260	0.384898
chr4	140374960	140397069	RAB33B	22109	0.408793
chr4	140427191	140477577	SETD7	50386	0.415215
chr4	140586921	140625406	MGST2	38485	0.431259
chr4	140637545	141075233	MAML3	437688	0.415938
chr4	140715278	140715587	7SK	309	0.420712
chr4	141049168	141056276	BC040304	7108	0.423607
chr4	141264596	141303710	SCOC	39114	0.389068
chr4	141204879	141294546	LOC100129858	89667	0.408567
chr4	141309606	141348815	CLGN	39209	0.358642
chr4	141364528	141419531	LOC152586	55003	0.364217
chr4	141445311	141474924	ELMOD2	29613	0.348057
chr4	141481049	141489959	UCP1	8910	0.402357
chr4	141541935	141677471	TBC1D9	135536	0.411544
chr4	141562344	141564234	TNRC18P1	1890	0.525926
chr4	141786724	142054616	RNF150	267892	0.382591
chr4	142142048	142155850	ZNF330	13802	0.349007
chr4	142242282	142247161	AK124399	4879	0.378971
chr4	142557748	142655140	IL15	97392	0.371355
chr4	142949181	143767604	INPP4B	818423	0.363965
chr4	144106069	144143141	USP38	37072	0.356253
chr4	144257982	144395718	GAB1	137736	0.386043
chr4	144434615	144478642	SMARCA5	44027	0.355123
chr4	144434624	144435760	AK307172	1136	0.612676
chr4	144480624	144489313	AX721289	8689	0.404995
chr4	144498560	144621828	FREM3	123268	0.395090
chr4	144792018	144826716	GYPE	34698	0.377457
chr4	144833483	144903605	BC029578	70122	0.382576
chr4	145030455	145061904	GYPA	31449	0.366148
chr4	145564067	145567171	HHIP-AS1	3104	0.472294
chr4	145567147	145659881	HHIP	92734	0.363222
chr4	145772723	145795939	BC044611	23216	0.379264
chr4	145915726	146019371	ANAPC10	103645	0.375638
chr4	146019155	146050676	ABCE1	31521	0.349323
chr4	146054801	146100832	OTUD4	46031	0.380635
chr4	146402950	146480325	SMAD1	77375	0.382152
chr4	146418229	146424123	BC042377	5894	0.372752
chr4	146540539	146581187	MMAA	40648	0.392295
chr4	146601355	146653948	C4orf51	52593	0.416158
chr4	146681887	146859607	ZNF827	177720	0.415541
chr4	147030606	147043065	LOC100505545	12459	0.419937
chr4	147096834	147111213	LSM6	14379	0.385145
chr4	147175136	147443123	SLC10A7	267987	0.369514
chr4	147560044	147563623	POU4F2	3579	0.494272
chr4	147628178	147867034	TTC29	238856	0.365182
chr4	148402068	148466106	EDNRA	64038	0.387801
chr4	148538538	148556672	TMEM184C	18134	0.377964
chr4	148559533	148605280	PRMT10	45747	0.397206
chr4	148653452	148993927	ARHGAP10	340475	0.409170
chr4	148703745	148703819	MIR4799	74	0.432432
chr4	148999914	149363672	NR3C2	363758	0.382889
chr4	150351084	150736980	BC031092	385896	0.356891
chr4	150855527	150855635	U6	108	0.388889
chr4	150999425	151178608	DCLK2	179183	0.407215
chr4	151185810	151936649	LRBA	750839	0.362235
chr4	151500240	151502697	AK096995	2457	0.455840
chr4	151503076	151505845	MAB21L2	2769	0.520766
chr4	152020724	152025804	RPS3A	5080	0.415551
chr4	152023208	152023280	SNORD73	72	0.277778
chr4	152041432	152147660	SH3D19	106228	0.402182
chr4	152198324	152212605	PRSS48	14281	0.398151
chr4	152330397	152584784	FAM160A1	254387	0.394195
chr4	152497917	152498068	7SK	151	0.443709
chr4	152591808	152682175	PET112	90367	0.438180
chr4	152877142	152890533	BC035179	13391	0.418341
chr4	153021969	153025789	BC040914	3820	0.463351
chr4	153242409	153456185	FBXW7	213776	0.352280
chr4	153410478	153410568	MIR3140	90	0.366667
chr4	153457415	153460415	DKFZP434I0714	3000	0.435667
chr4	153547265	153601317	TMEM154	54052	0.415877
chr4	153690505	153700916	TIGD4	10411	0.383441
chr4	153701111	153833063	ARFIP1	131952	0.374545
chr4	153855667	153857989	BC039551	2322	0.569767
chr4	153864134	153900848	FHDC1	36714	0.439887
chr4	154125597	154260474	TRIM2	134877	0.413896
chr4	154186813	154186907	U6	94	0.361702
chr4	154228620	154229963	ANXA2P1	1343	0.466121
chr4	154229784	154229804	DJ439575	20	0.350000
chr4	154229871	154229897	DJ439526	26	0.538462
chr4	154265800	154336247	MND1	70447	0.390350
chr4	154387497	154557862	KIAA0922	170365	0.417838
chr4	154605440	154627242	TLR2	21802	0.385240
chr4	154631311	154681387	RNF175	50076	0.411275
chr4	154701741	154710228	SFRP2	8487	0.428302
chr4	155155526	155312449	DCHS2	156923	0.371679
chr4	155456148	155471585	PLRG1	15437	0.347023
chr4	155484131	155493915	FGB	9784	0.360793
chr4	155504279	155511897	FGA	7618	0.399842
chr4	155525727	155533902	FGG	8175	0.373700
chr4	155548096	155669472	DQ266889	121376	0.379375
chr4	155665162	155674270	LRAT	9108	0.381313
chr4	155702423	155749965	RBM46	47542	0.346199
chr4	156129780	156138228	NPY2R	8448	0.396307
chr4	156263811	156298122	MAP9	34311	0.337559
chr4	156587861	156658214	GUCY1A3	70353	0.367973
chr4	156680125	156728783	GUCY1B3	48658	0.365181
chr4	156750880	156787425	ASIC5	36545	0.349186
chr4	156824844	156841558	TDO2	16714	0.339715
chr4	156845269	156875048	CTSO	29779	0.382854
chr4	157682762	157892546	PDGFC	209784	0.359384
chr4	157997276	158093242	GLRB	95966	0.351770
chr4	158141735	158287226	GRIA2	145491	0.342207
chr4	158493641	158497303	LOC340017	3662	0.432277
chr4	159045731	159094202	FAM198B	48471	0.371005
chr4	159091915	159092632	AK126266	717	0.617852
chr4	159093403	159123393	AK096792	29990	0.386062
chr4	159097458	159122065	AK126266	24607	0.382940
chr4	159131400	159176439	TMEM144	45039	0.380359
chr4	159191529	159198693	AK094909	7164	0.367253
chr4	159316545	159316686	U4	141	0.390071
chr4	159442865	159574521	RXFP1	131656	0.379269
chr4	159587826	159593202	C4orf46	5376	0.402902
chr4	159593276	159629841	ETFDH	36565	0.381239
chr4	159630278	159644552	PPID	14274	0.389800
chr4	159690181	159827954	FNIP2	137773	0.406538
chr4	159814683	159956333	C4orf45	141650	0.401377
chr4	160049953	160050046	MIR3688-1	93	0.354839
chr4	160049956	160050043	MIR3688-2	87	0.356322
chr4	160188997	160281301	RAPGEF2	92304	0.359432
chr4	162305043	163085186	FSTL5	780143	0.338166
chr4	162943884	162968702	BC033991	24818	0.335563
chr4	164049822	164088073	NAF1	38251	0.360566
chr4	164245116	164253947	NPY1R	8831	0.390669
chr4	164265090	164273086	NPY5R	7996	0.381691
chr4	164392246	164395047	TKTL2	2801	0.455195
chr4	164415672	164441691	TMA16	26019	0.367885
chr4	164445449	165304407	MARCH1	858958	0.355789
chr4	164749951	164750265	7SK	314	0.439490
chr4	165118158	165118863	ANP32C	705	0.483688
chr4	165630610	165630646	MIR5684	36	0.555556
chr4	165675282	165724947	LOC100505989	49665	0.386610
chr4	165798155	165818676	LOC100506013	20521	0.374592
chr4	165875597	165898818	TRIM61	23221	0.407433
chr4	165878099	165880273	FAM218A	2174	0.397884
chr4	165953150	165962896	TRIM60	9746	0.434332
chr4	165997229	166034024	TMEM192	36795	0.443104
chr4	166131170	166244308	KLHL2	113138	0.378989
chr4	166198943	166201175	GK3P	2232	0.452061
chr4	166214274	166214461	U2	187	0.395722
chr4	166248817	166264314	MSMO1	15497	0.370072
chr4	166300096	166419482	CPE	119386	0.383077
chr4	166307393	166307489	MIR578	96	0.343750
chr4	166321809	166321894	JA611274	85	0.411765
chr4	166594738	166594774	HV970138	36	0.388889
chr4	166794409	167025609	TLL1	231200	0.357003
chr4	167081748	167081777	HV970138	29	0.344828
chr4	167654535	168155741	SPOCK3	501206	0.348126
chr4	169013687	169108893	ANXA10	95206	0.358717
chr4	169137441	169239958	DDX60	102517	0.362730
chr4	169277885	169401638	DDX60L	123753	0.379853
chr4	169418216	169849608	PALLD	431392	0.398693
chr4	169908741	169931468	CBR4	22727	0.367712
chr4	170015406	170192249	SH3RF1	176843	0.392704
chr4	170314420	170533778	NEK1	219358	0.370791
chr4	170541671	170644338	CLCN3	102667	0.367518
chr4	170650618	170679093	C4orf27	28475	0.385988
chr4	170838911	170897053	LOC100506085	58142	0.425820
chr4	170907747	170947429	MFAP3L	39682	0.420241
chr4	170952925	170954179	BC031941	1254	0.481659
chr4	170981372	171011183	AADAT	29811	0.376639
chr4	171961752	171980311	LOC100506122	18559	0.354868
chr4	172734574	173961558	GALNTL6	1226984	0.365087
chr4	173551082	173585413	BC038759	34331	0.367481
chr4	173908347	173916913	BC137484	8566	0.393299
chr4	174053083	174090803	BC040577	37720	0.398701
chr4	174089903	174245118	GALNT7	155215	0.389808
chr4	174252526	174254920	HMGB2	2394	0.390560
chr4	174292092	174298683	SAP30	6591	0.405705
chr4	174309298	174320617	SCRG1	11319	0.372736
chr4	174447651	174451378	HAND2	3727	0.567212
chr4	174451608	174463082	NBLA00301	11474	0.442740
chr4	175015810	175141549	AK125257	125739	0.367595
chr4	175157809	175205402	FBXO8	47593	0.339294
chr4	175205054	175254531	CEP44	49477	0.355984
chr4	175344945	175345015	MIR4276	70	0.485714
chr4	175411327	175444049	HPGD	32722	0.366970
chr4	175474212	175474248	HH834010	36	0.333333
chr4	175563197	175750465	GLRA3	187268	0.354775
chr4	175750818	175791938	AK093264	41120	0.358925
chr4	175839508	175899331	ADAM29	59823	0.360029
chr4	175848510	175848545	HH834010	35	0.257143
chr4	176554087	176923842	GPM6A	369755	0.357661
chr4	176711457	176733340	BC038536	21883	0.342503
chr4	176986984	177103979	WDR17	116995	0.342818
chr4	177019313	177019436	SNORA51	123	0.463415
chr4	177105724	177116822	SPATA4	11098	0.382411
chr4	177134825	177190373	ASB5	55548	0.364748
chr4	177241089	177253396	SPCS3	12307	0.368571
chr4	177604690	177713895	VEGFC	109205	0.355524
chr4	178102595	178102895	7SK	300	0.490000
chr4	178230990	178284092	NEIL3	53102	0.373376
chr4	178351928	178363657	AGA	11729	0.399011
chr4	178366132	178598280	AK094945	232148	0.380145
chr4	178502012	178502075	U7	63	0.333333
chr4	178649910	178911904	LOC285501	261994	0.356317
chr4	181985242	182080302	LINC00290	95060	0.376141
chr4	182756017	182756261	7SK	244	0.405738
chr4	182896308	183006289	AK056196	109981	0.394786
chr4	183060158	183065668	MGC45800	5510	0.523412
chr4	183245098	183724177	TENM3	479079	0.384884
chr4	183090445	183090531	MIR1305	86	0.360465
chr4	183469811	183469932	U2	121	0.421488
chr4	183811243	183838630	DCTD	27387	0.457516
chr4	183958817	183961272	FAM92A1P2	2455	0.394297
chr4	184018173	184020352	WWC2-AS2	2179	0.629647
chr4	184020462	184241929	WWC2	221467	0.393092
chr4	184090500	184090570	U7	70	0.357143
chr4	184154780	184161787	BX537950	7007	0.382760
chr4	184239219	184241927	CLDN22	2708	0.401034
chr4	184242916	184243579	CLDN24	663	0.511312
chr4	184365788	184369049	CDKN2AIP	3261	0.452009
chr4	184415889	184425668	LOC389247	9779	0.400859
chr4	184426219	184432249	ING2	6030	0.465340
chr4	184560788	184580331	RWDD4	19543	0.402190
chr4	184574724	184574829	U6	105	0.361905
chr4	184580419	184634747	TRAPPC11	54328	0.385124
chr4	184596755	184596868	U6	113	0.415929
chr4	184627083	184627184	U6	101	0.465347
chr4	184826508	184938875	STOX2	112367	0.423247
chr4	184940455	184944677	AK001394	4222	0.397916
chr4	185009858	185139114	ENPP6	129256	0.446486
chr4	185262183	185275130	LOC728175	12947	0.459411
chr4	185286340	185291024	AK126253	4684	0.441716
chr4	185308875	185395726	IRF2	86851	0.454192
chr4	185548849	185570629	CASP3	21780	0.404132
chr4	185570766	185616112	CCDC111	45346	0.413135
chr4	185615218	185655286	MLF1IP	40068	0.399845
chr4	185676748	185747215	ACSL1	70467	0.444407
chr4	185719450	185720200	SLED1	750	0.485333
chr4	185764449	185768200	LOC731424	3751	0.472941
chr4	185772166	185772264	MIR3945	98	0.448980
chr4	185814153	185820615	LOC100506229	6462	0.452646
chr4	185940082	185941926	HELT	1844	0.655640
chr4	185973049	186028402	BC043280	55353	0.400882
chr4	186064416	186071538	SLC25A4	7122	0.468548
chr4	186080818	186125182	KIAA1430	44364	0.404720
chr4	186131283	186285120	SNX25	153837	0.411578
chr4	186285031	186300152	LRP2BP	15121	0.406918
chr4	186317839	186321390	ANKRD37	3551	0.411433
chr4	186320693	186347139	UFSP2	26446	0.384217
chr4	186350544	186370821	C4orf47	20277	0.358732
chr4	186366337	186392913	CCDC110	26576	0.404350
chr4	186421814	186456712	PDLIM3	34898	0.400052
chr4	186506597	186877870	SORBS2	371273	0.403875
chr4	186947609	186947740	U4	131	0.450382
chr4	186990308	187006252	TLR3	15944	0.397642
chr4	187070326	187093817	FAM149A	23491	0.461964
chr4	187110185	187112644	FLJ38576	2459	0.498983
chr4	187112673	187134617	CYP4V2	21944	0.421209
chr4	187148671	187179625	KLKB1	30954	0.400982
chr4	187187117	187210835	F11	23718	0.399865
chr4	187207251	187422212	LOC285441	214961	0.420904
chr4	187337279	187422212	LOC285441	84933	0.431799
chr4	187422262	187422369	U6	107	0.551402
chr4	187454808	187476537	MTNR1A	21729	0.449307
chr4	187508936	187644987	FAT1	136051	0.411978
chr4	188225236	188426767	LOC339975	201531	0.391801
chr4	188916924	188926199	ZFP42	9275	0.445822
chr4	189012426	189026744	TRIML2	14318	0.435815
chr4	189060597	189068649	TRIML1	8052	0.479384
chr4	189376731	189459706	LOC401164	82975	0.393950
chr4	190784613	190860993	BC087857	76380	0.398717
chr4	190861973	190884359	FRG1	22386	0.359242
chr4	190903675	190906028	TUBB4Q	2353	0.609010
chr4	190945522	190948412	LOC100288255	2890	0.443253
chr4	190988992	190990372	DUX2	1380	0.732609
chr4	190992203	190993669	DUX4L6	1466	0.731241
chr4	190995582	190996962	DUX2	1380	0.734058
chr4	190998875	191000255	DUX4	1380	0.734058
chr4	191002089	191003549	DUX4L4	1460	0.729452
chr4	191005383	191010142	DUX4L5	4759	0.728094
chr4	191012062	191013442	DUX2	1380	0.734058
chr5	140372	190087	PLEKHG4B	49715	0.535010
chr5	191625	195468	LRRC14B	3843	0.627114
chr5	204874	218297	CCDC127	13423	0.505327
chr5	218355	256814	SDHA	38459	0.460672
chr5	271735	315089	PDCD6	43354	0.513009
chr5	304291	438405	AHRR	134114	0.522727
chr5	441642	443258	C5orf55	1616	0.563119
chr5	443333	467409	EXOC3	24076	0.504153
chr5	468366	472052	FLJ00157	3686	0.528215
chr5	470570	473078	AK023178	2508	0.559410
chr5	473333	524549	SLC9A3	51216	0.613988
chr5	478317	480999	BC013821	2682	0.634974
chr5	535954	535997	MIR4456	43	0.488372
chr5	602283	612325	LOC100996325	10042	0.594105
chr5	612404	653666	CEP72	41262	0.541782
chr5	659976	693510	TPPP	33534	0.617045
chr5	795719	851101	ZDHHC11	55382	0.479271
chr5	863849	892939	BRD9	29090	0.529770
chr5	892968	918164	TRIP13	25196	0.504167
chr5	988424	997455	LOC100506688	9031	0.519987
chr5	1009076	1038927	NKD2	29851	0.614753
chr5	1050488	1112172	SLC12A7	61684	0.620485
chr5	1063010	1063089	MIR4635	79	0.569620
chr5	1173255	1178720	BC032469	5465	0.580604
chr5	1201709	1225230	SLC6A19	23521	0.598104
chr5	1225469	1246304	SLC6A18	20835	0.582673
chr5	1253286	1295162	TERT	41876	0.584846
chr5	1309424	1309492	MIR4457	68	0.426471
chr5	1317999	1345002	CLPTM1L	27003	0.560790
chr5	1346095	1346126	DQ598099	31	0.580645
chr5	1363696	1380182	BC034612	16486	0.488596
chr5	1392904	1445543	SLC6A3	52639	0.546116
chr5	1461541	1524076	LPCAT1	62535	0.568050
chr5	1567596	1568684	CR749689	1088	0.477941
chr5	1568636	1579695	SDHAP3	11059	0.477258
chr5	1589336	1594646	SDHAP3	5310	0.492655
chr5	1597671	1634120	LOC728613	36449	0.502675
chr5	1708899	1708983	MIR4277	84	0.642857
chr5	1798498	1799956	MRPL36	1458	0.593278
chr5	1801495	1816167	NDUFS6	14672	0.483438
chr5	1877540	1882880	IRX4	5340	0.642884
chr5	2746278	2751769	IRX2	5491	0.590421
chr5	2752261	2755511	C5orf38	3250	0.588000
chr5	3417265	3536208	LOC285577	118943	0.421454
chr5	3596167	3601517	IRX1	5350	0.582243
chr5	4773620	4774978	BC034630	1358	0.377025
chr5	5034471	5070115	LOC340094	35644	0.403827
chr5	5132199	5134697	AK094462	2498	0.500801
chr5	5140442	5320412	ADAMTS16	179970	0.422370
chr5	5422785	5490347	KIAA0947	67562	0.385187
chr5	6310553	6337405	FLJ33360	26852	0.466371
chr5	6372038	6378639	MED10	6601	0.449932
chr5	6448735	6496834	UBE2QL1	48099	0.472733
chr5	6582286	6588613	LOC255167	6327	0.518887
chr5	6599351	6633473	NSUN2	34122	0.433562
chr5	6633499	6669675	SRD5A1	36176	0.446843
chr5	6714717	6757161	PAPD7	42444	0.467699
chr5	6827965	6828034	MIR4278	69	0.463768
chr5	7269415	7269467	MIR4454	52	0.538462
chr5	7299486	7306827	LOC442132	7341	0.521864
chr5	7396342	7830194	ADCY2	433852	0.409220
chr5	7830490	7851603	C5orf49	21113	0.447165
chr5	7859271	7869150	FASTKD3	9879	0.377265
chr5	7869216	7901235	MTRR	32019	0.395359
chr5	8333595	8457677	LOC729506	124082	0.389388
chr5	8457799	8463209	LOC100505738	5410	0.412754
chr5	8839876	8881636	BC032891	41760	0.401796
chr5	9035137	9546233	SEMA5A	511096	0.401788
chr5	9053927	9054007	MIR4636	80	0.450000
chr5	9546311	9550409	LOC100505806	4098	0.477550
chr5	9548938	9549026	SNORD123	88	0.397727
chr5	9629108	9630463	TAS2R1	1355	0.410332
chr5	9641426	9903936	LOC285692	262510	0.404887
chr5	10225619	10250021	FAM173B	24402	0.427055
chr5	10250281	10266501	CCT5	16220	0.435882
chr5	10277706	10308168	CMBL	30462	0.465465
chr5	10353750	10440500	MARCH6	86750	0.393464
chr5	10440846	10441963	ROPN1L-AS1	1117	0.552372
chr5	10441973	10465138	ROPN1L	23165	0.497259
chr5	10564434	10657928	ANKRD33B	93494	0.475742
chr5	10679341	10761387	DAP	82046	0.463106
chr5	10971951	11904110	CTNND2	932159	0.394286
chr5	12574968	12805295	CT49	230327	0.352447
chr5	13690436	13944589	DNAH5	254153	0.389663
chr5	14143828	14509458	TRIO	365630	0.433009
chr5	14581890	14616287	FAM105A	34397	0.428468
chr5	14664782	14699842	FAM105B	35060	0.416686
chr5	14704908	14871887	ANKH	166979	0.438642
chr5	14712802	14716638	LOC100130744	3836	0.524505
chr5	14826037	14826121	MIR4637	84	0.309524
chr5	15500304	15939900	FBXL7	439596	0.398181
chr5	16067473	16179897	MARCH11	112424	0.392185
chr5	16180349	16185681	BC043001	5332	0.426669
chr5	16451627	16465894	ZNF622	14267	0.406673
chr5	16473146	16617167	FAM134B	144021	0.423869
chr5	16662015	16936385	MYO10	274370	0.441029
chr5	17130136	17217531	LOC285696	87395	0.436959
chr5	17216931	17276954	BASP1	60023	0.415424
chr5	17345724	17346064	7SK	340	0.485294
chr5	17379014	17387419	LOC401177	8405	0.433551
chr5	17811560	17930598	BC028204	119038	0.361574
chr5	19473154	19988353	CDH18	515199	0.348207
chr5	20611948	20937800	AK093362	325852	0.355057
chr5	21459588	21497305	GUSBP1	37717	0.460721
chr5	21483857	21483889	DQ596041	32	0.562500
chr5	21484136	21484168	DQ591060	32	0.531250
chr5	21616370	21779631	BC038535	163261	0.347211
chr5	21750972	22853731	CDH12	1102759	0.352868
chr5	22142460	22152379	PMCHL1	9919	0.350539
chr5	23507723	23528706	PRDM9	20983	0.439975
chr5	23951456	24178372	AX747383	226916	0.349984
chr5	24487208	24645085	CDH10	157877	0.340024
chr5	24835388	24840692	LOC340107	5304	0.358786
chr5	26880708	27038689	CDH9	157981	0.335357
chr5	27472398	27485935	LOC643401	13537	0.353919
chr5	28926976	28927420	LSP1P3	444	0.472973
chr5	29143667	29153802	AK098570	10135	0.355007
chr5	29162522	29172465	AK098570	9943	0.352409
chr5	31193761	31329253	CDH6	135492	0.383085
chr5	31400601	31532282	DROSHA	131681	0.397445
chr5	31532372	31555165	C5orf22	22793	0.398807
chr5	31798995	32111038	PDZD2	312043	0.449473
chr5	31936207	31936265	MIR4279	58	0.586207
chr5	32124823	32174425	GOLPH3	49602	0.410951
chr5	32227110	32313114	MTMR12	86004	0.440875
chr5	32354455	32444844	ZFR	90389	0.383255
chr5	32585604	32604185	SUB1	18581	0.385824
chr5	32711437	32791830	NPR3	80393	0.409575
chr5	32947548	32962573	LOC340113	15025	0.393012
chr5	33440881	33468196	TARS	27315	0.383599
chr5	33527286	33892124	ADAMTS12	364838	0.404023
chr5	33888160	33888267	U6	107	0.429907
chr5	33936490	33939023	RXFP3	2533	0.621398
chr5	33944720	33984780	SLC45A2	40060	0.406640
chr5	33987090	34008220	AMACR	21130	0.413630
chr5	34017962	34043371	C1QTNF3	25409	0.395962
chr5	34190471	34190499	DQ587763	28	0.571429
chr5	34190888	34190926	DQ571461	38	0.631579
chr5	34192170	34192202	DQ578105	32	0.500000
chr5	34192387	34192434	DQ598168	47	0.617021
chr5	34192986	34193018	DQ578105	32	0.500000
chr5	34193203	34193250	DQ598168	47	0.617021
chr5	34193321	34193359	DQ571461	38	0.631579
chr5	34656595	34832717	RAI14	176122	0.420771
chr5	34839268	34899564	TTC23L	60296	0.398368
chr5	34905365	34915780	RAD1	10415	0.395775
chr5	34915819	34925787	BRIX1	9968	0.375602
chr5	34929697	34959069	DNAJC21	29372	0.392415
chr5	34998205	35048240	AGXT2	50035	0.423324
chr5	35055801	35230823	PRLR	175022	0.409954
chr5	35617988	35814713	SPEF2	196725	0.378015
chr5	35856976	35879705	IL7R	22729	0.390998
chr5	35904397	35938881	CAPSL	34484	0.416860
chr5	35953190	35991535	UGT3A1	38345	0.404590
chr5	36035118	36067023	UGT3A2	31905	0.414261
chr5	36098657	36102483	AK094621	3826	0.308416
chr5	36103413	36152015	LMBRD2	48602	0.360232
chr5	36147993	36148090	MIR580	97	0.298969
chr5	36152144	36184142	SKP2	31998	0.397962
chr5	36192693	36241900	NADKD1	49207	0.356718
chr5	36249103	36302011	RANBP3L	52908	0.367392
chr5	36606456	36688436	SLC1A3	81980	0.403611
chr5	36871462	36876796	LOC646719	5334	0.401950
chr5	36876860	37065921	NIPBL	189061	0.350596
chr5	37106329	37249530	C5orf42	143201	0.389397
chr5	37291940	37371197	NUP155	79257	0.417932
chr5	37379411	37752774	WDR70	373363	0.390057
chr5	37812778	37835929	GDNF	23151	0.440067
chr5	37873526	37875900	GDNF-AS1	2374	0.387953
chr5	38258510	38465582	EGFLAM	207072	0.426045
chr5	38282370	38291088	EGFLAM-AS4	8718	0.420280
chr5	38400552	38403573	EGFLAM-AS2	3021	0.400861
chr5	38475064	38595507	LIFR	120443	0.390193
chr5	38557415	38671318	BC045578	113903	0.414317
chr5	38557603	38557663	MIR3650	60	0.550000
chr5	38819803	38821581	AK126213	1778	0.318898
chr5	38846100	38935743	OSMR	89643	0.412614
chr5	38938021	39074501	RICTOR	136480	0.355268
chr5	39105353	39270759	FYB	165406	0.379388
chr5	39284377	39364655	C9	80278	0.372207
chr5	39371775	39425335	DAB2	53560	0.396639
chr5	39460971	39462400	BC026261	1429	0.380686
chr5	40269659	40269821	U1	162	0.493827
chr5	40680031	40693837	PTGER4	13806	0.419455
chr5	40711677	40756072	TTC33	44395	0.387296
chr5	40759480	40798297	PRKAA1	38817	0.375351
chr5	40825364	40829244	LOC100506548	3880	0.421134
chr5	40831429	40835387	RPL37	3958	0.419909
chr5	40832757	40832837	SNORD72	80	0.312500
chr5	40841409	40855456	CARD6	14047	0.419591
chr5	40909598	40983042	C7	73444	0.381229
chr5	40911168	40911230	U7	62	0.403226
chr5	40998121	41071444	MROH2B	73323	0.393969
chr5	41142247	41213695	C6	71448	0.369667
chr5	41175074	41175376	7SK	302	0.450331
chr5	41307047	41510730	PLCXD3	203683	0.373360
chr5	41730166	41870791	OXCT1	140625	0.375068
chr5	41904469	41921738	C5orf51	17269	0.356766
chr5	41925355	41941672	FBXO4	16317	0.389716
chr5	42155934	42175356	AK000840	19422	0.363196
chr5	42423876	42721980	GHR	298104	0.384721
chr5	42484766	42485933	GHR	1167	0.372751
chr5	42756919	42802539	CCDC152	45620	0.357124
chr5	42799981	42812024	SEPP1	12043	0.358299
chr5	42985502	42993435	AK056817	7933	0.450019
chr5	43016149	43018913	LOC648987	2764	0.517728
chr5	43039181	43040447	ANXA2R	1266	0.454976
chr5	43042235	43045370	LOC153684	3135	0.462520
chr5	43041717	43041745	DQ601842	28	0.464286
chr5	43065288	43067073	LOC100132356	1785	0.501401
chr5	43067124	43093660	LOC100506639	26536	0.463521
chr5	43121641	43175823	ZNF131	54182	0.428094
chr5	43192169	43280952	NIM1	88783	0.427131
chr5	43287571	43313614	HMGCS1	26043	0.387628
chr5	43381599	43412488	CCL28	30889	0.413901
chr5	43444353	43483992	C5orf28	39639	0.382855
chr5	43486802	43515273	C5orf34	28471	0.379404
chr5	43526369	43557195	PAIP1	30826	0.378220
chr5	43573286	43603332	LOC100652772	30046	0.414764
chr5	43603228	43705668	NNT	102440	0.379412
chr5	44305096	44388784	FGF10	83688	0.354173
chr5	44809026	44815618	MRPS30	6592	0.368477
chr5	45255051	45696220	HCN1	441169	0.347264
chr5	49692030	49737234	EMB	45204	0.367600
chr5	49962771	50142356	PARP8	179585	0.355664
chr5	50463374	50463481	U6	107	0.355140
chr5	50668570	50679166	LOC642366	10596	0.417988
chr5	50678957	50690563	ISL1	11606	0.448647
chr5	52083773	52098452	PELO	14679	0.393351
chr5	52083773	52249485	ITGA1	165712	0.367909
chr5	52251186	52255037	AK097288	3851	0.376266
chr5	52285155	52390609	ITGA2	105454	0.380128
chr5	52393894	52405325	MOCS2	11431	0.374420
chr5	52393894	52405598	MOCS2	11704	0.382177
chr5	52405686	52410952	LOC257396	5266	0.408090
chr5	52776263	52782304	FST	6041	0.470783
chr5	52856464	52979171	NDUFS4	122707	0.365668
chr5	53173885	53174803	BC048141	918	0.377996
chr5	53180613	53606403	ARL15	425790	0.384941
chr5	53207849	53207953	U6	104	0.355769
chr5	53247333	53247429	MIR581	96	0.364583
chr5	53751430	53752214	HSPB3	784	0.475765
chr5	53813592	53842416	SNX18	28824	0.426797
chr5	54273694	54281414	ESM1	7720	0.369819
chr5	54320106	54329960	GZMK	9854	0.404201
chr5	54398473	54406080	GZMA	7607	0.393059
chr5	54408798	54469005	CDC20B	60207	0.396333
chr5	54455983	54463129	GPX8	7146	0.388889
chr5	54466359	54466450	MIR449A	91	0.428571
chr5	54466473	54466570	MIR449B	97	0.484536
chr5	54468089	54468181	MIR449C	92	0.467391
chr5	54515424	54523143	MCIDAS	7719	0.527789
chr5	54526980	54529508	CCNO	2528	0.611551
chr5	54552072	54603521	DHX29	51449	0.370619
chr5	54603575	54721409	SKIV2L2	117834	0.368569
chr5	54720669	54830906	PPAP2A	110237	0.396310
chr5	54804677	54804754	MIR5687	77	0.363636
chr5	54824669	54830370	RNF138P1	5701	0.399754
chr5	54921672	55008554	SLC38A9	86882	0.387134
chr5	55033844	55112974	DDX4	79130	0.374586
chr5	55147206	55213165	IL31RA	65959	0.416304
chr5	55230924	55290821	IL6ST	59897	0.374142
chr5	55290994	55299475	FLJ31104	8481	0.429430
chr5	55395506	55529186	ANKRD55	133680	0.415754
chr5	55421497	55421597	U6	100	0.370000
chr5	55593390	55593516	U6atac	126	0.507937
chr5	56110899	56191978	MAP3K1	81079	0.382984
chr5	56205086	56213165	SETD9	8079	0.404382
chr5	56215428	56247954	MIER3	32526	0.381787
chr5	56509900	56560506	GPBP1	50606	0.387266
chr5	56775842	56778636	ACTBL2	2794	0.401933
chr5	57749809	57755966	PLK2	6157	0.417411
chr5	57787329	57792185	GAPT	4856	0.341227
chr5	57878938	58147406	RAB3C	268468	0.379818
chr5	58153128	58155222	AB074188	2094	0.357211
chr5	58264865	59189621	PDE4D	924756	0.373090
chr5	59783539	59822245	PART1	38706	0.397819
chr5	59892738	59995993	DEPDC1B	103255	0.386170
chr5	60047615	60140101	ELOVL7	92486	0.391767
chr5	60169658	60240905	ERCC8	71247	0.371651
chr5	60240955	60448864	NDUFAF2	207909	0.362991
chr5	60453535	60458302	SMIM15	4767	0.365849
chr5	60628099	60841999	ZSWIM6	213900	0.381744
chr5	60920227	60923894	BC032910	3667	0.488410
chr5	60933635	61002362	C5orf64	68727	0.432348
chr5	60954317	60983841	BC043229	29524	0.440997
chr5	60959971	60960066	U6	95	0.400000
chr5	61028616	61031495	BC039381	2879	0.433831
chr5	61601988	61683011	KIF2A	81023	0.386952
chr5	61684350	61699728	DIMT1	15378	0.405579
chr5	61714710	61924416	IPO11	209706	0.379355
chr5	61739002	61739109	U6	107	0.392523
chr5	61874561	61877275	LRRC70	2714	0.327192
chr5	63255874	63258119	HTR1A	2245	0.579955
chr5	63461670	63668696	RNF180	207026	0.365708
chr5	63801773	63908121	RGS7BP	106348	0.390745
chr5	63986134	64014017	FAM159B	27883	0.386508
chr5	64013977	64064496	SREK1IP1	50519	0.362022
chr5	64064754	64314590	CWC27	249836	0.355769
chr5	64444562	64777704	ADAMTS6	333142	0.359060
chr5	64813592	64858995	CENPK	45403	0.372751
chr5	64859062	64883376	PPWD1	24314	0.364646
chr5	64885506	64920187	TRIM23	34681	0.369165
chr5	64920557	64926532	TRAPPC13	5975	0.390460
chr5	64920557	64961954	TRAPPC13	41397	0.368288
chr5	64961754	65017941	SGTB	56187	0.393935
chr5	65018022	65125111	NLN	107089	0.401096
chr5	65222381	65376851	ERBB2IP	154470	0.373140
chr5	65240632	65241401	LOC100303749	769	0.342003
chr5	65440045	65479444	SREK1	39399	0.349780
chr5	65500950	65505274	BC028670	4324	0.462535
chr5	65892175	66465423	MAST4	573248	0.391987
chr5	66478103	66492617	CD180	14514	0.426829
chr5	67089040	67096886	BC042046	7846	0.382743
chr5	67511583	67597649	PIK3R1	86066	0.391978
chr5	68264369	68325754	AK128486	61385	0.405180
chr5	68389775	68426899	SLC30A5	37124	0.392253
chr5	68462836	68474070	CCNB1	11234	0.436354
chr5	68483211	68485293	DQ576994	2082	0.492795
chr5	68485374	68506184	CENPH	20810	0.426478
chr5	68513572	68525985	MRPS36	12413	0.425361
chr5	68530621	68573257	CDK7	42636	0.404728
chr5	68576518	68616407	CCDC125	39889	0.438341
chr5	68647552	68665409	TAF9	17857	0.413283
chr5	68660569	68665409	TAF9	4840	0.430992
chr5	68667280	68710630	RAD17	43350	0.391926
chr5	68710938	68737890	MARVELD2	26952	0.434921
chr5	68788118	68853931	OCLN	65813	0.428973
chr5	68856050	68888729	GTF2H2C	32679	0.382906
chr5	68902925	68919876	SMA	16951	0.444458
chr5	68933824	68938008	AK124130	4184	0.469885
chr5	68926979	68929028	LOC100272216	2049	0.595412
chr5	68927858	68927890	DQ574682	32	0.531250
chr5	68928137	68928169	DQ596042	32	0.562500
chr5	68930154	68930192	DQ571461	38	0.631579
chr5	68930812	68932308	DQ575504	1496	0.574198
chr5	68930970	68931008	DQ571461	38	0.631579
chr5	68931789	68931827	DQ571461	38	0.631579
chr5	69199602	69770097	SMA4	570495	0.383784
chr5	69194136	69194942	DQ575504	806	0.423077
chr5	69194994	69195032	DQ570150	38	0.631579
chr5	69195810	69195848	DQ570150	38	0.631579
chr5	69196626	69196664	DQ570150	38	0.631579
chr5	69197439	69197477	DQ570150	38	0.631579
chr5	69198236	69198960	DQ591060	724	0.606354
chr5	69321071	69338940	SERF1A	17869	0.436286
chr5	69321472	69321558	SERF1	86	0.627907
chr5	69345349	69373422	SMN2	28073	0.423432
chr5	69351644	69353243	BC045789	1599	0.425266
chr5	69388864	69407510	NAIP	18646	0.420251
chr5	69403207	69406827	DQ570835	3620	0.417680
chr5	69422504	69423523	SMA4	1019	0.469087
chr5	69497638	69554864	SMA4	57226	0.426275
chr5	69528629	69529176	DQ587763	547	0.574040
chr5	69717561	69746189	GTF2H2B	28628	0.374913
chr5	69776869	69881549	SMA5	104680	0.419679
chr5	69782327	69787614	LOC441081	5287	0.561377
chr5	69785799	69785837	DQ571461	38	0.631579
chr5	69786618	69786656	DQ571461	38	0.631579
chr5	70070876	70070914	DQ570150	38	0.631579
chr5	70071692	70071730	DQ570150	38	0.631579
chr5	70072505	70072543	DQ570150	38	0.631579
chr5	70073246	70074026	DQ591060	780	0.603846
chr5	70196489	70214357	SERF1A	17868	0.436255
chr5	70196890	70196976	SERF1	86	0.627907
chr5	70220767	70248842	SMN2	28075	0.423330
chr5	70227068	70228667	BC045789	1599	0.425266
chr5	70264309	70320941	NAIP	56632	0.431911
chr5	70278674	70282294	DQ570835	3620	0.417956
chr5	70291804	70292273	SMA3	469	0.428571
chr5	70330950	70363497	GTF2H2	32547	0.382432
chr5	70370029	70388897	LOC647859	18868	0.419281
chr5	70403559	70407180	DQ570835	3621	0.418393
chr5	70423727	70510559	SMA4	86832	0.378489
chr5	70529458	70529487	DQ577092	29	0.517241
chr5	70647681	70742169	AK123868	94488	0.361570
chr5	70671611	70681820	PMCHL2	10209	0.349300
chr5	70751441	70863649	BDP1	112208	0.398412
chr5	70883114	70954530	MCCC2	71416	0.411981
chr5	71014989	71016875	CARTPT	1886	0.518558
chr5	71403117	71505397	MAP1B	102280	0.422771
chr5	71465293	71465367	MIR4803	74	0.351351
chr5	71515235	71616084	MRPS27	100849	0.388631
chr5	71616199	71655180	PTCD2	38981	0.399759
chr5	71739233	71803249	ZNF366	64016	0.423254
chr5	72143929	72210215	TNPO1	66286	0.368962
chr5	72165554	72168159	AX746492	2605	0.386948
chr5	72174417	72174490	MIR4804	73	0.452055
chr5	72251807	72386349	FCHO2	134542	0.370397
chr5	72416387	72427644	TMEM171	11257	0.470374
chr5	72469022	72470970	TMEM174	1948	0.497947
chr5	72742084	72744352	FOXD1	2268	0.660494
chr5	72794249	72801448	BTF3	7199	0.385887
chr5	72848024	72861511	ANKRA2	13487	0.371691
chr5	72861597	72877794	UTP15	16197	0.376119
chr5	72921982	73237818	ARHGEF28	315836	0.393590
chr5	73618310	73624182	BC043537	5872	0.438181
chr5	73923230	73937249	ENC1	14019	0.456452
chr5	73980968	74017113	HEXB	36145	0.403486
chr5	74017030	74063042	GFM2	46012	0.363470
chr5	74062815	74072737	NSA2	9922	0.404858
chr5	74073398	74162663	FAM169A	89265	0.386400
chr5	74323288	74326724	GCNT4	3436	0.385914
chr5	74364121	74532703	ANKRD31	168582	0.373433
chr5	74632992	74657926	HMGCR	24934	0.372985
chr5	74666927	74807806	COL4A3BP	140879	0.370247
chr5	74807656	74895646	POLK	87990	0.364848
chr5	74907300	74967671	ANKDD1B	60371	0.413145
chr5	74970023	75013313	POC5	43290	0.372950
chr5	75379304	75621416	SV2C	242112	0.409814
chr5	75699148	76003957	IQGAP2	304809	0.404594
chr5	75911306	75919259	F2RL2	7953	0.406010
chr5	76008227	76008713	NCRUPAR	486	0.462963
chr5	76011867	76031595	F2R	19728	0.427970
chr5	76114832	76131140	F2RL1	16308	0.445242
chr5	76145825	76217056	S100Z	71231	0.437983
chr5	76248679	76265299	CRHBP	16620	0.431949
chr5	76264682	76264742	HV689151	60	0.433333
chr5	76326209	76361058	AGGF1	34849	0.388132
chr5	76372531	76383030	ZBED3	10499	0.450043
chr5	76376258	76376396	SNORA47	138	0.608696
chr5	76383883	76444176	ZBED3-AS1	60293	0.407527
chr5	76506705	76724080	PDE8B	217375	0.414703
chr5	76728068	76788332	WDR41	60264	0.378518
chr5	76924536	76934522	OTP	9986	0.473463
chr5	76986994	77072185	TBCA	85191	0.370156
chr5	77080957	77081267	HM358977	310	0.590323
chr5	77298149	77590579	AP3B1	292430	0.365646
chr5	77654629	77656170	BC039455	1541	0.517197
chr5	77656338	77776562	SCAMP1	120224	0.375865
chr5	77781037	77944648	LHFPL2	163611	0.440087
chr5	78073036	78282357	ARSB	209321	0.409997
chr5	78293428	78365449	DMGDH	72021	0.396690
chr5	78365546	78385897	BHMT2	20351	0.432067
chr5	78407603	78428113	BHMT	20510	0.416724
chr5	78531924	78623038	JMY	91114	0.402145
chr5	78669646	78809659	HOMER1	140013	0.371580
chr5	78908242	78982471	PAPD4	74229	0.361732
chr5	78985658	79096049	CMYA5	110391	0.406863
chr5	79272538	79287088	MTX3	14550	0.375052
chr5	79331169	79379107	THBS4	47938	0.435104
chr5	79362171	79379477	BC047373	17306	0.469317
chr5	79434549	79551898	SERINC5	117349	0.438214
chr5	79594916	79596297	LOC644936	1381	0.491673
chr5	79615789	79617660	SPZ1	1871	0.392304
chr5	79615793	79617658	SPZ1	1865	0.393029
chr5	79646423	79647785	CRSP8P	1362	0.518355
chr5	79703837	79775498	ZFYVE16	71661	0.376383
chr5	79783799	79838382	FAM151B	54583	0.389755
chr5	79852573	79866304	ANKRD34B	13731	0.430267
chr5	79922044	79950800	DHFR	28756	0.412366
chr5	79945818	79946854	MTRNR2L2	1036	0.404440
chr5	79950466	80172634	MSH3	222168	0.380244
chr5	80256507	80525981	RASGRF2	269474	0.409283
chr5	80501461	80746718	RNU5E-1	245257	0.403377
chr5	80529138	80562217	CKMT2	33079	0.443635
chr5	80533383	80597388	LOC100131067	64005	0.410062
chr5	80597401	80608965	ZCCHC9	11564	0.383172
chr5	80625946	80689988	ACOT12	64042	0.407561
chr5	80713178	81047072	SSBP2	333894	0.358928
chr5	81267843	81551216	ATG10	283373	0.378953
chr5	81569138	81574235	RPS23	5097	0.447322
chr5	81600752	81614147	ATP6AP1L	13395	0.414259
chr5	81678763	81682335	BC132949	3572	0.402856
chr5	82135973	82136043	MIR3977	70	0.342857
chr5	82348664	82373272	TMEM167A	24608	0.357323
chr5	82360022	82360156	SCARNA18	134	0.402985
chr5	82373316	82649579	XRCC4	276263	0.352038
chr5	82767492	82878122	VCAN	110630	0.371680
chr5	82934016	83016896	HAPLN1	82880	0.362271
chr5	83238125	83680611	EDIL3	442486	0.354832
chr5	85578261	85593365	NBPF22P	15104	0.444518
chr5	85913783	85916583	COX7C	2800	0.428214
chr5	85916313	85916392	MIR3607	79	0.379747
chr5	86042634	86045589	BC041393	2955	0.365144
chr5	86410695	86410771	MIR4280	76	0.434211
chr5	86415964	86543835	BC034940	127871	0.373877
chr5	86512422	86534798	BC126296	22376	0.379603
chr5	86564069	86687743	RASA1	123674	0.356930
chr5	86690078	86708850	CCNH	18772	0.369220
chr5	87491022	87564665	TMEM161B	73643	0.352090
chr5	87564840	87732491	TMEM161B-AS1	167651	0.372703
chr5	87960262	87972116	LINC00461	11854	0.439177
chr5	88014057	88199922	MEF2C	185865	0.360428
chr5	88185151	88263096	AL050132	77945	0.360305
chr5	89312437	89312537	MIR3660	100	0.380000
chr5	89689528	89705603	CETN3	16075	0.335863
chr5	89754019	89770585	MBLAC2	16566	0.368586
chr5	89770680	89810369	POLR3G	39689	0.369825
chr5	89811444	89825401	LYSMD3	13957	0.359103
chr5	89854616	90460033	GPR98	605417	0.371261
chr5	90606837	90610219	AK091866	3382	0.442933
chr5	90664540	90679149	ARRDC3	14609	0.357862
chr5	90676163	90716532	ARRDC3-AS1	40369	0.387599
chr5	91495353	91742351	AK056485	246998	0.281699
chr5	92745064	92906499	NR2F1-AS1	161435	0.368668
chr5	92919042	92929786	NR2F1	10744	0.512844
chr5	92953430	93447404	FAM172A	493974	0.363983
chr5	93076014	93077309	POU5F2	1295	0.572973
chr5	93486555	93954309	KIAA0825	467754	0.366556
chr5	93905171	93905195	DQ590013	24	0.500000
chr5	93954390	94031573	ANKRD32	77183	0.358745
chr5	94042288	94620279	MCTP1	577991	0.373172
chr5	94727047	94786144	FAM81B	59097	0.374012
chr5	94799598	94890709	TTC37	91111	0.355621
chr5	94890824	94940806	ARSK	49982	0.367152
chr5	94955979	94957284	GPR150	1305	0.740996
chr5	94982480	94992849	RFESD	10369	0.370913
chr5	94994019	95018714	SPATA9	24695	0.375299
chr5	95066849	95132071	RHOBTB3	65222	0.393242
chr5	95149552	95158577	GLRX	9025	0.456953
chr5	95187935	95195836	C5orf27	7901	0.461967
chr5	95220801	95297775	ELL2	76974	0.381700
chr5	95414841	95414916	MIR583	75	0.466667
chr5	95726039	95768985	PCSK1	42946	0.398803
chr5	95997906	96110385	CAST	112479	0.389166
chr5	96096513	96143892	ERAP1	47379	0.393191
chr5	96211643	96255406	ERAP2	43763	0.384114
chr5	96294155	96365115	LNPEP	70960	0.363670
chr5	96308117	96308599	BC107094	482	0.452282
chr5	96427573	96478520	LIX1	50947	0.392702
chr5	96496570	96519005	RIOK2	22435	0.367595
chr5	97674677	97674987	HM358988	310	0.577419
chr5	98104998	98132198	RGMB	27200	0.429743
chr5	98105321	98108788	RGMB-AS1	3467	0.464667
chr5	98190907	98262238	CHD1	71331	0.346609
chr5	98225434	98225537	U6	103	0.398058
chr5	98264837	98266713	LOC100289230	1876	0.461087
chr5	98858479	98858509	DQ597441	30	0.566667
chr5	98859298	98859327	DQ597441	29	0.551724
chr5	98860478	98860510	DQ596041	32	0.562500
chr5	98861081	98861113	DQ591060	32	0.531250
chr5	99382129	99382151	JB137812	22	0.500000
chr5	99715208	99723958	LOC100133050	8750	0.462514
chr5	99724630	99724662	DQ574682	32	0.531250
chr5	99725234	99725265	DQ596042	31	0.548387
chr5	99726415	99726445	DQ583509	30	0.566667
chr5	99871123	99922440	FAM174A	51317	0.355477
chr5	100142638	100238987	ST8SIA4	96349	0.341259
chr5	101569691	101632253	SLCO4C1	62562	0.349973
chr5	101707651	101834720	SLCO6A1	127069	0.358530
chr5	101944300	101948125	AX747345	3825	0.381176
chr5	102201526	102366808	PAM	165282	0.354195
chr5	102421703	102455842	GIN1	34139	0.359999
chr5	102465009	102539224	PPIP5K2	74215	0.334730
chr5	102594441	102614361	C5orf30	19920	0.374699
chr5	102884555	102898490	NUDT12	13935	0.340294
chr5	104435174	104435799	RAB9BP1	625	0.409600
chr5	106712589	107006596	EFNA5	294007	0.382743
chr5	107146329	107146625	7SK	296	0.449324
chr5	107194733	107717799	FBXL17	523066	0.358083
chr5	108063525	108063962	HP07349	437	0.636156
chr5	108065630	108067538	BC034788	1908	0.357966
chr5	108083522	108523373	FER	439851	0.356921
chr5	108528055	108530759	AK021888	2704	0.394601
chr5	108670409	108745675	PJA2	75266	0.376505
chr5	108674369	108674389	JB023059	20	0.300000
chr5	109025155	109203429	MAN2A1	178274	0.365959
chr5	109035200	109035535	7SK	335	0.474627
chr5	109218882	109221200	LOC100289673	2318	0.497412
chr5	109755197	110062450	TMEM232	307253	0.352625
chr5	110020494	110020628	SNORA51	134	0.477612
chr5	110074753	110098484	SLC25A46	23731	0.351565
chr5	110407389	110413722	TSLP	6333	0.411337
chr5	110427869	110466200	WDR36	38331	0.339255
chr5	110559946	110820748	CAMK4	260802	0.373291
chr5	110834021	110848157	STARD4	14136	0.368492
chr5	110847923	111075423	STARD4-AS1	227500	0.395380
chr5	111055465	111055758	7SK	293	0.447099
chr5	111064999	111312628	NREP	247629	0.380319
chr5	111248204	111353003	NREP-AS1	104799	0.383343
chr5	111498314	111755010	EPB41L4A	256696	0.393446
chr5	111496222	111498198	EPB41L4A-AS1	1976	0.466093
chr5	111497181	111497314	SNORA13	133	0.406015
chr5	111755279	111756677	FLJ11235	1398	0.617310
chr5	112073555	112181936	APC	108381	0.370083
chr5	112114059	112114166	U6	107	0.429907
chr5	112196884	112228776	SRP19	31892	0.419165
chr5	112212080	112258031	REEP5	45951	0.416008
chr5	112227308	112228791	ZRSR1	1483	0.472690
chr5	112312406	112357892	DCP2	45486	0.377699
chr5	112357795	112824527	MCC	466732	0.415540
chr5	112658724	112772038	FLJ43978	113314	0.398062
chr5	112768250	112770728	TSSK1B	2478	0.523810
chr5	112829531	112829657	U4atac	126	0.452381
chr5	112849390	112930984	YTHDC2	81594	0.346668
chr5	113589209	113589451	7SK	242	0.537190
chr5	113698015	113832197	KCNN2	134182	0.380394
chr5	113783114	113805508	AK097686	22394	0.392650
chr5	113807941	114109110	AK097686	301169	0.374547
chr5	114460458	114516243	TRIM36	55785	0.401757
chr5	114546526	114598569	PGGT1B	52043	0.356993
chr5	114602884	114632458	CCDC112	29574	0.361703
chr5	114856607	114880591	FEM1C	23984	0.356279
chr5	114914338	114961876	TMED7-TICAM2	47538	0.374269
chr5	115140429	115152405	CDO1	11976	0.398464
chr5	115163893	115177548	ATG12	13655	0.365947
chr5	115177618	115249778	AP3S1	72160	0.364773
chr5	115297020	115298980	AX747550	1960	0.617857
chr5	115298150	115363299	AQPEP	65149	0.377074
chr5	115387162	115394827	ARL14EPL	7665	0.396608
chr5	115420726	115628978	COMMD10	208252	0.358018
chr5	115779250	115910551	SEMA6A	131301	0.405595
chr5	116751207	116915439	LOC728342	164232	0.344330
chr5	117618268	117620462	BC044609	2194	0.504102
chr5	118172568	118324240	DTWD2	151672	0.377505
chr5	118310280	118310362	MIR1244-2	82	0.329268
chr5	118332002	118373361	BC036311	41359	0.392273
chr5	118407083	118584822	DMXL1	177739	0.367781
chr5	118691595	118730294	TNFAIP8	38699	0.406806
chr5	118788137	118878030	HSD17B4	89893	0.358270
chr5	118965253	118971517	FAM170A	6264	0.485313
chr5	119673243	119673348	U6	105	0.342857
chr5	119800018	120022964	PRR16	222946	0.355068
chr5	121187649	121188523	FTMT	874	0.581236
chr5	121297655	121364295	SRFBP1	66640	0.354877
chr5	121398889	121414055	LOX	15166	0.379335
chr5	121465214	121489266	ZNF474	24052	0.375021
chr5	121495870	121518358	LOC100505841	22488	0.384561
chr5	121647819	121799794	SNCAIP	151975	0.391143
chr5	121772191	121814782	MGC32805	42591	0.404334
chr5	121964646	122066254	BC043373	101608	0.383808
chr5	122110690	122170234	SNX2	59544	0.358592
chr5	122181159	122344902	SNX24	163743	0.400756
chr5	122359077	122372425	PPIC	13348	0.445835
chr5	122424840	122523745	PRDM6	98905	0.404085
chr5	122680578	122759286	CEP120	78708	0.361895
chr5	122881110	122952738	CSNK1G3	71628	0.338234
chr5	123972609	124080865	ZNF608	108256	0.403830
chr5	125695787	125829853	GRAMD3	134066	0.389539
chr5	125877532	125931082	ALDH7A1	53550	0.429991
chr5	125936606	125962944	PHAX	26338	0.432645
chr5	125967413	125971974	C5orf48	4561	0.417452
chr5	126091007	126091109	U6	102	0.382353
chr5	126112314	126172712	LMNB1	60398	0.423292
chr5	126187125	126189758	AX748201	2633	0.493733
chr5	126203405	126366500	MARCH3	163095	0.409835
chr5	126386995	126409184	C5orf63	22189	0.383974
chr5	126626455	126796910	MEGF10	170455	0.389669
chr5	126853308	126890780	PRRC1	37472	0.362778
chr5	126988706	126994322	CTXN3	5616	0.401353
chr5	127357243	127418766	FLJ33630	61523	0.372625
chr5	127419482	127525380	SLC12A2	105898	0.352273
chr5	127593600	127873735	FBN2	280135	0.368497
chr5	128301209	128369335	SLC27A6	68126	0.366747
chr5	128430441	128449719	ISOC1	19278	0.389356
chr5	128433380	128433459	MIR4633	79	0.569620
chr5	128732754	128732840	MIR4460	86	0.418605
chr5	128796102	129074376	ADAMTS19	278274	0.349206
chr5	129083883	129100756	KIAA1024L	16873	0.353049
chr5	129240522	129522327	CHSY3	281805	0.359089
chr5	130494975	130501041	HINT1	6066	0.440983
chr5	130506640	130541119	LYRM7	34479	0.380405
chr5	130599701	130730382	CDC42SE2	130681	0.396332
chr5	130759613	130970929	RAPGEF6	211316	0.378835
chr5	131142683	131281391	LOC728637	138708	0.390345
chr5	131285666	131347355	ACSL6	61689	0.479389
chr5	131396346	131398896	IL3	2550	0.492157
chr5	131409484	131411863	CSF2	2379	0.555275
chr5	131415758	131415826	SnoZ6	68	0.602941
chr5	131528303	131563556	P4HA2	35253	0.484441
chr5	131584600	131631008	BC030525	46408	0.514739
chr5	131593350	131609147	PDLIM4	15797	0.570235
chr5	131630144	131679899	SLC22A4	49755	0.449623
chr5	131646968	131705608	LOC553103	58640	0.436221
chr5	131694766	131695813	BC045788	1047	0.406877
chr5	131701181	131701291	MIR3936	110	0.518182
chr5	131701645	131705196	LOC553103	3551	0.379611
chr5	131705400	131731306	SLC22A5	25906	0.483710
chr5	131746464	131822549	C5orf56	76085	0.476743
chr5	131746464	131796622	C5orf56	50158	0.462319
chr5	131817300	131826465	IRF1	9165	0.537807
chr5	131877135	131879214	IL5	2079	0.328042
chr5	131892615	131980313	RAD50	87698	0.386428
chr5	131973739	131991846	BC042122	18107	0.422433
chr5	131993864	131996801	IL13	2937	0.559755
chr5	132009677	132018370	IL4	8693	0.479926
chr5	132028322	132073265	KIF3A	44943	0.366375
chr5	132083136	132089856	CCNI2	6720	0.498065
chr5	132086508	132113067	SEPT8	26559	0.521857
chr5	132149032	132152489	SOWAHA	3457	0.574197
chr5	132157832	132162002	SHROOM1	4170	0.622062
chr5	132196877	132200477	GDF9	3600	0.425833
chr5	132202318	132204536	UQCRQ	2218	0.493237
chr5	132209357	132210582	LEAP2	1225	0.448163
chr5	132211070	132299354	AFF4	88284	0.404286
chr5	132332677	132362240	ZCCHC10	29563	0.426885
chr5	132387661	132440709	HSPA4	53048	0.413738
chr5	132446759	132450167	AF086294	3408	0.509096
chr5	132532151	132948223	FSTL4	416072	0.466849
chr5	132763287	132763398	MIR1289-2	111	0.531532
chr5	133291197	133304406	C5orf15	13209	0.398062
chr5	133307565	133340824	VDAC1	33259	0.473857
chr5	133450401	133483920	TCF7	33519	0.558131
chr5	133492081	133512724	SKP1	20643	0.409534
chr5	133634114	133702765	CDKL3	68651	0.398159
chr5	133561447	133561543	MIR3661	96	0.583333
chr5	133706869	133727799	UBE2B	20930	0.415337
chr5	133737755	133747598	CDKN2AIPNL	9843	0.451996
chr5	133835868	133835975	U6	107	0.392523
chr5	133842304	133844921	BC032795	2617	0.523118
chr5	133861797	133918918	PHF15	57121	0.534637
chr5	133936838	133968533	SAR1B	31695	0.418142
chr5	133984474	134063601	SEC24A	79127	0.422511
chr5	134074169	134087850	CAMLG	13681	0.433521
chr5	134094460	134166812	DDX46	72352	0.412967
chr5	134181657	134195425	C5orf24	13768	0.415166
chr5	134209459	134237323	TXNDC15	27864	0.461169
chr5	134240809	134298336	PCBD2	57527	0.420220
chr5	134263728	134263802	MIR4461	74	0.486486
chr5	134303595	134347397	CATSPER3	43802	0.431898
chr5	134363423	134369964	PITX1	6541	0.583244
chr5	134368969	134680370	LOC100996485	311401	0.476469
chr5	134571923	134583867	LOC340073	11944	0.517498
chr5	134670070	134734928	H2AFY	64858	0.468161
chr5	134779903	134783038	C5orf20	3135	0.539713
chr5	134784557	134788089	TIFAB	3532	0.532276
chr5	134869971	134871639	NEUROG1	1668	0.601918
chr5	134906370	134914969	CXCL14	8599	0.520642
chr5	134984371	134989624	LOC340074	5253	0.457643
chr5	135170364	135224326	SLC25A48	53962	0.473815
chr5	135227934	135231516	IL9	3582	0.422390
chr5	135266005	135277367	FBXL21	11362	0.383383
chr5	135282599	135290723	LECT2	8124	0.388725
chr5	135364583	135399507	TGFBI	34924	0.489778
chr5	135416186	135416286	VTRNA2-1	100	0.570000
chr5	135465202	135470579	SMAD5-AS1	5377	0.453413
chr5	135468535	135518422	SMAD5	49887	0.369575
chr5	135527155	135528851	LOC389332	1696	0.667453
chr5	135548998	135701164	TRPC7	152166	0.425069
chr5	136310986	136835018	SPOCK1	524032	0.427594
chr5	136953188	137071779	KLHL3	118591	0.427132
chr5	136983260	136983338	MIR874	78	0.692308
chr5	137203544	137223540	MYOT	19996	0.369824
chr5	137087072	137090039	HNRNPA0	2967	0.485339
chr5	137136881	137146439	NPY6R	9558	0.394225
chr5	137225124	137276156	PKD2L2	51032	0.391284
chr5	137273641	137368802	FAM13B	95161	0.395561
chr5	137368481	137372955	AK310493	4474	0.471614
chr5	137419773	137427199	WNT8A	7426	0.485456
chr5	137450860	137475132	NME5	24272	0.413027
chr5	137475458	137514358	BRD8	38900	0.429897
chr5	137514416	137523404	KIF20A	8988	0.452715
chr5	137523336	137549032	CDC23	25696	0.412126
chr5	137588068	137610253	GFRA3	22185	0.473698
chr5	137620958	137667516	CDC25C	46558	0.434770
chr5	137673223	137685418	FAM53C	12195	0.495941
chr5	137673703	137685418	FAM53C	11715	0.490909
chr5	137688284	137772716	KDM3B	84432	0.431815
chr5	137774689	137782658	REEP2	7969	0.583386
chr5	137801180	137805004	EGR1	3824	0.565377
chr5	137841781	137878989	ETF1	37208	0.430391
chr5	137890570	137911318	HSPA9	20748	0.429535
chr5	137894658	137894728	SNORD63	70	0.428571
chr5	137896731	137896799	SNORD63	68	0.352941
chr5	138089106	138270723	CTNNA1	181617	0.416734
chr5	138205078	138211057	LRRTM2	5979	0.384847
chr5	138282409	138534065	SIL1	251656	0.444349
chr5	138629332	138667366	MATR3	38034	0.388021
chr5	138611868	138612009	SNORA74	141	0.531915
chr5	138614468	138614668	SNORA74A	200	0.480000
chr5	138677518	138705409	PAIP2	27891	0.433796
chr5	138702884	138719039	SLC23A1	16155	0.500712
chr5	138723256	138725605	MZB1	2349	0.587484
chr5	138727634	138730885	PROB1	3251	0.699477
chr5	138732455	138739776	SPATA24	7321	0.510449
chr5	138745891	138775214	DNAJC18	29323	0.438666
chr5	138784244	138842320	ECSCR	58076	0.069065
chr5	138855112	138862343	TMEM173	7231	0.536302
chr5	138940750	139008018	UBE2D2	67268	0.434917
chr5	139028300	139062680	CXXC5	34380	0.582548
chr5	139175405	139224048	PSD2	48643	0.517937
chr5	139226363	139422884	NRG2	196521	0.464200
chr5	139482506	139487597	LOC100505636	5091	0.404046
chr5	139493707	139499001	PURA	5294	0.399509
chr5	139505520	139508391	IGIP	2871	0.359805
chr5	139541537	139552636	CR627225	11099	0.447338
chr5	139554652	139623374	CYSTM1	68722	0.445505
chr5	139624634	139682689	PFDN1	58055	0.407803
chr5	139712427	139726188	HBEGF	13761	0.499310
chr5	139739786	139754722	SLC4A9	14936	0.513123
chr5	139780098	139781013	BC030152	915	0.577049
chr5	139781398	139929163	ANKHD1-EIF4EBP3	147765	0.389856
chr5	139927250	139929163	EIF4EBP3	1913	0.557763
chr5	139929651	139937041	SRA1	7390	0.463058
chr5	139937852	139944189	APBB3	6337	0.535585
chr5	139944419	139948683	SLC35A4	4264	0.537054
chr5	140011312	140013035	CD14	1723	0.601857
chr5	140019011	140024989	TMCO6	5978	0.513550
chr5	140024947	140027370	NDUFA2	2423	0.484523
chr5	140027383	140042065	IK	14682	0.445103
chr5	140037506	140037565	U7	59	0.322034
chr5	140044383	140050553	WDR55	6170	0.501945
chr5	140050380	140053171	DND1	2791	0.578646
chr5	140053489	140071312	HARS	17823	0.452225
chr5	140071017	140078890	HARS2	7873	0.458910
chr5	140080031	140086239	ZMAT2	6208	0.431379
chr5	140090860	140090958	VTRNA1-1	98	0.520408
chr5	140098510	140098598	VTRNA1-2	88	0.545455
chr5	140105743	140105831	VTRNA1-3	88	0.602273
chr5	140254930	140391929	PCDHA12	136999	0.395273
chr5	140240340	140243224	AX746964	2884	0.520458
chr5	140430978	140433512	PCDHB1	2534	0.483820
chr5	140474236	140476964	PCDHB2	2728	0.547654
chr5	140479828	140481794	BC016751	1966	0.488810
chr5	140480233	140483406	PCDHB3	3173	0.495430
chr5	140501580	140505201	PCDHB4	3621	0.457885
chr5	140514799	140517704	PCDHB5	2905	0.533563
chr5	140529838	140532868	PCDHB6	3030	0.506931
chr5	140535579	140537990	PCDHB17	2411	0.552468
chr5	140552242	140555957	PCDHB7	3715	0.475908
chr5	140557370	140560081	PCDHB8	2711	0.542604
chr5	140560979	140565796	PCDHB16	4817	0.450903
chr5	140566892	140571111	PCDHB9	4219	0.464565
chr5	140571951	140575213	PCDHB10	3262	0.485592
chr5	140579347	140582618	PCDHB11	3271	0.509324
chr5	140588290	140591698	PCDHB12	3408	0.482981
chr5	140593508	140596993	PCDHB13	3485	0.490100
chr5	140603077	140605860	PCDHB14	2783	0.499820
chr5	140613937	140617101	PCDHB18	3164	0.496207
chr5	140619688	140624312	PCDHB19P	4624	0.446799
chr5	140625146	140627801	PCDHB15	2655	0.529567
chr5	140682195	140683612	SLC25A2	1417	0.502470
chr5	140698056	140700351	TAF7	2295	0.433551
chr5	140868807	140892548	PCDHGC5	23741	0.516827
chr5	140805852	140807825	PCDHGB8P	1973	0.521541
chr5	140894587	140998622	DIAPH1	104035	0.412409
chr5	140937877	140944827	LOC100505658	6950	0.381295
chr5	141000442	141016423	HDAC3	15981	0.452287
chr5	141016516	141020631	RELL2	4115	0.600000
chr5	141018868	141030986	FCHSD1	12118	0.528223
chr5	141032967	141061800	ARAP3	28833	0.514376
chr5	141232672	141257944	PCDH1	25272	0.544278
chr5	141254323	141255029	BC127870	706	0.478754
chr5	141275190	141276260	LOC729080	1070	0.396262
chr5	141303384	141321612	KIAA0141	18228	0.482061
chr5	141324529	141338627	PCDH12	14098	0.505533
chr5	141348450	141369856	RNF14	21406	0.402644
chr5	141380233	141392620	GNPDA1	12387	0.465407
chr5	141488323	141534008	NDFIP1	45685	0.391420
chr5	141689991	141704620	SPRY4	14629	0.501196
chr5	141971742	142066060	FGF1	94318	0.449638
chr5	142005733	142005811	SNORA36	78	0.397436
chr5	142150291	142608572	ARHGAP26	458281	0.421414
chr5	142239169	142248475	ARHGAP26-AS1	9306	0.457984
chr5	142490048	142490068	JB162171	20	0.450000
chr5	142657495	142784045	NR3C1	126550	0.374603
chr5	143059424	143059536	MIR5197	112	0.392857
chr5	143191725	143200284	HMHB1	8559	0.400164
chr5	143537722	143550278	YIPF5	12556	0.357996
chr5	143550436	143856944	KCTD16	306508	0.379256
chr5	145138581	145214899	PRELID2	76318	0.395922
chr5	145239295	145252531	GRXCR2	13236	0.407072
chr5	145316125	145442879	SH3RF2	126754	0.420192
chr5	145463875	145483946	PLAC8L1	20071	0.411689
chr5	145492588	145562294	LARS	69706	0.387097
chr5	145583162	145668784	RBM27	85622	0.386758
chr5	145718586	145720083	POU4F3	1497	0.598530
chr5	145826872	145891069	TCERG1	64197	0.363911
chr5	145894416	145895676	GPR151	1260	0.500794
chr5	145969066	146258348	PPP2R2B	289282	0.401999
chr5	146293769	146299069	PPP2R2B-IT1	5300	0.377736
chr5	146614578	146763768	STK32A	149190	0.384644
chr5	146770370	146889619	DPYSL3	119249	0.414335
chr5	146939556	147041572	JAKMIP2-AS1	102016	0.389557
chr5	146965003	147162411	JAKMIP2	197408	0.382892
chr5	147204142	147211260	SPINK1	7118	0.367097
chr5	147258273	147261756	SCGB3A2	3483	0.399081
chr5	147272270	147286101	C5orf46	13831	0.382836
chr5	147443534	147516925	SPINK5	73391	0.350820
chr5	147549223	147554961	SPINK14	5738	0.372952
chr5	147582356	147594700	SPINK6	12344	0.338626
chr5	147647869	147763346	AK054753	115477	0.372325
chr5	147648281	147665773	SPINK13	17492	0.382346
chr5	147691989	147695481	SPINK7	3492	0.389175
chr5	147715121	147719412	SPINK9	4291	0.339082
chr5	147763497	147822399	FBXO38	58902	0.370463
chr5	147861114	148016624	HTR4	155510	0.384052
chr5	148206155	148208197	ADRB2	2042	0.505877
chr5	148361712	148442737	SH3TC2	81025	0.414563
chr5	148443065	148446548	AK056780	3483	0.424060
chr5	148521053	148639999	ABLIM3	118946	0.444193
chr5	148651400	148721367	AFAP1L1	69967	0.463290
chr5	148724976	148734146	GRPEL2	9170	0.413086
chr5	148737569	148749221	PCYOX1L	11652	0.501459
chr5	148753829	148758838	IL17B	5009	0.532841
chr5	148786525	148793646	BX640700	7121	0.528016
chr5	148808480	148810296	MIR143	1816	0.512665
chr5	148810223	148810247	JA483376	24	0.500000
chr5	148875456	148931115	CSNK1A1	55659	0.394581
chr5	148877796	148881757	BC005905	3961	0.376420
chr5	148961134	149014527	ARHGEF37	53393	0.461315
chr5	149109814	149234585	PPARGC1B	124771	0.490058
chr5	149237518	149324356	PDE6A	86838	0.433612
chr5	149340299	149366963	SLC26A2	26664	0.409053
chr5	149372685	149380730	TIGD6	8045	0.460659
chr5	149380168	149432706	HMGXB3	52538	0.432906
chr5	149432853	149492935	CSF1R	60082	0.481009
chr5	149493401	149535422	PDGFRB	42021	0.543443
chr5	149546343	149564121	CDX1	17778	0.537631
chr5	149569519	149590635	SLC6A7	21116	0.546079
chr5	149599053	149669403	CAMK2A	70350	0.520697
chr5	149675908	149682525	ARSI	6617	0.541635
chr5	149737201	149779871	TCOF1	42670	0.524490
chr5	149781199	149792499	CD74	11300	0.533097
chr5	149823791	149829319	RPS14	5528	0.491679
chr5	149887673	149937773	NDST1	50100	0.517026
chr5	149980641	150031903	SYNPO	51262	0.523409
chr5	150040402	150058930	MYOZ3	18528	0.490879
chr5	150070351	150074395	RBM22	4044	0.436202
chr5	150070351	150080669	RBM22	10318	0.432739
chr5	150088308	150138657	DCTN4	50349	0.387356
chr5	150157507	150176298	SMIM3	18791	0.433612
chr5	150226084	150228231	IRGM	2147	0.488589
chr5	150273953	150284545	ZNF300	10592	0.365842
chr5	150310018	150323539	ZNF300P1	13521	0.351675
chr5	150399998	150408554	GPX3	8556	0.530271
chr5	150409503	150466747	TNIP1	57244	0.502935
chr5	150480266	150537443	ANXA6	57177	0.490162
chr5	150560612	150585036	CCDC69	24424	0.429700
chr5	150560612	150603654	CCDC69	43042	0.457995
chr5	150632612	150649953	GM2A	17341	0.468370
chr5	150655925	150683334	SLC36A3	27409	0.427086
chr5	150694538	150727151	SLC36A2	32613	0.431668
chr5	150827162	150871940	SLC36A1	44778	0.438787
chr5	150883652	150948505	FAT2	64853	0.463525
chr5	151031839	151035010	BC034636	3171	0.405866
chr5	151040656	151066615	SPARC	25959	0.478832
chr5	151056508	151067468	BC039364	10960	0.469891
chr5	151122382	151138210	ATOX1	15828	0.460639
chr5	151149353	151151069	LOC100652758	1716	0.585082
chr5	151151475	151184915	G3BP1	33440	0.394498
chr5	151167423	151168131	AX747080	708	0.450565
chr5	151168141	151169671	AX747080	1530	0.454248
chr5	151202073	151304397	GLRA1	102324	0.416833
chr5	151329131	151650009	AK001582	320878	0.399392
chr5	151771101	151784840	NMUR2	13739	0.384307
chr5	151998524	152351909	AK123816	353385	0.374266
chr5	152871731	153193429	GRIA1	321698	0.411094
chr5	153371268	153418497	FAM114A2	47229	0.374918
chr5	153418518	153437014	MFAP3	18496	0.381272
chr5	153570294	153800543	GALNT10	230249	0.442860
chr5	153769328	153825382	SAP30L-AS1	56054	0.454401
chr5	153825516	153840613	SAP30L	15097	0.457574
chr5	153854531	153857824	HAND1	3293	0.560279
chr5	153975571	153975632	MIR3141	61	0.688525
chr5	154092461	154197167	LARP1	104706	0.465207
chr5	154198051	154230213	FAXDC2	32162	0.463559
chr5	154238198	154256352	CNOT8	18154	0.429437
chr5	154266975	154317776	GEMIN5	50801	0.413358
chr5	154320632	154348971	MRPL22	28339	0.388228
chr5	154393259	154397685	KIF4B	4426	0.459783
chr5	155753766	156194798	SGCD	441032	0.389908
chr5	156277548	156279539	PPP1R2P3	1991	0.368659
chr5	156346292	156390266	TIMD4	43974	0.426320
chr5	156456530	156485970	HAVCR1	29440	0.430537
chr5	156512842	156536248	HAVCR2	23406	0.431513
chr5	156565450	156569921	MED7	4471	0.449340
chr5	156589343	156593279	FAM71B	3936	0.487551
chr5	156607906	156682109	ITK	74203	0.412760
chr5	156693090	156822606	CYFIP2	129516	0.442895
chr5	156768606	156772729	FNDC9	4123	0.454038
chr5	156904311	157002831	ADAM19	98520	0.460079
chr5	156887026	156901730	NIPAL4	14704	0.478713
chr5	156887336	156895828	NIPAL4	8492	0.474093
chr5	157052686	157079428	SOX30	26742	0.404532
chr5	157098560	157107162	C5orf52	8602	0.483492
chr5	157158322	157166772	THG1L	8450	0.425917
chr5	157166794	157167910	AK000953	1116	0.456093
chr5	157170754	157183746	LSM11	12992	0.443119
chr5	157212750	157286183	CLINT1	73433	0.377718
chr5	157236105	157236212	U6	107	0.420561
chr5	158122922	158526788	EBF1	403866	0.399744
chr5	158527689	158544486	AK123543	16797	0.443115
chr5	158584416	158634834	RNF145	50418	0.358523
chr5	158690088	158713048	UBLCP1	22960	0.361760
chr5	158741790	158757481	IL12B	15691	0.418456
chr5	158745049	158745175	U4atac	126	0.468254
chr5	158758525	158789842	LOC285626	31317	0.412108
chr5	158875563	158893284	LOC285627	17721	0.441115
chr5	159343739	159400017	ADRA1B	56278	0.440367
chr5	159436179	159492550	TTC1	56371	0.413440
chr5	159518346	159546452	PWWP2A	28106	0.429695
chr5	159614373	159665729	FABP6	51356	0.485357
chr5	159623597	159631833	AK097242	8236	0.508135
chr5	159659130	159659151	HI423497	21	0.571429
chr5	159678670	159739573	CCNJL	60903	0.476906
chr5	159774774	159797648	C1QTNF2	22874	0.469791
chr5	159792546	159792568	JB074968	22	0.500000
chr5	159820154	159827060	C5orf54	6906	0.398204
chr5	159828647	159846168	SLU7	17521	0.369157
chr5	159848864	159855746	PTTG1	6882	0.393054
chr5	159895244	159914433	DQ658414	19189	0.426182
chr5	159901408	159901490	MIR3142	82	0.451219
chr5	159990126	160279219	ATP10B	289093	0.401881
chr5	160358785	160365633	LOC285629	6848	0.507447
chr5	160715435	160975130	GABRB2	259695	0.358728
chr5	161112657	161129598	GABRA6	16941	0.360014
chr5	161275541	161326965	GABRA1	51424	0.346045
chr5	161494647	161582545	GABRG2	87898	0.349962
chr5	162864576	162872022	CCNG1	7446	0.378458
chr5	162875115	162877423	AK124680	2308	0.336222
chr5	162880585	162887143	NUDCD2	6558	0.396615
chr5	162887516	162918953	HMMR	31437	0.368133
chr5	162909609	162921064	BC035392	11455	0.375557
chr5	162932533	162946359	MAT2B	13826	0.375018
chr5	163781145	164029423	BC011998	248278	0.357450
chr5	165036445	165036684	7SK	239	0.468619
chr5	166711842	167691162	TENM2	979320	0.403904
chr5	167460095	167460210	SNORA40	115	0.356522
chr5	167719064	167899308	WWC1	180244	0.465120
chr5	167816643	167816715	TRNA	72	0.458333
chr5	167913462	167946309	RARS	32847	0.394252
chr5	167956581	167957639	FBLL1	1058	0.663516
chr5	167975499	167979974	M55536	4475	0.337877
chr5	167982627	168006614	PANK3	23987	0.385167
chr5	167987900	167987978	MIR103A1	78	0.487179
chr5	167987908	167987970	MIR103B1	62	0.467742
chr5	168088737	168728133	SLIT3	639396	0.450056
chr5	168195150	168195260	MIR218-2	110	0.554545
chr5	168440268	168451992	AK098705	11724	0.447544
chr5	168690604	168690698	MIR585	94	0.542553
chr5	169010637	169031781	SPDL1	21144	0.372777
chr5	169064250	169510386	DOCK2	446136	0.433890
chr5	169290718	169407744	FAM196B	117026	0.436202
chr5	169455491	169455570	MIR378E	79	0.582278
chr5	169532916	169536729	FOXI1	3813	0.538683
chr5	169618650	169623637	AK055811	4987	0.460999
chr5	169659949	169673235	C5orf58	13286	0.404787
chr5	169675087	169724822	LCP2	49735	0.448296
chr5	169758434	169762104	LOC257358	3670	0.481744
chr5	169780468	169780583	DL490294	115	0.556522
chr5	169780880	170163636	KCNIP1	382756	0.462770
chr5	169805164	169816681	KCNMB1	11517	0.503343
chr5	170210722	170241050	GABRP	30328	0.435835
chr5	170288895	170727019	RANBP17	438124	0.373969
chr5	170732984	170735759	AX746723	2775	0.535496
chr5	170736287	170739138	TLX3	2851	0.667836
chr5	170813659	170813764	MIR3912	105	0.314286
chr5	170814707	170837888	NPM1	23181	0.433674
chr5	170846666	170884630	FGF18	37964	0.548546
chr5	171288555	171433877	FBXW11	145322	0.397187
chr5	171469073	171615346	STK10	146273	0.490152
chr5	171621175	171630458	EFCAB9	9283	0.458688
chr5	171636649	171710795	UBTD2	74146	0.412605
chr5	171760502	171881527	SH3PXD2B	121025	0.484437
chr5	172068275	172118533	NEURL1B	50258	0.507501
chr5	172195092	172198203	DUSP1	3111	0.530055
chr5	172261222	172379688	ERGIC1	118466	0.509260
chr5	172293439	172299820	BX648961	6381	0.504937
chr5	172381785	172385778	LOC100268168	3993	0.467819
chr5	172386438	172396774	RPL26L1	10336	0.449013
chr5	172410762	172461900	ATP6V0E1	51138	0.441531
chr5	172447728	172447932	SNORA74B	204	0.544118
chr5	172483354	172566291	CREBRF	82937	0.410746
chr5	172571444	172591390	BNIP1	19946	0.458688
chr5	172659106	172662315	NKX2-5	3209	0.618884
chr5	172741725	172756506	STC2	14781	0.509302
chr5	172789136	172789243	U6	107	0.355140
chr5	173006645	173012075	LOC285593	5430	0.450092
chr5	173034147	173043666	BOD1	9519	0.445740
chr5	173315330	173387313	CPEB4	71983	0.373421
chr5	173416161	173433143	C5orf47	16982	0.377341
chr5	173472606	173536182	HMP19	63576	0.461699
chr5	173518231	173536182	HMP19	17951	0.489945
chr5	174151574	174157902	MSX2	6328	0.468869
chr5	174178736	174178790	MIR4634	54	0.796296
chr5	174346084	174422734	FLJ16171	76650	0.418213
chr5	174867674	174871163	DRD1	3489	0.479507
chr5	174905513	174955621	SFXN1	50108	0.422707
chr5	175085039	175113245	HRH2	28206	0.500780
chr5	175298500	175311023	CPLX2	12523	0.543640
chr5	175386533	175395318	THOC3	8785	0.433466
chr5	175476680	175489025	BC042064	12345	0.441798
chr5	175490711	175541801	FAM153B	51090	0.447974
chr5	175547849	175559261	LOC100507387	11412	0.415703
chr5	175570087	175626298	LOC643201	56211	0.463379
chr5	175601379	175601409	DQ570256	30	0.500000
chr5	175601551	175601583	DQ578341	32	0.562500
chr5	175609743	175609774	DQ576909	31	0.516129
chr5	175610046	175610104	DQ601567	58	0.465517
chr5	175665369	175772990	SIMC1	107621	0.421925
chr5	175773065	175788809	KIAA1191	15744	0.468814
chr5	175792501	175800503	ARL10	8002	0.538740
chr5	175810939	175815763	NOP16	4824	0.489013
chr5	175815783	175816751	HIGD2A	968	0.578512
chr5	175819455	175843570	CLTB	24115	0.530914
chr5	175875355	175937075	FAF2	61720	0.427333
chr5	175953699	175964421	RNF44	10722	0.601660
chr5	175976342	176022769	CDHR2	46427	0.535615
chr5	176022802	176037131	GPRIN1	14329	0.553493
chr5	176047209	176057557	SNCB	10348	0.567839
chr5	176056439	176056501	MIR4281	62	0.774194
chr5	176057682	176073642	EIF4E1B	15960	0.522431
chr5	176074387	176086059	TSPAN17	11672	0.586960
chr5	176237559	176307899	UNC5A	70340	0.581319
chr5	176307869	176326333	HK3	18464	0.542786
chr5	176332005	176433795	UIMC1	101790	0.418784
chr5	176449696	176493745	ZNF346	44049	0.454880
chr5	176513920	176525126	FGFR4	11206	0.601285
chr5	176560832	176727214	NSD1	166382	0.421812
chr5	176728198	176730744	RAB24	2546	0.578162
chr5	176730762	176733960	PRELID1	3198	0.542839
chr5	176734205	176739292	MXD3	5087	0.609200
chr5	176758562	176778885	LMAN2	20323	0.505191
chr5	176784843	176799599	RGS14	14756	0.585389
chr5	176811431	176825849	SLC34A1	14418	0.556249
chr5	176827107	176827637	PFN3	530	0.713208
chr5	176829138	176836577	F12	7439	0.578841
chr5	176853686	176869850	GRK6	16164	0.587231
chr5	176864889	176874945	PRR7-AS1	10056	0.582637
chr5	176875325	176883287	PRR7	7962	0.603115
chr5	176883613	176900694	DBN1	17081	0.593174
chr5	176910394	176924602	PDLIM7	14208	0.607193
chr5	176930750	176936858	DOK3	6108	0.590537
chr5	176938577	176943967	DDX41	5390	0.591651
chr5	176946789	176981548	FAM193B	34759	0.499353
chr5	177019212	177023099	TMED9	3887	0.528943
chr5	177027118	177037346	B4GALT7	10228	0.578901
chr5	177053082	177099278	LOC202181	46196	0.410252
chr5	177150364	177207505	FAM153A	57141	0.445092
chr5	177302261	177311269	LOC728554	9008	0.433060
chr5	177378259	177384898	AK126616	6639	0.491038
chr5	177419235	177423243	PROP1	4008	0.543663
chr5	177433966	177476088	FAM153C	42122	0.450074
chr5	177540555	177553107	N4BP3	12552	0.605481
chr5	177558027	177575479	RMND5B	17452	0.493009
chr5	177576464	177580961	NHP2	4497	0.521681
chr5	177611510	177614433	GMCL1P1	2923	0.393774
chr5	177631507	177638184	HNRNPAB	6677	0.536618
chr5	177635539	177659803	AGXT2L2	24264	0.514960
chr5	177664616	178017556	COL23A1	352940	0.506180
chr5	178029664	178054054	CLK4	24390	0.384215
chr5	178138521	178157703	ZNF354A	19182	0.461422
chr5	178191863	178245436	AACSP1	53573	0.488082
chr5	178286953	178311424	ZNF354B	24471	0.455110
chr5	178322915	178360210	ZFP2	37295	0.423006
chr5	178368193	178393218	ZNF454	25025	0.432408
chr5	178368193	178383921	ZNF454	15728	0.449262
chr5	178405329	178422124	GRM6	16795	0.559274
chr5	178450775	178461388	ZNF879	10613	0.436163
chr5	178487606	178507691	ZNF354C	20085	0.431367
chr5	178537851	178772431	ADAMTS2	234580	0.538716
chr5	178949499	178950924	AX747985	1425	0.574035
chr5	178951447	178952173	AX747985	726	0.578512
chr5	178977561	179037027	RUFY1	59466	0.477046
chr5	179041178	179050711	HNRNPH1	9533	0.400818
chr5	179068557	179072047	C5orf60	3490	0.569914
chr5	179078542	179080234	AX747879	1692	0.562057
chr5	179105558	179107975	CBY3	2417	0.563509
chr5	179125929	179158639	CANX	32710	0.433293
chr5	179159850	179204287	MAML1	44437	0.476472
chr5	179220985	179223513	LTC4S	2528	0.665744
chr5	179224597	179233952	MGAT4B	9355	0.640513
chr5	179225277	179225346	MIR1229	69	0.666667
chr5	179247841	179265077	SQSTM1	17236	0.531678
chr5	179264265	179285840	C5orf45	21575	0.495620
chr5	179286012	179288282	BC040901	2270	0.462996
chr5	179289070	179334856	TBC1D9B	45786	0.542218
chr5	179382473	179499109	RNF130	116636	0.423471
chr5	179442302	179442397	MIR340	95	0.389474
chr5	179527794	179636130	RASGEF1C	108336	0.499511
chr5	179660594	179719071	MAPK9	58477	0.436052
chr5	179727699	179780315	GFPT2	52616	0.512354
chr5	179921416	180005353	CNOT6	83937	0.420756
chr5	180017104	180018487	SCGB3A1	1383	0.733189
chr5	180028505	180076624	FLT4	48119	0.602382
chr5	180110724	180110763	DQ589679	39	0.410256
chr5	180111832	180111866	DQ596879	34	0.617647
chr5	180112948	180112990	DQ579975	42	0.452381
chr5	180113363	180113396	DQ596473	33	0.515152
chr5	180113462	180113538	DQ570121	76	0.460526
chr5	180113666	180113724	DQ601567	58	0.465517
chr5	180166122	180167058	OR2Y1	936	0.513889
chr5	180217540	180230048	MGAT1	12508	0.507755
chr5	180256953	180258618	HEIH	1665	0.590991
chr5	180257956	180262726	LINC00847	4770	0.513837
chr5	180274610	180288286	ZFP62	13676	0.429219
chr5	180326076	180377906	BTNL8	51830	0.404553
chr5	180415844	180433727	BTNL3	17883	0.431975
chr5	180467224	180488523	BTNL9	21299	0.499178
chr5	180551356	180552304	OR2V1	948	0.536920
chr5	180581942	180582890	OR2V2	948	0.534810
chr5	180620923	180632177	TRIM7	11254	0.548872
chr5	180649565	180649633	MIR4638	68	0.720588
chr5	180649868	180657685	AX748230	7817	0.495970
chr5	180650262	180662808	TRIM41	12546	0.519528
chr5	180663927	180670906	GNB2L1	6979	0.503224
chr5	180668817	180668889	SNORD96A	72	0.527778
chr5	180670313	180670376	SNORD95	63	0.555556
chr5	180683385	180688119	TRIM52	4734	0.448880
chr5	180688212	180691567	LOC100507602	3355	0.556781
chr5	180748652	180753553	LOC100133331	4901	0.543767
chr5	180754160	180755054	LOC388312	894	0.634228
chr5	180794287	180795226	OR4F16	939	0.460064
chr5	180846762	180848396	BC036251	1634	0.431457
chr6	146549	146639	DQ584609	90	0.577778
chr6	292100	351355	DUSP22	59255	0.473412
chr6	391738	411443	IRF4	19705	0.483278
chr6	485137	693141	EXOC2	208004	0.405108
chr6	655938	656964	HUS1B	1026	0.566277
chr6	709104	711405	AX747750	2301	0.409387
chr6	775455	780214	AK093403	4759	0.451986
chr6	961240	1101567	LOC285768	140327	0.436181
chr6	1080163	1105181	AX747250	25018	0.441362
chr6	1312674	1314993	FOXQ1	2319	0.621389
chr6	1390068	1395832	FOXF2	5764	0.598716
chr6	1496349	1519556	BC087858	23207	0.460378
chr6	1513942	1513965	DD413621	23	0.391304
chr6	1610680	1614129	FOXC1	3449	0.533198
chr6	1624034	2245868	GMDS	621834	0.407760
chr6	1727166	1729106	AK024936	1940	0.369588
chr6	2452644	2484263	AK091028	31619	0.464499
chr6	2622971	2635298	C6orf195	12327	0.470350
chr6	2663862	2751154	MYLK4	87292	0.426030
chr6	2765665	2785979	WRNIP1	20314	0.445604
chr6	2832565	2842283	SERPINB1	9718	0.432805
chr6	2854264	2854341	MIR4645	77	0.441558
chr6	2854890	2876744	MGC39372	21854	0.472774
chr6	2884221	2900910	AY927512	16689	0.403200
chr6	2887499	2903546	SERPINB9	16047	0.437777
chr6	2948392	2971543	SERPINB6	23151	0.465336
chr6	3000066	3019994	NQO2	19928	0.474358
chr6	2988881	2991405	DKFZP686I15217	2524	0.517829
chr6	3020389	3025005	HTATSF1P2	4616	0.465988
chr6	3076997	3115421	RIPK1	38424	0.449277
chr6	3118925	3153432	BPHL	34507	0.469963
chr6	3153901	3157783	TUBB2A	3882	0.562597
chr6	3154098	3155151	TUBB2A	1053	0.629630
chr6	3183051	3196001	LOC100507194	12950	0.452432
chr6	3224494	3227968	TUBB2B	3474	0.571100
chr6	3224985	3226037	TUBB2A	1052	0.632129
chr6	3229005	3288894	AK096219	59889	0.503348
chr6	3259161	3268300	PSMG4	9139	0.526097
chr6	3269206	3456793	SLC22A23	187587	0.475251
chr6	3455936	3461032	AK096549	5096	0.538854
chr6	3722835	3752246	PXDC1	29411	0.526232
chr6	3849631	3851551	FAM50B	1920	0.586458
chr6	4021568	4065217	PRPF4B	43649	0.383331
chr6	4068592	4079457	FAM217A	10865	0.416751
chr6	4079439	4130999	C6orf201	51560	0.416835
chr6	4115926	4135831	ECI2	19905	0.416981
chr6	4136305	4157619	AK092451	21314	0.391949
chr6	4610845	4612153	KU-MEL-3	1308	0.511468
chr6	4776679	4955778	CDYL	179099	0.414882
chr6	4995279	5004271	RPP40	8992	0.432273
chr6	5004049	5240729	AK094934	236680	0.441884
chr6	5030205	5043173	BC133670	12968	0.465608
chr6	5085719	5087455	PPP1R3G	1736	0.661290
chr6	5186833	5261172	LYRM4	74339	0.420533
chr6	5148466	5148556	MIR3691	90	0.577778
chr6	5261583	5771816	FARS2	510233	0.414215
chr6	5998232	6007633	NRN1	9401	0.525370
chr6	6144310	6320924	F13A1	176614	0.417039
chr6	6360823	6623059	LY86-AS1	262236	0.412598
chr6	6588933	6655216	LY86	66283	0.443145
chr6	6725118	6730141	BC039678	5023	0.472626
chr6	7108085	7252213	RREB1	144128	0.455997
chr6	7281287	7313541	SSR1	32254	0.401718
chr6	7326886	7389942	CAGE1	63056	0.412490
chr6	7390061	7418270	RIOK1	28209	0.398383
chr6	7528895	7528953	SNORD112	58	0.431034
chr6	7541869	7586946	DSP	45077	0.422854
chr6	7590431	7612200	SNRNP48	21769	0.373283
chr6	7727010	7881961	BMP6	154951	0.433627
chr6	7881482	7911047	TXNDC5	29565	0.468696
chr6	7986334	7990577	PIP5K1P1	4243	0.462644
chr6	8079627	8102828	EEF1E1	23201	0.389940
chr6	8086640	8086766	SCARNA27	126	0.476190
chr6	8413300	8435794	SLC35B3	22494	0.346226
chr6	8435855	8712526	LOC100506207	276671	0.371965
chr6	8652441	8654080	HULC	1639	0.413667
chr6	9707989	9939582	OFCC1	231593	0.380607
chr6	9842164	9864348	MRDS1	22184	0.386991
chr6	9897103	9897240	AF548120	137	0.394161
chr6	10396915	10415470	TFAP2A	18555	0.469523
chr6	10414299	10416402	LOC100130275	2103	0.553971
chr6	10428017	10435055	LINC00518	7038	0.414749
chr6	10439949	10440027	MIR5689	78	0.512821
chr6	10585992	10629601	GCNT2	43609	0.429774
chr6	10671650	10694839	C6orf52	23189	0.416922
chr6	10695187	10709970	PAK1IP1	14783	0.407766
chr6	10723147	10731362	TMEM14C	8215	0.474863
chr6	10747994	10757214	TMEM14B	9220	0.463883
chr6	10762955	10838788	MAK	75833	0.421070
chr6	10873455	10882098	GCM2	8643	0.445100
chr6	10887063	10974541	SYCP2L	87478	0.402124
chr6	10980992	11044624	ELOVL2	63632	0.396923
chr6	11043990	11079377	ELOVL2-AS1	35387	0.417131
chr6	11094265	11138969	SMIM13	44704	0.421864
chr6	11102721	11112071	ERVFRD-1	9350	0.470374
chr6	11183530	11232915	NEDD9	49385	0.436165
chr6	11417585	11481553	BC030116	63968	0.403936
chr6	11487462	11516747	BC038755	29285	0.390473
chr6	11538459	11583757	TMEM170B	45298	0.366087
chr6	11710051	11710193	SNORA67	142	0.485915
chr6	11713887	11779280	ADTRP	65393	0.434924
chr6	12012723	12165232	HIVEP1	152509	0.389013
chr6	12290528	12297427	EDN1	6899	0.428903
chr6	12717036	13288075	PHACTR1	571039	0.411770
chr6	13305183	13328787	TBC1D7	23604	0.400017
chr6	13279526	13295818	LOC100130357	16292	0.477780
chr6	13358061	13361194	AK127555	3133	0.465688
chr6	13363586	13487869	GFOD1	124283	0.449362
chr6	13574858	13615390	SIRT5	40532	0.426305
chr6	13615558	13621127	NOL7	5569	0.425211
chr6	13621729	13711796	RANBP9	90067	0.369392
chr6	13786780	13814792	MCUR1	28012	0.412180
chr6	13925423	13980240	RNF182	54817	0.381415
chr6	14117864	14137148	CD83	19284	0.446692
chr6	15246205	15522273	JARID2	276068	0.439290
chr6	15248047	15248887	BC033996	840	0.709524
chr6	15523031	15663289	DTNBP1	140258	0.399328
chr6	16129316	16148478	MYLIP	19162	0.402568
chr6	16141786	16141855	MIR4639	69	0.463768
chr6	16238810	16295780	GMPR	56970	0.478269
chr6	16299342	16761721	ATXN1	462379	0.418644
chr6	17102488	17131603	STMND1	29115	0.405221
chr6	17281808	17294099	RBM24	12291	0.406476
chr6	17290199	17294099	RBM24	3900	0.368718
chr6	17393735	17558023	CAP2	164288	0.422995
chr6	17600517	17611950	FAM8A1	11433	0.403918
chr6	17615265	17707065	NUP153	91800	0.401830
chr6	17763923	17987854	KIF13A	223931	0.408452
chr6	18120717	18122851	NHLRC1	2134	0.520619
chr6	18128544	18155374	TPMT	26830	0.415580
chr6	18155618	18224084	KDM1B	68466	0.420223
chr6	18224399	18264799	DEK	40400	0.392054
chr6	18366683	18366714	DQ597117	31	0.580645
chr6	18367059	18367085	DQ599995	26	0.461538
chr6	18387580	18469105	RNF144B	81525	0.391917
chr6	18522977	18723129	AK098665	200152	0.387665
chr6	18572014	18572111	MIR548A1	97	0.360825
chr6	18836401	18836473	TRNA	72	0.500000
chr6	19068773	19180711	AK097585	111938	0.365729
chr6	19642655	19642760	U6	105	0.352381
chr6	19802394	19804981	AK092541	2587	0.412060
chr6	19837600	19842431	ID4	4831	0.467398
chr6	20099915	20212695	MBOAT1	112780	0.420420
chr6	20402136	20493945	E2F3	91809	0.427213
chr6	20534687	21232634	CDKAL1	697947	0.380417
chr6	21593971	21598849	SOX4	4878	0.525215
chr6	21666674	22194616	LINC00340	527942	0.408797
chr6	22134830	22147422	LOC729177	12592	0.405575
chr6	22146882	22194616	LINC00340	47734	0.387502
chr6	22287472	22303082	PRL	15610	0.369443
chr6	22569677	22570750	HDGFL1	1073	0.677540
chr6	24126413	24147757	NRSN1	21344	0.401377
chr6	24171982	24358280	DCDC2	186298	0.386864
chr6	24357130	24358512	KAAG1	1382	0.518813
chr6	24403152	24425816	MRS2	22664	0.393708
chr6	24426061	24489850	GPLD1	63789	0.432598
chr6	24495196	24537435	ALDH5A1	42239	0.430219
chr6	24544331	24646383	KIAA0319	102052	0.415357
chr6	24650204	24667115	TDP2	16911	0.387499
chr6	24667262	24705295	ACOT13	38033	0.414272
chr6	24705089	24719403	C6orf62	14314	0.384309
chr6	24775158	24786325	GMNN	11167	0.368228
chr6	24804512	24911195	FAM65B	106683	0.420423
chr6	25081294	25138051	CMAHP	56757	0.383054
chr6	25245145	25261635	BC029534	16490	0.380109
chr6	25279655	25620758	LRRC16A	341103	0.395033
chr6	25652428	25702008	SCGN	49580	0.395764
chr6	25726290	25726790	HIST1H2AA	500	0.514000
chr6	25726360	25726755	HIST1H2AA	395	0.539240
chr6	25727136	25727573	HIST1H2BA	437	0.475973
chr6	25732350	25732402	DQ586576	52	0.442308
chr6	25732660	25733089	HIST1H2APS1	429	0.582751
chr6	25754926	25781403	SLC17A4	26477	0.395022
chr6	25783125	25832287	SLC17A1	49162	0.367377
chr6	25845327	25874471	SLC17A3	29144	0.374828
chr6	25912983	25930946	SLC17A2	17963	0.393865
chr6	25962916	25987557	TRIM38	24641	0.408709
chr6	26017259	26018040	HIST1H1A	781	0.517286
chr6	26020717	26021186	HIST1H3A	469	0.592751
chr6	26021906	26022278	HIST1H4A	372	0.594086
chr6	26027123	26027480	HIST1H4B	357	0.557423
chr6	26031816	26032288	HIST1H3B	472	0.565678
chr6	26033319	26033796	HIST1H2AB	477	0.574423
chr6	26043454	26043885	HIST1H2BB	431	0.531322
chr6	26045638	26046097	HIST1H3C	459	0.586057
chr6	26055967	26056699	HIST1H1C	732	0.564208
chr6	26087508	26095469	HFE	7961	0.472931
chr6	26096614	26097056	HFE	442	0.328054
chr6	26104175	26104565	HIST1H4C	390	0.523077
chr6	26107639	26108364	HIST1H1T	725	0.485517
chr6	26123694	26124132	HIST1H2BC	438	0.568493
chr6	26124372	26124918	HIST1H2AC	546	0.573260
chr6	26156558	26157343	HIST1H1E	785	0.603822
chr6	26158348	26158835	HIST1H2BD	487	0.548255
chr6	26184023	26184458	HIST1H2BE	435	0.588506
chr6	26188937	26189304	HIST1H4D	367	0.566758
chr6	26197011	26199521	HIST1H3D	2510	0.463745
chr6	26199011	26199521	HIST1H2AD	510	0.560784
chr6	26199786	26200216	HIST1H2BF	430	0.567442
chr6	26204872	26205249	HIST1H4E	377	0.564987
chr6	26216427	26216872	HIST1H2BG	445	0.530337
chr6	26217147	26217711	HIST1H2AE	564	0.542553
chr6	26225382	26225844	HIST1H3E	462	0.588745
chr6	26234439	26235216	HIST1H1D	777	0.526384
chr6	26240653	26241021	HIST1H4F	368	0.565217
chr6	26246838	26247205	HIST1H4G	367	0.572207
chr6	26250369	26250835	HIST1H3F	466	0.596566
chr6	26251878	26252303	HIST1H2BH	425	0.569412
chr6	26271145	26271612	HIST1H3G	467	0.591006
chr6	26272385	26272942	BC079832	557	0.524237
chr6	26273203	26273640	HIST1H2BI	437	0.576659
chr6	26285353	26285727	HIST1H4H	374	0.540107
chr6	26368405	26378540	BTN3A2	10135	0.458510
chr6	26383328	26395100	BTN2A2	11772	0.457781
chr6	26402464	26415444	BTN3A1	12980	0.444607
chr6	26422316	26431841	BTN2A3P	9525	0.461942
chr6	26440699	26453643	BTN3A3	12944	0.440667
chr6	26458152	26469866	BTN2A1	11714	0.466621
chr6	26472171	26482737	LOC285819	10566	0.427598
chr6	26501457	26510652	BTN1A1	9195	0.455574
chr6	26521933	26527612	HCG11	5679	0.418207
chr6	26538571	26547164	HMGN4	8593	0.416735
chr6	26569551	26574926	BC033330	5375	0.452279
chr6	26597170	26600277	ABT1	3107	0.501448
chr6	26634610	26659980	ZNF322	25370	0.373394
chr6	26839265	26924333	GUSBP2	85068	0.395648
chr6	26864472	26864500	DQ596042	28	0.535714
chr6	26864775	26864804	DQ587763	29	0.551724
chr6	26864794	26864826	DQ596042	32	0.562500
chr6	26866009	26866048	DQ571494	39	0.641026
chr6	26866826	26866865	DQ571494	39	0.641026
chr6	26867646	26867685	DQ571494	39	0.641026
chr6	26924771	26991753	LINC00240	66982	0.357574
chr6	26987144	26988085	LOC100270746	941	0.532412
chr6	27100094	27100575	HIST1H2BJ	481	0.559252
chr6	27100816	27101314	HIST1H2AG	498	0.606426
chr6	27106071	27114637	HIST1H2BK	8566	0.420149
chr6	27107087	27107457	HIST1H4I	370	0.610811
chr6	27114118	27114165	Histone3	47	0.361702
chr6	27114860	27115341	HIST1H2AH	481	0.592516
chr6	27115404	27115467	MIR3143	63	0.412698
chr6	27215501	27224399	PRSS16	8898	0.498202
chr6	27276841	27280011	POM121L2	3170	0.529968
chr6	27292539	27293741	VN1R10P	1202	0.376040
chr6	27325601	27343153	ZNF204P	17552	0.405937
chr6	27356523	27369227	ZNF391	12704	0.437106
chr6	27356537	27357613	BC132797	1076	0.580855
chr6	27357717	27358702	AX747641	985	0.407107
chr6	27418520	27440897	ZNF184	22377	0.387898
chr6	27661857	27676936	LOC100507173	15079	0.427880
chr6	27729522	27730966	LOC100131289	1444	0.500000
chr6	27775256	27775709	HIST1H2BL	453	0.584989
chr6	27775976	27778314	HIST1H3H	2338	0.451668
chr6	27782079	27782518	HIST1H2AJ	439	0.601367
chr6	27782821	27783267	HIST1H2BM	446	0.560538
chr6	27791902	27792258	HIST1H4J	356	0.623595
chr6	27793689	27794715	FKSG63	1026	0.581871
chr6	27794098	27794504	BC016143	406	0.509852
chr6	27798951	27799305	HIST1H4K	354	0.627119
chr6	27805657	27806117	HIST1H2AK	460	0.608696
chr6	27806439	27806888	HIST1H2BN	449	0.619154
chr6	27833106	27833576	HIST1H2AL	470	0.604255
chr6	27834569	27835359	HIST1H1B	790	0.578481
chr6	27839622	27840099	HIST1H3I	477	0.605870
chr6	27840925	27841289	HIST1H4L	364	0.579670
chr6	27858092	27858570	HIST1H3J	478	0.577406
chr6	27860476	27860963	HIST1H2AM	487	0.581109
chr6	27861202	27861669	HIST1H2BO	467	0.578158
chr6	27878962	27880174	OR2B2	1212	0.412541
chr6	27925018	27925960	OR2B6	942	0.439490
chr6	28048481	28057340	ZNF165	8859	0.420476
chr6	28058453	28105094	LOC100129195	46641	0.403486
chr6	28058584	28063493	ZSCAN12P1	4909	0.420249
chr6	28092386	28097856	ZSCAN16	5470	0.412431
chr6	28109687	28127250	ZKSCAN8	17563	0.386039
chr6	28129538	28137373	ZNF192P1	7835	0.423357
chr6	28183115	28186707	TOB2P1	3592	0.521437
chr6	28193028	28201264	ZSCAN9	8236	0.434191
chr6	28212489	28220002	ZKSCAN4	7513	0.448556
chr6	28227074	28228736	NKAPL	1662	0.450060
chr6	28234787	28245980	ZSCAN26	11193	0.416689
chr6	28249313	28270326	PGBD1	21013	0.399181
chr6	28292514	28303911	ZSCAN31	11397	0.412126
chr6	28317690	28336954	ZKSCAN3	19264	0.450270
chr6	28356726	28367544	ZSCAN12	10818	0.421705
chr6	28400431	28411279	ZSCAN23	10848	0.404499
chr6	28471072	28483570	GPX6	12498	0.444711
chr6	28493788	28502728	GPX5	8940	0.408725
chr6	28539406	28555112	SCAND3	15706	0.385139
chr6	28555154	28559524	AK056211	4370	0.436156
chr6	28827401	28831454	LOC401242	4053	0.429805
chr6	28870778	28891768	TRIM27	20990	0.446689
chr6	28962593	28973035	ZNF311	10442	0.410266
chr6	29003999	29044517	LOC100129636	40518	0.357002
chr6	29011989	29012952	OR2W1	963	0.410177
chr6	29053984	29055090	OR2B3	1106	0.424955
chr6	29079667	29080603	OR2J3	936	0.456197
chr6	29141310	29142351	OR2J2	1041	0.444765
chr6	29274466	29275432	OR14J1	966	0.454451
chr6	29323006	29324054	OR5V1	1048	0.414122
chr6	29341199	29343068	OR12D3	1869	0.381487
chr6	29364415	29365448	OR12D2	1033	0.457890
chr6	29393280	29395509	OR11A1	2229	0.397488
chr6	29407715	29408754	OR10C1	1039	0.563041
chr6	29426229	29432099	OR2H1	5870	0.418228
chr6	29454542	29455679	MAS1L	1137	0.497801
chr6	29497182	29501345	LOC100507362	4163	0.576027
chr6	29523388	29527702	UBD	4314	0.434631
chr6	29570004	29600962	GABBR1	30958	0.491828
chr6	29550028	29550105	SNORD32B	77	0.480519
chr6	29555682	29556745	OR2H2	1063	0.534337
chr6	29624757	29640149	MOG	15392	0.456926
chr6	29640168	29644931	ZFP57	4763	0.483519
chr6	29691116	29695073	HLA-F	3957	0.549659
chr6	29694377	29716826	HLA-F-AS1	22449	0.459397
chr6	29702965	29716826	HLA-F-AS1	13861	0.482866
chr6	29718583	29718925	IFITM4P	342	0.573099
chr6	29758807	29760850	HCG4	2043	0.555556
chr6	29759099	29760483	LOC554223	1384	0.563584
chr6	29759682	29765584	LOC554223	5902	0.456286
chr6	29794755	29798899	HLA-G	4144	0.564913
chr6	29857104	29858668	HLA-H	1564	0.546675
chr6	29867167	29911213	AK097625	44046	0.460791
chr6	29892368	29893428	HCG4B	1060	0.394340
chr6	29894105	29897504	BC035647	3399	0.573404
chr6	29910246	29913661	HLA-A	3415	0.583309
chr6	29942891	29946177	HCG9	3286	0.517651
chr6	29979874	29981277	UNQ6501	1403	0.411974
chr6	30022377	30028961	ZNRD1-AS1	6584	0.395960
chr6	30029035	30032686	ZNRD1	3651	0.414133
chr6	30034931	30038108	PPP1R11	3177	0.480642
chr6	30038042	30043628	RNF39	5586	0.562836
chr6	30070673	30080867	TRIM31	10194	0.470865
chr6	30093184	30095185	DQ580846	2001	0.468766
chr6	30104509	30116512	TRIM40	12003	0.425477
chr6	30119722	30128711	TRIM10	8989	0.457670
chr6	30130982	30140473	TRIM15	9491	0.470867
chr6	30152231	30181271	TRIM26	29040	0.469456
chr6	30201815	30293911	HCG17	92096	0.414231
chr6	30227338	30234728	HLA-L	7390	0.504330
chr6	30255173	30294933	HCG18	39760	0.427238
chr6	30297087	30314635	TRIM39-RPP21	17548	0.448199
chr6	30457182	30461982	HLA-E	4800	0.554583
chr6	30509154	30525371	GNL1	16217	0.499291
chr6	30524485	30532473	PRR3	7988	0.449549
chr6	30539169	30559309	ABCF1	20140	0.485055
chr6	30552108	30552194	MIR877	86	0.627907
chr6	30568176	30585084	PPP1R10	16908	0.460965
chr6	30585485	30594174	MRPS18B	8689	0.463460
chr6	30594662	30614598	ATAT1	19936	0.488262
chr6	30614815	30620987	C6orf136	6172	0.521387
chr6	30620895	30640830	DHX16	19935	0.499925
chr6	30644165	30655093	PPP1R18	10928	0.555637
chr6	30655823	30659058	NRM	3235	0.562597
chr6	30667583	30685458	MDC1	17875	0.488839
chr6	30688156	30693195	TUBB	5039	0.525501
chr6	30695510	30710453	FLOT1	14943	0.496554
chr6	30710975	30712327	IER3	1352	0.585059
chr6	30780642	30798436	AK098012	17794	0.477240
chr6	30856464	30867933	DDR1	11469	0.568489
chr6	30858659	30858749	MIR4640	90	0.644444
chr6	30875976	30882814	GTF2H4	6838	0.529102
chr6	30882107	30894235	VARS2	12128	0.546999
chr6	30899126	30899952	SFTA2	826	0.565375
chr6	30908776	30921998	DPCR1	13222	0.476100
chr6	30951484	30957675	MUC21	6191	0.500888
chr6	30973728	31003179	MUC22	29451	0.461478
chr6	31021226	31027655	HCG22	6429	0.484679
chr6	31078999	31080332	C6orf15	1333	0.576894
chr6	31082607	31107869	PSORS1C1	25262	0.522484
chr6	31082864	31088252	CDSN	5388	0.525241
chr6	31105310	31107127	PSORS1C2	1817	0.576775
chr6	31110215	31125566	CCHCR1	15351	0.516579
chr6	31126302	31131992	TCF19	5690	0.516520
chr6	31132113	31138451	POU5F1	6338	0.512938
chr6	31133727	31133824	POU5F1	97	0.515464
chr6	31137992	31138276	POU5F1	284	0.676056
chr6	31141511	31145676	PSORS1C3	4165	0.521489
chr6	31165536	31171745	HCG27	6209	0.497343
chr6	31236525	31239913	HLA-C	3388	0.592975
chr6	31371370	31383090	MICA	11720	0.496928
chr6	31430956	31433586	HCP5	2630	0.505323
chr6	31439005	31440185	HCG26	1180	0.509322
chr6	31465854	31478901	MICB	13047	0.494980
chr6	31496738	31498008	MCCD1	1270	0.574016
chr6	31497995	31510252	DDX39B	12257	0.472791
chr6	31504150	31504226	SNORD117	76	0.447368
chr6	31512227	31514625	ATP6V1G2	2398	0.491243
chr6	31515352	31526606	NFKBIL1	11254	0.481429
chr6	31539875	31542100	LTA	2225	0.577079
chr6	31543343	31546112	TNF	2769	0.528350
chr6	31544291	31546112	TNF	1821	0.524986
chr6	31548335	31550202	LTB	1867	0.617033
chr6	31554475	31556686	LST1	2211	0.554500
chr6	31555417	31556686	LST1	1269	0.548463
chr6	31556659	31560762	NCR3	4103	0.517914
chr6	31583032	31584798	AIF1	1766	0.538505
chr6	31588449	31605554	PRRC2A	17105	0.534990
chr6	31590855	31590987	SNORA38	132	0.446970
chr6	31606804	31620170	BAG6	13366	0.520575
chr6	31623670	31625987	APOM	2317	0.518774
chr6	31626074	31628549	C6orf47	2475	0.570101
chr6	31629005	31633407	GPANK1	4402	0.523853
chr6	31633656	31637843	CSNK2B	4187	0.518271
chr6	31644460	31648150	LY6G5C	3690	0.498916
chr6	31654725	31671137	ABHD16A	16412	0.502925
chr6	31660528	31671137	ABHD16A	10609	0.486757
chr6	31668805	31668868	MIR4646	63	0.587302
chr6	31674683	31678372	LY6G6F	3689	0.532123
chr6	31680112	31681842	LY6G6E	1730	0.564162
chr6	31686424	31689511	LY6G6C	3087	0.529316
chr6	31691120	31694485	C6orf25	3365	0.547994
chr6	31694816	31698039	DDAH2	3223	0.599752
chr6	31698357	31704341	CLIC1	5984	0.513870
chr6	31707724	31730945	MSH5-SAPCD1	23221	0.486284
chr6	31727201	31732624	MSH5-SAPCD1	5423	0.527568
chr6	31733370	31745108	VWA7	11738	0.544982
chr6	31745296	31763712	VARS	18416	0.538010
chr6	31765168	31774761	LSM2	9593	0.481184
chr6	31777395	31782835	HSPA1L	5440	0.486581
chr6	31783290	31785719	HSPA1A	2429	0.597777
chr6	31795511	31798031	HSPA1B	2520	0.587698
chr6	31802692	31807541	C6orf48	4849	0.485667
chr6	31803039	31803103	SNORD48	64	0.562500
chr6	31804852	31804916	SNORD52	64	0.421875
chr6	31826828	31830709	NEU1	3881	0.545993
chr6	31830969	31846823	SLC44A4	15854	0.536268
chr6	31847536	31865464	EHMT2	17928	0.538208
chr6	31895265	31919861	CFB	24596	0.519719
chr6	31867393	31869769	ZBTB12	2376	0.645202
chr6	31919863	31926864	NELFE	7001	0.495929
chr6	31924615	31924717	MIR1236	102	0.549020
chr6	31926580	31937532	SKIV2L	10952	0.544923
chr6	31937587	31940032	DOM3Z	2445	0.587730
chr6	31939645	31949223	STK19	9578	0.524222
chr6	31973358	31976712	CYP21A1P	3354	0.617174
chr6	31973358	31974180	CYP21A2	822	0.592457
chr6	31976196	31981050	TNXB	4854	0.634734
chr6	31981166	31981961	STK19	795	0.550943
chr6	32006092	32009447	CYP21A2	3355	0.618480
chr6	32008931	32077151	TNXB	68220	0.544269
chr6	32083044	32096017	ATF6B	12973	0.514145
chr6	32096483	32098067	FKBPL	1584	0.546086
chr6	32116139	32119720	PRRT1	3581	0.600112
chr6	32121228	32131458	PPT2	10230	0.505767
chr6	32132355	32136313	PPT2-EGFL8	3958	0.558868
chr6	32135982	32143916	AGPAT1	7934	0.509075
chr6	32146161	32151930	RNF5	5769	0.540822
chr6	32148744	32152099	AGER	3355	0.566617
chr6	32152509	32157963	PBX2	5454	0.549505
chr6	32158542	32163300	GPSM3	4758	0.527322
chr6	32162619	32191844	NOTCH4	29225	0.518118
chr6	32223487	32233615	AK123889	10128	0.404226
chr6	32260474	32339656	C6orf10	79182	0.381627
chr6	32358286	32361468	HCG23	3182	0.375864
chr6	32362512	32374900	BTNL2	12388	0.420245
chr6	32407618	32412826	HLA-DRA	5208	0.428571
chr6	32485153	32498006	HLA-DRB5	12853	0.428227
chr6	32520489	32527779	HLA-DRB6	7290	0.441289
chr6	32546122	32546497	AK293020	375	0.309333
chr6	32605182	32611429	HLA-DQA1	6247	0.428206
chr6	32627240	32634466	HLA-DQB1	7226	0.468586
chr6	32709162	32714664	HLA-DQA2	5502	0.432933
chr6	32723874	32731330	HLA-DQB2	7456	0.473847
chr6	32793186	32806547	TAP2	13361	0.465085
chr6	32808493	32811816	PSMB8	3323	0.490220
chr6	32811862	32814277	LOC100507463	2415	0.522567
chr6	32812985	32821748	TAP1	8763	0.504508
chr6	32821937	32827628	PSMB9	5691	0.474609
chr6	32861952	32871535	LOC100294145	9583	0.407075
chr6	32902405	32908847	HLA-DMB	6442	0.451723
chr6	32916390	32920899	HLA-DMA	4509	0.503881
chr6	32940860	32949282	BRD2	8422	0.466516
chr6	32937094	32940704	BRD2	3610	0.594183
chr6	32971959	32977389	HLA-DOA	5430	0.525599
chr6	33032345	33041454	HLA-DPA1	9109	0.417280
chr6	33043702	33057473	HLA-DPB1	13771	0.473241
chr6	33080292	33086926	HLA-DPB2	6634	0.481761
chr6	33130468	33160245	COL11A2	29777	0.565839
chr6	33161361	33168473	RXRB	7112	0.539792
chr6	33167336	33167410	JA611279	74	0.486486
chr6	33168602	33172214	SLC39A7	3612	0.520764
chr6	33172413	33174608	HSD17B8	2195	0.566287
chr6	33175611	33175721	MIR219-1	110	0.681818
chr6	33176285	33180499	RING1	4214	0.529663
chr6	33217312	33222667	HCG25	5355	0.452661
chr6	33218048	33239662	VPS52	21614	0.455260
chr6	33239851	33244281	RPS18	4430	0.468849
chr6	33244916	33246602	B3GALT4	1686	0.641163
chr6	33246879	33257304	WDR46	10425	0.518657
chr6	33257373	33258711	PFDN6	1338	0.533632
chr6	33259430	33267165	RGL2	7735	0.571170
chr6	33271409	33282164	TAPBP	10755	0.502929
chr6	33282181	33285719	ZBTB22	3538	0.594404
chr6	33286334	33290793	DAXX	4459	0.541601
chr6	33359312	33377699	KIFC1	18387	0.476859
chr6	33367539	33368372	BC146941	833	0.444178
chr6	33378772	33384230	PHF1	5458	0.556981
chr6	33384318	33386065	CUTA	1747	0.558672
chr6	33387846	33421466	SYNGAP1	33620	0.539381
chr6	33406107	33406214	MIR5004	107	0.532710
chr6	33422355	33425320	ZBTB9	2965	0.524115
chr6	33540322	33548070	BAK1	7748	0.571760
chr6	33551475	33556803	GGNBP1	5328	0.559497
chr6	33553882	33561115	LINC00336	7233	0.568920
chr6	33589155	33664348	ITPR3	75193	0.550011
chr6	33664537	33679528	MNF1	14991	0.481689
chr6	33689442	33714762	IP6K3	25320	0.534084
chr6	33738989	33756906	LEMD2	17917	0.531674
chr6	33762448	33771793	MLN	9345	0.547780
chr6	33836691	33836724	DQ591368	33	0.515152
chr6	33836896	33836927	DQ588775	31	0.516129
chr6	33838045	33838090	DQ575620	45	0.644444
chr6	33838530	33838577	DQ574302	47	0.617021
chr6	33839233	33839264	DQ582547	31	0.387097
chr6	33839352	33839408	DQ574483	56	0.500000
chr6	33839759	33839794	DQ593162	35	0.628571
chr6	33839981	33840022	DQ597035	41	0.609756
chr6	33840036	33840068	DQ588564	32	0.562500
chr6	33840068	33840099	DQ595963	31	0.483871
chr6	33840687	33840721	DQ587023	34	0.588235
chr6	33842073	33842118	DQ601690	45	0.555556
chr6	33842126	33842155	DQ576911	29	0.586207
chr6	33842348	33842378	DQ577977	30	0.466667
chr6	33843183	33843217	DQ575513	34	0.411765
chr6	33843233	33843263	DQ573052	30	0.400000
chr6	33843705	33843736	DQ577182	31	0.483871
chr6	33844274	33844303	DQ584412	29	0.586207
chr6	33844327	33844366	DQ584979	39	0.564103
chr6	33844422	33844452	DQ582579	30	0.466667
chr6	33844700	33844792	DQ589683	92	0.554348
chr6	33844801	33844845	DQ593611	44	0.545455
chr6	33844863	33844894	DQ594410	31	0.612903
chr6	33844970	33845008	DQ582841	38	0.526316
chr6	33845037	33845071	DQ575895	34	0.588235
chr6	33845360	33845396	DQ575530	36	0.500000
chr6	33845416	33845475	DQ575377	59	0.525424
chr6	33845545	33845575	DQ586570	30	0.633333
chr6	33846086	33846117	DQ593990	31	0.516129
chr6	33846531	33846576	DQ573704	45	0.511111
chr6	33846859	33846895	DQ570748	36	0.527778
chr6	33847281	33847332	DQ599657	51	0.470588
chr6	33847340	33847375	DQ596290	35	0.400000
chr6	33847406	33847467	DQ601334	61	0.557377
chr6	33848971	33849014	DQ584108	43	0.465116
chr6	33849271	33849307	DQ577931	36	0.500000
chr6	33849611	33849646	DQ575305	35	0.457143
chr6	33850008	33850051	DQ586699	43	0.488372
chr6	33850091	33850129	DQ575290	38	0.526316
chr6	33850752	33850802	DQ572560	50	0.520000
chr6	33851932	33851994	DQ575175	62	0.467742
chr6	33853294	33853325	DQ574159	31	0.451613
chr6	33853347	33853381	DQ575062	34	0.441176
chr6	33853739	33853784	DQ599837	45	0.622222
chr6	33854972	33855002	DQ587590	30	0.400000
chr6	33855168	33855211	DQ595081	43	0.441860
chr6	33856202	33856246	DQ570026	44	0.500000
chr6	33856385	33856426	DQ599581	41	0.341463
chr6	33857070	33857107	DQ595416	37	0.432432
chr6	33857151	33857199	DQ594337	48	0.395833
chr6	33857287	33864684	LOC100507584	7397	0.518318
chr6	33859438	33859469	DQ584005	31	0.548387
chr6	33860253	33860321	DQ597072	68	0.485294
chr6	33860543	33860575	DQ594437	32	0.687500
chr6	33860597	33860626	DQ585264	29	0.517241
chr6	33860603	33860635	DQ571863	32	0.468750
chr6	33860627	33860656	DQ571410	29	0.586207
chr6	33860645	33860676	DQ593272	31	0.516129
chr6	33862895	33864466	DQ589635	1571	0.540420
chr6	33865514	33865551	DQ599760	37	0.567568
chr6	33865587	33865617	DQ578421	30	0.533333
chr6	33865676	33865716	DQ600887	40	0.500000
chr6	33866040	33866092	DQ583382	52	0.461538
chr6	33866162	33866196	DQ574291	34	0.617647
chr6	33866237	33866270	DQ590088	33	0.545455
chr6	33866369	33866401	DQ588801	32	0.531250
chr6	33866586	33866625	DQ592196	39	0.435897
chr6	33866715	33866821	DQ571485	106	0.584906
chr6	33866907	33866939	DQ572638	32	0.562500
chr6	33866944	33866992	DQ572388	48	0.562500
chr6	33867037	33867088	DQ590110	51	0.450980
chr6	33867289	33867326	DQ587803	37	0.540541
chr6	33867390	33867420	DQ592861	30	0.400000
chr6	33867503	33867545	DQ601324	42	0.547619
chr6	33867617	33867693	DQ583111	76	0.513158
chr6	33867725	33867771	DQ583986	46	0.521739
chr6	33868324	33868393	DQ600101	69	0.579710
chr6	33868573	33868611	DQ599137	38	0.421053
chr6	33868660	33868690	DQ597264	30	0.566667
chr6	33869143	33869174	DQ590825	31	0.322581
chr6	33869312	33869346	DQ578079	34	0.588235
chr6	33869383	33869422	DQ578686	39	0.564103
chr6	33869755	33869823	DQ601655	68	0.470588
chr6	33869849	33869887	DQ597187	38	0.473684
chr6	33869912	33869942	DQ591577	30	0.366667
chr6	33870300	33870327	DQ571738	27	0.444444
chr6	33870425	33870477	DQ589976	52	0.423077
chr6	33870637	33870686	DQ587230	49	0.510204
chr6	33870715	33870744	DQ576197	29	0.586207
chr6	33870855	33870897	DQ570651	42	0.547619
chr6	33870927	33870972	DQ599973	45	0.577778
chr6	33871107	33871137	DQ583766	30	0.500000
chr6	33871137	33871191	DQ592889	54	0.574074
chr6	33871585	33871620	DQ596554	35	0.485714
chr6	33871660	33871701	DQ597719	41	0.487805
chr6	33871715	33871756	DQ571433	41	0.439024
chr6	33871792	33871822	DQ578611	30	0.533333
chr6	33871876	33871911	DQ596227	35	0.514286
chr6	33871993	33872081	DQ600808	88	0.534091
chr6	33872217	33872251	DQ576849	34	0.529412
chr6	33872300	33872341	DQ586674	41	0.536585
chr6	33872410	33872461	DQ573006	51	0.549020
chr6	33872530	33872570	DQ599213	40	0.475000
chr6	33872606	33872650	DQ594165	44	0.522727
chr6	33872810	33872888	DQ587262	78	0.423077
chr6	33873015	33873067	DQ573430	52	0.461538
chr6	33873285	33873316	DQ578525	31	0.322581
chr6	33873326	33873380	DQ597061	54	0.537037
chr6	33873506	33873573	DQ573348	67	0.492537
chr6	33873784	33873832	DQ579247	48	0.500000
chr6	33874087	33874118	DQ597052	31	0.548387
chr6	33874158	33874217	DQ600333	59	0.491525
chr6	33874314	33874453	DQ589422	139	0.568345
chr6	33874552	33874581	DQ580270	29	0.482759
chr6	33874995	33875036	DQ586584	41	0.536585
chr6	33875267	33875311	DQ597137	44	0.545455
chr6	33875463	33875495	DQ571282	32	0.562500
chr6	33876055	33876094	DQ570892	39	0.512821
chr6	33876097	33876158	DQ570017	61	0.491803
chr6	33876552	33876600	DQ589393	48	0.458333
chr6	33876603	33876635	DQ589595	32	0.500000
chr6	33876660	33876700	DQ598002	40	0.475000
chr6	33876730	33876837	DQ592096	107	0.532710
chr6	33877007	33877044	DQ584058	37	0.486486
chr6	33877543	33877580	DQ579071	37	0.567568
chr6	33877627	33877676	DQ586217	49	0.428571
chr6	33877783	33877834	DQ575913	51	0.549020
chr6	33877982	33878015	DQ595616	33	0.515152
chr6	33878152	33878219	DQ589313	67	0.477612
chr6	33878245	33878285	DQ579683	40	0.525000
chr6	33878303	33878378	DQ579150	75	0.493333
chr6	33878411	33878457	DQ574888	46	0.608696
chr6	33878523	33878554	DQ570403	31	0.483871
chr6	33878770	33878816	DQ575962	46	0.586957
chr6	33878878	33885985	AL832447	7107	0.503869
chr6	33888742	33888797	DQ587303	55	0.490909
chr6	33889194	33889220	DQ580801	26	0.576923
chr6	33967748	33967828	MIR1275	80	0.512500
chr6	33989622	34113914	GRM4	124292	0.559159
chr6	34204576	34214008	HMGA1	9432	0.579729
chr6	34214156	34216904	C6orf1	2748	0.601528
chr6	34247455	34249545	DQ572964	2090	0.446411
chr6	34252326	34253796	DQ591995	1470	0.425850
chr6	34254972	34393902	RPS10-NUDT3	138930	0.433420
chr6	34482648	34503000	PACSIN1	20352	0.576258
chr6	34505578	34524110	SPDEF	18532	0.579808
chr6	34555065	34664625	C6orf106	109560	0.418310
chr6	34724870	34741634	SNRPC	16764	0.427344
chr6	34759793	34845291	UHRF1BP1	85498	0.428454
chr6	34845554	34855848	TAF11	10294	0.414416
chr6	34857037	35059190	ANKS1A	202153	0.449338
chr6	35085848	35109187	TCP11	23339	0.423754
chr6	35172921	35178950	AY927475	6029	0.492619
chr6	35182189	35218609	SCUBE3	36420	0.500137
chr6	35227509	35263760	ZNF76	36251	0.478442
chr6	35265594	35289548	DEF6	23954	0.484971
chr6	35310334	35395968	PPARD	85634	0.495329
chr6	35420137	35434881	FANCE	14744	0.504205
chr6	35436177	35438558	RPL10A	2381	0.569509
chr6	35441373	35464861	TEAD3	23488	0.567524
chr6	35465650	35480647	TULP1	14997	0.537441
chr6	35541361	35656719	FKBP5	115358	0.401169
chr6	35632493	35632566	MIR5690	73	0.301370
chr6	35704858	35716685	ARMC12	11827	0.468166
chr6	35744391	35747329	CLPSL2	2938	0.558203
chr6	35748830	35755841	CLPSL1	7011	0.497076
chr6	35762758	35765121	CLPS	2363	0.560728
chr6	35773070	35791852	LHFPL5	18782	0.473006
chr6	35800810	35888957	SRPK1	88147	0.404415
chr6	35911290	35992305	SLC26A8	81015	0.423094
chr6	35995453	36079013	MAPK14	83560	0.398815
chr6	36098260	36112301	MAPK13	14041	0.533082
chr6	36125844	36163947	BC042825	38103	0.388578
chr6	36164549	36200567	BRPF3	36018	0.470154
chr6	36238236	36276372	PNPLA1	38136	0.473883
chr6	36283534	36304662	C6orf222	21128	0.495646
chr6	36333970	36355577	ETV7	21607	0.497894
chr6	36358328	36410666	PXT1	52338	0.428140
chr6	36410543	36458315	KCTD20	47772	0.423763
chr6	36461668	36515247	STK38	53579	0.415237
chr6	36562089	36572244	SRSF3	10155	0.401083
chr6	36590212	36590289	MIR3925	77	0.454545
chr6	36644236	36655116	CDKN1A	10880	0.544026
chr6	36665627	36700960	RAB44	35333	0.501797
chr6	36708554	36807220	CPNE5	98666	0.516794
chr6	36807549	36816400	AK096023	8851	0.526268
chr6	36822605	36842800	PPIL1	20195	0.442634
chr6	36853639	36896740	C6orf89	43101	0.434793
chr6	36922208	36932613	PI16	10405	0.550793
chr6	36935910	36954327	MTCH1	18417	0.524624
chr6	36973422	36996845	FGD2	23423	0.535286
chr6	37137921	37143204	PIM1	5283	0.538141
chr6	37140232	37143204	PIM1	2972	0.480148
chr6	37179953	37225413	TMEM217	45460	0.434602
chr6	37179953	37225413	TMEM217	45460	0.434602
chr6	37225547	37300746	TBC1D22B	75199	0.433437
chr6	37321747	37362514	RNF8	40767	0.436628
chr6	37400906	37449284	FTSJD2	48378	0.456861
chr6	37450696	37467700	CCDC167	17004	0.523053
chr6	37523140	37523198	MIR4462	58	0.586207
chr6	37600283	37665766	MDGA1	65483	0.520272
chr6	37787306	38122399	ZFAND3	335093	0.392249
chr6	38136226	38607924	BTBD9	471698	0.406341
chr6	38147073	38149010	AX747659	1937	0.526587
chr6	38643701	38670952	GLO1	27251	0.398517
chr6	38683116	38998574	DNAH8	315458	0.391031
chr6	38874270	38920883	LOC100131047	46613	0.390470
chr6	39016556	39055520	GLP1R	38964	0.519787
chr6	39071839	39082865	SAYSD1	11026	0.416198
chr6	39156746	39197251	KCNK5	40505	0.519664
chr6	39266776	39282237	KCNK17	15461	0.544143
chr6	39282473	39290330	KCNK16	7857	0.544101
chr6	39302875	39693181	KIF6	390306	0.404437
chr6	39760158	39872653	DAAM2	112495	0.475781
chr6	39851291	39854344	AX747174	3053	0.526695
chr6	39872033	39895455	MOCS1	23422	0.495987
chr6	40312083	40323745	LINC00951	11662	0.503001
chr6	40346162	40347631	TDRG1	1469	0.509190
chr6	40359372	40555126	LRFN2	195754	0.485114
chr6	40994639	41006938	UNC5CL	12299	0.517440
chr6	41010236	41012076	TSPO2	1840	0.560326
chr6	41010236	41012076	TSPO2	1840	0.560326
chr6	41020939	41032630	APOBEC2	11691	0.448978
chr6	41034530	41040188	OARD1	5658	0.409332
chr6	41040706	41070146	NFYA	29440	0.406827
chr6	41100032	41103080	ADCY10P1	3048	0.396982
chr6	41105094	41108573	ADCY10P1	3479	0.436620
chr6	41116998	41122087	TREML1	5089	0.506190
chr6	41126243	41130924	TREM2	4681	0.542192
chr6	41157551	41168925	TREML2	11374	0.511781
chr6	41176291	41185685	TREML3P	9394	0.426442
chr6	41196061	41206120	TREML4	10059	0.428671
chr6	41217114	41217327	TREML5P	213	0.572770
chr6	41242998	41254457	TREM1	11459	0.467929
chr6	41303527	41318625	NCR2	15098	0.470327
chr6	41470181	41487590	DQ141194	17409	0.512379
chr6	41514163	41570122	FOXP4	55959	0.547008
chr6	41566460	41566526	MIR4641	66	0.666667
chr6	41606194	41621982	MDFI	15788	0.572017
chr6	41651715	41703997	TFEB	52282	0.541410
chr6	41658400	41701566	TFEB	43166	0.531251
chr6	41704448	41715139	PGC	10691	0.533346
chr6	41737913	41747630	FRS3	9717	0.527220
chr6	41748499	41755563	PRICKLE4	7064	0.557758
chr6	41754499	41757634	TOMM6	3135	0.540351
chr6	41757633	41760146	DQ592954	2513	0.383605
chr6	41765382	41863099	USP49	97717	0.414380
chr6	41873091	41888877	MED20	15786	0.465729
chr6	41873091	41888877	MED20	15786	0.465729
chr6	41888964	41900784	BYSL	11820	0.487225
chr6	41902670	41909552	CCND3	6882	0.571636
chr6	42018250	42048644	TAF8	30394	0.455616
chr6	42068856	42110715	C6orf132	41859	0.526458
chr6	42123143	42147794	GUCA1A	24651	0.512312
chr6	42151021	42162694	GUCA1B	11673	0.465947
chr6	42174538	42185633	MRPS10	11095	0.410906
chr6	42192668	42419783	TRERF1	227115	0.457539
chr6	42531759	42661243	UBR2	129484	0.391114
chr6	42664332	42690358	PRPH2	26026	0.492546
chr6	42695120	42695174	DQ582057	54	0.555556
chr6	42695313	42695932	ATP6V0CP3	619	0.605816
chr6	42712233	42713884	TBCC	1651	0.548153
chr6	42788793	42836296	GLTSCR1L	47503	0.443383
chr6	42847670	42854731	RPL7L1	7061	0.475995
chr6	42855730	42857576	DQ581019	1846	0.445829
chr6	42858002	42858554	C6orf226	552	0.596014
chr6	42883726	42893575	PTCRA	9849	0.509696
chr6	42896859	42907008	CNPY3	10149	0.506552
chr6	42928499	42931618	GNMT	3119	0.571658
chr6	42929294	42929645	BC040637	351	0.538462
chr6	42931610	42946981	PEX6	15371	0.520656
chr6	42979966	42981618	MEA1	1652	0.554479
chr6	42952236	42980083	PPP2R5D	27847	0.498869
chr6	42981840	42989036	KLHDC3	7196	0.523902
chr6	42989384	42997337	RRP36	7953	0.499937
chr6	43005354	43021683	CUL7	16329	0.547002
chr6	43021766	43027242	MRPL2	5476	0.493243
chr6	43027628	43042833	KLC4	15205	0.508320
chr6	43044551	43129458	PTK7	84907	0.492468
chr6	43138919	43149244	SRF	10325	0.557191
chr6	43149921	43192325	CUL9	42404	0.490874
chr6	43193366	43197211	DNPH1	3845	0.552406
chr6	43211221	43255997	TTBK1	44776	0.562377
chr6	43265997	43273276	SLC22A7	7279	0.544031
chr6	43273210	43276530	CRIP3	3320	0.560542
chr6	43303807	43337181	ZNF318	33374	0.432912
chr6	43395291	43418163	ABCC10	22872	0.529162
chr6	43418089	43423786	DLK2	5697	0.575742
chr6	43445260	43474294	TJAP1	29034	0.511745
chr6	43474702	43478081	LRRC73	3379	0.621190
chr6	43479564	43484728	YIPF3	5164	0.524593
chr6	43484776	43489246	POLR1C	4470	0.464430
chr6	43490067	43543812	XPO5	53745	0.438013
chr6	43543877	43588260	POLH	44383	0.436496
chr6	43588217	43596936	GTPBP2	8719	0.525748
chr6	43597278	43608688	MAD2L1BP	11410	0.492463
chr6	43612766	43638748	RSPH9	25982	0.503041
chr6	43638933	43655549	MRPS18A	16616	0.490973
chr6	43737945	43754223	VEGFA	16278	0.564013
chr6	43812607	43820054	AK097853	7447	0.495502
chr6	43858764	43905944	LOC100132354	47180	0.506740
chr6	43964176	44042389	AK024736	78213	0.515477
chr6	43968336	43973694	C6orf223	5358	0.589212
chr6	44081372	44095191	MRPL14	13819	0.461032
chr6	44095375	44123256	TMEM63B	27881	0.537893
chr6	44126547	44152139	CAPN11	25592	0.515669
chr6	44191240	44201888	SLC29A1	10648	0.568464
chr6	44213902	44221625	HSP90AB1	7723	0.491001
chr6	44221837	44225283	SLC35B2	3446	0.570807
chr6	44225902	44233525	NFKBIE	7623	0.559229
chr6	44238479	44247182	TMEM151B	8703	0.590486
chr6	44247896	44265458	TCTE1	17562	0.505865
chr6	44266462	44281063	AARS2	14601	0.544346
chr6	44310396	44344904	SPATS1	34508	0.422916
chr6	44355250	44418161	CDC5L	62911	0.385020
chr6	44403377	44403459	MIR4642	82	0.585366
chr6	44698854	44705093	BX647715	6239	0.469787
chr6	44794466	45345788	SUPT3H	551322	0.362385
chr6	45165410	45165507	MIR586	97	0.329897
chr6	45296053	45518819	RUNX2	222766	0.387914
chr6	45866189	46048085	CLIC5	181896	0.419899
chr6	45986481	45986588	U6	107	0.401869
chr6	46097700	46114436	ENPP4	16736	0.361138
chr6	46127761	46138717	ENPP5	10956	0.389193
chr6	46172959	46173269	HM358993	310	0.580645
chr6	46188466	46459060	RCAN2	270594	0.395770
chr6	46459788	46501217	BC042616	41429	0.375365
chr6	46517444	46620523	CYP39A1	103079	0.368164
chr6	46620651	46645927	SLC25A27	25276	0.378857
chr6	46655611	46672056	TDRD6	16445	0.379386
chr6	46672052	46703430	PLA2G7	31378	0.410128
chr6	46714653	46726954	ANKRD66	12301	0.399073
chr6	46761093	46807519	MEP1A	46426	0.381230
chr6	46820241	46889714	GPR116	69473	0.411973
chr6	46871209	46877766	BC042990	6557	0.397285
chr6	46967812	47010082	GPR110	42270	0.403832
chr6	47199267	47277680	TNFRSF21	78413	0.413949
chr6	47445524	47594996	CD2AP	149472	0.363767
chr6	47624325	47665533	GPR111	41208	0.403101
chr6	47666288	47689757	GPR115	23469	0.407431
chr6	47683018	47683337	7SK	319	0.404389
chr6	47749774	47794116	OPN5	44342	0.389089
chr6	47791125	47791286	U1	161	0.459627
chr6	47845763	48036425	PTCHD4	190662	0.367530
chr6	49312459	49312521	U7	62	0.403226
chr6	49398072	49431041	MUT	32969	0.345294
chr6	49431095	49460820	CENPQ	29725	0.379815
chr6	49467670	49495777	GLYATL3	28107	0.390863
chr6	49518112	49519808	C6orf141	1696	0.561321
chr6	49572889	49604587	RHAG	31698	0.396776
chr6	49660070	49681303	CRISP2	21233	0.353459
chr6	49695091	49712168	CRISP3	17077	0.344908
chr6	49753363	49755053	PGK2	1690	0.457988
chr6	49783205	49792479	BC067243	9274	0.341169
chr6	49801978	49834218	CRISP1	32240	0.357723
chr6	49913813	49917157	DEFB133	3344	0.331340
chr6	49928004	49931818	DEFB114	3814	0.268485
chr6	49936389	49937338	DEFB113	949	0.318230
chr6	49986555	49989694	DEFB110	3139	0.345014
chr6	50011287	50016364	DEFB112	5077	0.368919
chr6	50681256	50740746	TFAP2D	59490	0.372315
chr6	50786438	50815326	TFAP2B	28888	0.441429
chr6	51329487	51329563	SNORD66	76	0.513158
chr6	51480144	51952423	PKHD1	472279	0.383282
chr6	52009146	52009232	MIR206	86	0.453488
chr6	52013720	52013839	MIR133B	119	0.571429
chr6	52051184	52055436	IL17A	4252	0.375353
chr6	52101483	52109298	IL17F	7815	0.424568
chr6	52128811	52149679	MCM3	20868	0.431714
chr6	52226925	52272575	PAQR8	45650	0.423067
chr6	52284993	52360583	EFHC1	75590	0.384257
chr6	52362199	52441862	TRAM2	79663	0.466616
chr6	52441999	52448791	TRAM2-AS1	6792	0.451266
chr6	52529198	52533951	LOC730101	4753	0.443930
chr6	52535883	52551385	TMEM14A	15502	0.417624
chr6	52604260	52609957	GSTA7P	5697	0.427067
chr6	52614884	52628361	GSTA2	13477	0.407361
chr6	52656177	52668664	GSTA1	12487	0.404581
chr6	52696540	52710893	GSTA5	14353	0.415105
chr6	52761438	52774496	GSTA3	13058	0.422653
chr6	52842745	52860178	GSTA4	17433	0.410199
chr6	52866097	52926600	ICK	60503	0.408624
chr6	52929795	52965670	FBXO9	35875	0.382216
chr6	52991759	53013624	GCM1	21865	0.424240
chr6	53132195	53213977	ELOVL5	81782	0.418760
chr6	53141790	53141869	MIR5685	79	0.582278
chr6	53199257	53202415	RPS16P5	3158	0.467068
chr6	53280091	53280405	7SK	314	0.426752
chr6	53362139	53409927	GCLC	47788	0.407864
chr6	53426086	53481967	AK126334	55881	0.392548
chr6	53512698	53530506	KLHL31	17808	0.388140
chr6	53516383	53518904	AX746830	2521	0.458152
chr6	53659533	53788919	LRRC1	129386	0.396882
chr6	53794843	53862465	AK056584	67622	0.388675
chr6	53863687	53871950	MLIP-IT1	8263	0.396708
chr6	53976244	54131078	MLIP	154834	0.356033
chr6	54173202	54254950	TINAG	81748	0.347593
chr6	54635401	54635422	DD157417	21	0.571429
chr6	54639170	54639195	JA072123	25	0.480000
chr6	54711568	54809897	FAM83B	98329	0.358440
chr6	55039070	55147418	HCRTR2	108348	0.347722
chr6	55192266	55267291	GFRAL	75025	0.357454
chr6	55299170	55444012	HMGCLL1	144842	0.343664
chr6	55620237	55740375	BMP5	120138	0.341466
chr6	55921387	56112378	COL21A1	190991	0.352807
chr6	56322784	56819426	DST	496642	0.380665
chr6	56615105	56615138	RNU6-71P	33	0.363636
chr6	56819772	56892142	BEND6	72370	0.385339
chr6	56911383	56920023	KIAA1586	8640	0.378125
chr6	56954807	57035098	ZNF451	80291	0.364985
chr6	56979708	57037011	BC032020	57303	0.358777
chr6	57037103	57050012	BAG2	12909	0.404679
chr6	57053581	57087078	RAB23	33497	0.379437
chr6	57182421	57513376	PRIM2	330955	0.373253
chr6	58250694	58287724	GUSBP4	37030	0.457494
chr6	58264081	58264108	DQ596041	27	0.518519
chr6	58264384	58264413	DQ587763	29	0.551724
chr6	58264403	58264435	DQ596042	32	0.562500
chr6	62389864	62996100	KHDRBS2	606236	0.348417
chr6	63985855	64029882	LGSN	44027	0.368910
chr6	64281919	64293489	PTP4A1	11570	0.388505
chr6	64356431	64424405	PHF3	67974	0.357696
chr6	64429875	66417118	EYS	1987243	0.350599
chr6	66011310	66015504	LOC441155	4194	0.442537
chr6	66497771	66499376	SLC25A51P1	1605	0.470405
chr6	68590880	68599051	LOC648232	8171	0.472402
chr6	69345631	70099403	BAI3	753772	0.351280
chr6	70385640	70507049	LMBRD1	121409	0.350155
chr6	70576447	70922157	COL19A1	345710	0.365352
chr6	70925742	71012786	COL9A1	87044	0.380405
chr6	71136141	71270877	FAM135A	134736	0.356594
chr6	71276624	71298606	C6orf57	21982	0.407515
chr6	71377478	71571716	SMAP1	194238	0.377310
chr6	71571068	71666788	B3GAT2	95720	0.400930
chr6	71836595	71836808	U3	213	0.450704
chr6	71998476	72012230	OGFRL1	13754	0.379162
chr6	72086662	72086734	MIR30C2	72	0.416667
chr6	72113253	72113324	MIR30A	71	0.535211
chr6	72113256	72113278	DM119538	22	0.500000
chr6	72113297	72113319	DM119539	22	0.454545
chr6	72124148	72130448	LINC00472	6300	0.433333
chr6	72596405	73112845	RIMS1	516440	0.355699
chr6	73331570	73908573	KCNQ5	577003	0.373435
chr6	73677409	73677476	MIR4282	67	0.402985
chr6	73844525	73853237	KCNQ5-AS1	8712	0.397383
chr6	73933267	73935175	KHDC1L	1908	0.534067
chr6	73951037	73972907	KHDC1	21870	0.422771
chr6	73977773	74001061	AL832252	23288	0.459035
chr6	74062784	74063999	DPPA5	1215	0.546502
chr6	74072399	74073898	KHDC3L	1499	0.585057
chr6	74078279	74079515	OOEP	1236	0.506472
chr6	74104284	74127289	DDX43	23005	0.410085
chr6	74134855	74162043	MB21D1	27188	0.435560
chr6	74171453	74211179	MTO1	39726	0.426924
chr6	74225472	74230755	EEF1A1	5283	0.442173
chr6	74303101	74363737	SLC17A5	60636	0.421812
chr6	74403625	74405743	AK124950	2118	0.458924
chr6	74405507	74538041	CD109	132534	0.385773
chr6	74779166	75400443	AF086303	621277	0.364514
chr6	75794041	75915623	COL12A1	121582	0.368270
chr6	75947390	75953644	COX7A2	6254	0.408219
chr6	75962637	75994632	TMEM30A	31995	0.373340
chr6	75994729	76001580	LOC100506804	6851	0.397314
chr6	76017799	76203496	FILIP1	185697	0.381121
chr6	76311621	76427994	SENP6	116373	0.373386
chr6	76458908	76629254	MYO6	170346	0.376645
chr6	76631061	76782335	IMPG1	151274	0.385916
chr6	78171947	78173120	HTR1B	1173	0.565217
chr6	78646917	78646988	SNORD112	71	0.366197
chr6	79577260	79608135	IRAK1BP1	30875	0.374802
chr6	79644135	79788011	PHIP	143876	0.342941
chr6	79910961	79944455	HMGN3	33494	0.386159
chr6	79943390	79946517	LOC100288198	3127	0.425008
chr6	80017385	80023101	BC070061	5716	0.505248
chr6	80194707	80247147	LCA5	52440	0.349695
chr6	80248450	80248479	DQ582269	29	0.517241
chr6	80340999	80413369	SH3BGRL2	72370	0.388379
chr6	80451635	80451669	RNY4	34	0.470588
chr6	80513303	80580137	C6orf7	66834	0.384939
chr6	80624528	80657315	ELOVL4	32787	0.366792
chr6	80714321	80752244	TTK	37923	0.345331
chr6	80816343	81055987	BCKDHB	239644	0.368267
chr6	82455446	82462428	FAM46A	6982	0.423661
chr6	82523002	82523909	BC038576	907	0.369350
chr6	82879955	82957448	IBTK	77493	0.360936
chr6	83073960	83077133	TPBG	3173	0.522849
chr6	83602185	83775545	UBE3D	173360	0.384927
chr6	83777384	83878475	DOPEY1	101091	0.359725
chr6	83874592	83903655	PGM3	29063	0.393284
chr6	83903031	83906256	RWDD2A	3225	0.471628
chr6	83920109	84140938	ME1	220829	0.369340
chr6	84222193	84235421	PRSS35	13228	0.398246
chr6	84262604	84418847	SNAP91	156243	0.364964
chr6	84562984	84567234	RIPPLY2	4250	0.428941
chr6	84569369	84670146	CYB5R4	100777	0.372565
chr6	84743419	84800605	MRAP2	57186	0.423373
chr6	84833959	84937335	KIAA1009	103376	0.369960
chr6	85442215	85473954	TBX18	31739	0.371121
chr6	86096936	86099904	AK024998	2968	0.401954
chr6	86159301	86205509	NT5E	46208	0.430683
chr6	86215214	86303629	SNX14	88415	0.373670
chr6	86323692	86353043	SYNCRIP	29351	0.408334
chr6	86386724	86388438	SNHG5	1714	0.413069
chr6	86387011	86387086	SNORD50A	75	0.360000
chr6	86387306	86387377	SNORD50B	71	0.380282
chr6	87647023	87726397	HTR1E	79374	0.384988
chr6	87795215	87804865	CGA	9650	0.367876
chr6	87865268	87973406	ZNF292	108138	0.376167
chr6	87992696	88038996	GJB7	46300	0.403801
chr6	88032305	88052043	SMIM8	19738	0.395582
chr6	88054570	88075181	C6orf163	20611	0.402309
chr6	88091719	88109459	C6orf164	17740	0.404735
chr6	88117689	88174191	C6orf165	56502	0.379066
chr6	88182642	88222057	SLC35A1	39415	0.390131
chr6	88224095	88299735	RARS2	75640	0.382708
chr6	88299784	88377172	ORC3	77388	0.389518
chr6	88384577	88411985	AKIRIN2	27408	0.408238
chr6	88494577	88621449	AY927641	126872	0.403682
chr6	88757506	88776550	SPACA1	19044	0.354547
chr6	88849584	88875767	CNR1	26183	0.386281
chr6	89319988	89673348	RNGTT	353360	0.366371
chr6	89372191	89380624	JQ733905	8433	0.473734
chr6	89790428	89794879	PNRC1	4451	0.485734
chr6	89805677	89827800	SRSF12	22123	0.407720
chr6	89855768	89875288	PM20D2	19520	0.396107
chr6	89887222	89927496	GABRR1	40274	0.436758
chr6	89966839	90025018	GABRR2	58179	0.458413
chr6	90036343	90062619	UBE2J1	26276	0.402002
chr6	90074334	90121995	RRAGD	47661	0.422379
chr6	90142896	90343553	ANKRD6	200657	0.430237
chr6	90341942	90348474	LYRM2	6532	0.400949
chr6	90353230	90529442	MDN1	176212	0.415471
chr6	90539618	90584155	CASP8AP2	44537	0.425646
chr6	90604187	90605819	GJA10	1632	0.466912
chr6	90636246	91006627	BACH2	370381	0.405015
chr6	90710940	90711225	7SK	285	0.508772
chr6	91022460	91022552	MIR4464	92	0.358696
chr6	91223291	91297020	MAP3K7	73729	0.358814
chr6	92231377	92231455	MIR4643	78	0.384615
chr6	92338753	92400146	BC037927	61393	0.362582
chr6	93949739	94129300	EPHA7	179561	0.332567
chr6	94416800	94486199	TSG1	69399	0.342498
chr6	96025372	96057328	MANEA	31956	0.338591
chr6	96463844	96663488	FUT9	199644	0.352192
chr6	96969701	97003151	UFL1	33450	0.331181
chr6	97010423	97064512	FHL5	54089	0.353787
chr6	97097328	97097467	U4	139	0.410072
chr6	97241997	97285353	GPR63	43356	0.362603
chr6	97337186	97345767	NDUFAF4	8581	0.381424
chr6	97372495	97588630	KLHL32	216135	0.388817
chr6	97537842	97862283	MIR548H3	324441	0.366387
chr6	97590036	97731052	MMS22L	141016	0.355718
chr6	97753512	98156726	AK091365	403214	0.353405
chr6	98472406	98472495	MIR2113	89	0.415730
chr6	99282579	99286666	POU3F2	4087	0.483729
chr6	99321600	99395849	FBXL4	74249	0.369096
chr6	99720792	99797531	FAXC	76739	0.415617
chr6	99817347	99842082	COQ3	24735	0.393976
chr6	99846536	99849314	PNISR	2778	0.331533
chr6	99847840	99873207	PNISR	25367	0.364332
chr6	99872797	99875596	DQ599242	2799	0.446231
chr6	99880183	99963252	USP45	83069	0.377168
chr6	99968869	99981059	TSTD3	12190	0.408860
chr6	99990262	100016690	CCNC	26428	0.351445
chr6	100054649	100063454	PRDM13	8805	0.510278
chr6	100367785	100442114	MCHR2	74329	0.379677
chr6	100441913	100524295	LOC728012	82382	0.368296
chr6	100836749	100911811	SIM1	75062	0.398897
chr6	100956607	101329224	ASCC3	372617	0.341144
chr6	101846860	102517958	GRIK2	671098	0.339360
chr6	101878708	101878736	DQ585302	28	0.535714
chr6	105175967	105307794	HACE1	131827	0.373899
chr6	105384168	105388402	LINC00577	4234	0.435286
chr6	105404922	105531207	LIN28B	126285	0.366576
chr6	105544698	105584543	BVES	39845	0.402033
chr6	105585561	105617819	BVES-AS1	32258	0.384463
chr6	105605774	105627858	POPDC3	22084	0.396169
chr6	105725441	105850999	PREP	125558	0.409604
chr6	106534194	106557814	PRDM1	23620	0.412913
chr6	106632351	106773695	ATG5	141344	0.368342
chr6	106959304	107018334	AIM1	59030	0.402643
chr6	107018902	107077373	RTN4IP1	58471	0.410306
chr6	107077440	107116292	QRSL1	38852	0.395321
chr6	107165326	107193879	LOC100422737	28553	0.427451
chr6	107218004	107222877	AK123416	4873	0.435255
chr6	107349406	107372547	C6orf203	23141	0.470420
chr6	107386384	107435636	BEND3	49252	0.469016
chr6	107473760	107780779	PDSS2	307019	0.398213
chr6	107811316	107982513	SOBP	171197	0.416105
chr6	108023363	108145521	SCML4	122158	0.437655
chr6	108188959	108279482	SEC63	90523	0.398407
chr6	108362612	108395941	OSTM1	33329	0.389751
chr6	108444839	108479222	AF520419	34383	0.425908
chr6	108487214	108510013	NR2E1	22799	0.478486
chr6	108532716	108582464	SNX3	49748	0.412177
chr6	108616097	108844251	LACE1	228154	0.391551
chr6	108882068	109005971	FOXO3	123903	0.414695
chr6	109080363	109090321	LINC00222	9958	0.467463
chr6	109169618	109295352	ARMC2	125734	0.416156
chr6	109307639	109415708	SESN1	108069	0.375584
chr6	109450506	109485115	CEP57L1	34609	0.357479
chr6	109557816	109591717	LOC100996634	33901	0.414885
chr6	109615505	109629423	CCDC162P	13918	0.427791
chr6	109659677	109676151	C6orf185	16474	0.456780
chr6	109687716	109703762	CD164	16046	0.383211
chr6	109711417	109762374	PPIL6	50957	0.428989
chr6	109761930	109765122	SMPD2	3192	0.588346
chr6	109765265	109777190	MICAL1	11925	0.577107
chr6	109783718	109804440	ZBTB24	20722	0.438085
chr6	109814058	110012415	AK9	198357	0.382674
chr6	110012423	110146634	FIG4	134211	0.389327
chr6	110300297	110301924	GPR6	1627	0.577136
chr6	110421021	110501207	WASF1	80186	0.366485
chr6	110501586	110553422	CDC40	51836	0.367717
chr6	110567148	110679475	METTL24	112327	0.406403
chr6	110713382	110736753	DDO	23371	0.445766
chr6	110745891	110797844	SLC22A16	51953	0.413258
chr6	110931180	111136412	CDK19	205232	0.397833
chr6	111133327	111136191	BC047513	2864	0.457402
chr6	111195986	111216913	AMD1	20927	0.415253
chr6	111279762	111289091	GTF3C6	9329	0.454390
chr6	111303290	111346794	RPF2	43504	0.426513
chr6	111367621	111368757	GSTM2P1	1136	0.526408
chr6	111408780	111544606	SLC16A10	135826	0.403693
chr6	111580481	111590261	KIAA1919	9780	0.426483
chr6	111620233	111804432	REV3L	184199	0.368048
chr6	111804674	111824811	TRAF3IP2-AS1	20137	0.399911
chr6	111816121	111816969	AF216583	848	0.359670
chr6	111876580	111927477	TRAF3IP2	50897	0.444054
chr6	111981534	112041265	FYN	59731	0.433493
chr6	112375370	112390887	WISP3	15517	0.391119
chr6	112391859	112408751	TUBE1	16892	0.346614
chr6	112408673	112423993	FAM229B	15320	0.363251
chr6	112429133	112575917	LAMA4	146784	0.391085
chr6	112668531	112672498	RFPL4B	3967	0.401311
chr6	114178526	114184652	MARCKS	6126	0.484656
chr6	114189178	114194512	LOC285758	5334	0.345894
chr6	114225550	114242806	FLJ34503	17256	0.394124
chr6	114257319	114292359	HDAC2	35040	0.368493
chr6	114290864	114661899	BC042098	371035	0.381829
chr6	114376749	114384041	HS3ST5	7292	0.402907
chr6	116262692	116381921	FRK	119229	0.367637
chr6	116359893	116361107	TPI1P3	1214	0.553542
chr6	116421998	116566853	NT5DC1	144855	0.363419
chr6	116440084	116447296	COL10A1	7212	0.387271
chr6	116571130	116575261	TSPYL4	4131	0.477366
chr6	116601282	116759442	DSE	158160	0.380735
chr6	116596021	116601280	TSPYL1	5259	0.444761
chr6	116782532	116784934	FAM26F	2402	0.491257
chr6	116817650	116866773	TRAPPC3L	49123	0.378560
chr6	116832807	116839709	FAM26E	6902	0.397566
chr6	116850175	116880031	FAM26D	29856	0.368703
chr6	116892582	116914436	RWDD1	21854	0.361764
chr6	116937641	116954148	RSPH4A	16507	0.378809
chr6	116956780	116989973	ZUFSP	33193	0.365408
chr6	116999739	117001922	AX746765	2183	0.447549
chr6	117002366	117063030	KPNA5	60664	0.355433
chr6	117073359	117086886	FAM162B	13527	0.378798
chr6	117113247	117150198	GPRC6A	36951	0.372331
chr6	117198375	117253326	RFX6	54951	0.345781
chr6	117586720	117594728	VGLL2	8008	0.478022
chr6	117609529	117747018	ROS1	137489	0.372393
chr6	117622617	117622921	7SK	304	0.427632
chr6	117803819	117891020	DCBLD1	87201	0.394422
chr6	117996616	118031886	NUS1	35270	0.373887
chr6	118228688	118638839	SLC35F1	410151	0.384563
chr6	118781934	119031238	CEP85L	249304	0.381663
chr6	118822535	118824996	BRD7P3	2461	0.378302
chr6	118869441	118881587	PLN	12146	0.343158
chr6	119103870	119104581	LOC100287632	711	0.413502
chr6	119134611	119252903	MCM9	118292	0.389257
chr6	119215240	119230335	ASF1A	15095	0.393177
chr6	119280995	119399812	FAM184A	118817	0.379289
chr6	119390211	119390308	MIR548B	97	0.371134
chr6	119498365	119670931	MAN1A1	172566	0.375972
chr6	119648445	119648550	U6	105	0.419048
chr6	119773711	119812467	LOC285762	38756	0.379915
chr6	121400626	121655644	C6orf170	255018	0.357285
chr6	121756744	121770873	GJA1	14129	0.402435
chr6	122720695	122754264	HSF2	33569	0.355477
chr6	122757933	122760368	BC022047	2435	0.384394
chr6	122764492	122792952	SERINC1	28460	0.359346
chr6	122973873	123047518	PKIB	73645	0.366515
chr6	123100645	123105218	FABP7	4573	0.377651
chr6	123109970	123130864	SMPDL3A	20894	0.404901
chr6	123317581	123385063	CLVS2	67482	0.367683
chr6	123537483	123958238	TRDN	420755	0.349714
chr6	123760748	123792901	AL832096	32153	0.366809
chr6	124125068	125146786	NKAIN2	1021718	0.361008
chr6	125229391	125284173	STL	54782	0.375141
chr6	125304513	125404661	RNF217	100148	0.363572
chr6	125474878	125584644	TPD52L1	109766	0.389838
chr6	125596495	125623282	HDDC2	26787	0.409639
chr6	125995498	126041364	LOC643623	45866	0.387629
chr6	126039386	126070336	BC036196	30950	0.381195
chr6	126070731	126082415	HEY2	11684	0.403372
chr6	126111908	126253176	NCOA7	141268	0.389848
chr6	126196313	126196644	7SK	331	0.456193
chr6	126277860	126301389	HINT3	23529	0.381614
chr6	126307575	126360420	TRMT11	52845	0.360204
chr6	126433836	126443762	MIR5695	9926	0.387266
chr6	126661252	126669754	CENPW	8502	0.359798
chr6	126698800	127440994	AK127472	742194	0.361581
chr6	126923379	126923444	Vimentin3	65	0.353846
chr6	127440047	127518184	RSPO3	78137	0.358946
chr6	127587826	127609705	RNF146	21879	0.364642
chr6	127609856	127663552	ECHDC1	53696	0.356432
chr6	127759550	127780535	KIAA0408	20985	0.350441
chr6	127759550	127840500	SOGA3	80950	0.382224
chr6	127898318	127912963	C6orf58	14645	0.340935
chr6	128029338	128222226	THEMIS	192888	0.350774
chr6	128289923	128841870	PTPRK	551947	0.354130
chr6	129204285	129837710	LAMA2	633425	0.360205
chr6	129758019	129758125	U6	106	0.349057
chr6	129800757	129873731	BC035400	72974	0.377518
chr6	129898239	130031370	ARHGAP18	133131	0.385703
chr6	130152388	130182416	TMEM244	30028	0.373252
chr6	130339727	130462594	L3MBTL3	122867	0.382975
chr6	130465446	130537030	SAMD3	71584	0.407535
chr6	130687425	130764210	TMEM200A	76785	0.379267
chr6	131148544	131158276	SMLR1	9732	0.417797
chr6	131160487	131384462	EPB41L2	223975	0.385981
chr6	131456825	131604675	AKAP7	147850	0.382131
chr6	131894343	131905472	ARG1	11129	0.379639
chr6	131907877	131949379	MED23	41502	0.355356
chr6	131958374	132068550	ENPP3	110176	0.379139
chr6	132021608	132022541	OR2A4	933	0.501608
chr6	132029580	132032157	CTAGE9	2577	0.412107
chr6	132129155	132216295	ENPP1	87140	0.381937
chr6	132141473	132141793	7SK	320	0.471875
chr6	132269316	132272518	CTGF	3202	0.522486
chr6	132270468	132270491	DD182001	23	0.521739
chr6	132455117	132468198	LOC100507254	13081	0.379787
chr6	132617193	132722664	MOXD1	105471	0.370680
chr6	132778662	132834337	STX7	55675	0.378015
chr6	132859426	132860475	TAAR9	1049	0.420400
chr6	132873831	132874860	TAAR8	1029	0.412051
chr6	132891460	132892498	TAAR6	1038	0.445087
chr6	132909730	132910877	TAAR5	1147	0.523976
chr6	132929363	132930441	TAAR3	1078	0.413729
chr6	132938288	132945414	TAAR2	7126	0.374965
chr6	132966122	132967142	TAAR1	1020	0.377451
chr6	133001996	133035194	VNN1	33198	0.381168
chr6	133043925	133055831	VNN3	11906	0.377289
chr6	133065008	133079033	VNN2	14025	0.393369
chr6	133090506	133119747	SLC18B1	29241	0.396361
chr6	133135707	133138703	RPS12	2996	0.421896
chr6	133136445	133138490	SNORA33	2045	0.396577
chr6	133409218	133427717	LINC00326	18499	0.366074
chr6	133562494	133853258	EYA4	290764	0.368705
chr6	133823389	134210120	BC041459	386731	0.379951
chr6	134142284	134175130	MGC34034	32846	0.368355
chr6	134210258	134213393	TCF21	3135	0.501754
chr6	134216640	134219157	AX747860	2517	0.473580
chr6	134273307	134308638	TBPL1	35331	0.379129
chr6	134308718	134373789	SLC2A12	65071	0.408738
chr6	134435110	134438818	HMGA1P7	3708	0.492449
chr6	134490383	134639196	SGK1	148813	0.422638
chr6	134749385	134800051	BC040308	50666	0.401453
chr6	134758853	134825158	LOC154092	66305	0.398944
chr6	134846455	134930796	AJ606331	84341	0.392561
chr6	134943815	134943843	DQ591448	28	0.392857
chr6	135238527	135271260	ALDH8A1	32733	0.425289
chr6	135281516	135376036	HBS1L	94520	0.355999
chr6	135300475	135300570	MIR3662	95	0.378947
chr6	135502452	135540311	MYB	37859	0.397369
chr6	135605109	135818903	AHI1	213794	0.363130
chr6	135818938	135839968	LINC00271	21030	0.370376
chr6	135819541	136011976	LINC00271	192435	0.376226
chr6	136172833	136516709	PDE7B	343876	0.383150
chr6	136175173	136546762	AJ606316	371589	0.385464
chr6	136552167	136571449	MTFR2	19282	0.397936
chr6	136578000	136610989	BCLAF1	32989	0.356088
chr6	136663418	136847351	MAP7	183933	0.389109
chr6	136866329	136866630	7SK	301	0.405316
chr6	136878186	137113656	MAP3K5	235470	0.398947
chr6	137143701	137235072	PEX7	91371	0.383678
chr6	137243401	137246776	SLC35D3	3375	0.578963
chr6	137303295	137314368	NHEG1	11073	0.407387
chr6	137321107	137366298	IL20RA	45191	0.412007
chr6	137464956	137494785	IL22RA2	29829	0.416306
chr6	137518620	137540567	IFNGR1	21947	0.387661
chr6	137813335	137815531	OLIG3	2196	0.546448
chr6	138144806	138189370	LOC100130476	44564	0.411251
chr6	138188324	138204451	TNFAIP3	16127	0.439697
chr6	138409641	138428660	PERP	19019	0.394500
chr6	138483052	138665800	KIAA1244	182748	0.416158
chr6	138537126	138539627	PBOV1	2501	0.382247
chr6	138725335	138734582	HEBP2	9247	0.462637
chr6	138743180	138820579	NHSL1	77399	0.408455
chr6	138756349	138756431	MIR3145	82	0.317073
chr6	139012957	139018187	FLJ46906	5230	0.539006
chr6	139046347	139094816	LOC100507462	48469	0.417978
chr6	139094656	139114456	CCDC28A	19800	0.391616
chr6	139117247	139225207	ECT2L	107960	0.413996
chr6	139225619	139309398	REPS1	83779	0.374199
chr6	139349818	139364439	ABRACL	14621	0.442035
chr6	139456248	139501946	HECA	45698	0.417830
chr6	139561198	139613208	TXLNB	52010	0.402634
chr6	139693391	139695350	CITED2	1959	0.511996
chr6	139790131	139795733	LOC645434	5602	0.416101
chr6	140092209	140181608	LOC100132735	89399	0.374109
chr6	140297466	140414858	BC038188	117392	0.369233
chr6	140526388	140526463	MIR3668	75	0.213333
chr6	141004950	141005020	MIR4465	70	0.500000
chr6	141807277	141807549	7SK	272	0.466912
chr6	141902805	142351554	AK097143	448749	0.358735
chr6	142334791	142334865	JA611295	74	0.243243
chr6	142334796	142334860	JA611294	64	0.234375
chr6	142396744	142409936	NMBR	13192	0.368632
chr6	142468409	142542085	VTA1	73676	0.353141
chr6	142623055	142767403	GPR126	144348	0.356825
chr6	142847591	142959026	LOC153910	111435	0.395002
chr6	143072603	143266338	HIVEP2	193735	0.383204
chr6	143287558	143358719	LOC100507489	71161	0.381866
chr6	143382022	143661441	AIG1	279419	0.396126
chr6	143743968	143771841	ADAT2	27873	0.383920
chr6	143771917	143811751	PEX3	39834	0.351208
chr6	143815948	143833020	FUCA2	17072	0.399485
chr6	143875466	143883185	LOC285740	7719	0.426091
chr6	143999101	144152322	PHACTR2	153221	0.396871
chr6	144164507	144184943	LTV1	20436	0.397044
chr6	144175205	144177090	AX746989	1885	0.381963
chr6	144185572	144259483	ZC2HC1B	73911	0.398141
chr6	144261436	144329541	PLAGL1	68105	0.398326
chr6	144416017	144416754	SF3B5	737	0.573948
chr6	144471653	144513076	STX11	41423	0.409145
chr6	144612872	145174170	UTRN	561298	0.379180
chr6	145946439	146056991	EPM2A	110552	0.379487
chr6	146136011	146207721	LOC100507557	71710	0.370158
chr6	146110405	146113109	FLJ44955	2704	0.450074
chr6	146119271	146135921	FBXO30	16650	0.360360
chr6	146205944	146285233	SHPRH	79289	0.349128
chr6	146348781	146758734	GRM1	409953	0.371843
chr6	146864827	146876086	RAB32	11259	0.394706
chr6	146870894	146873504	FW339973	2610	0.386207
chr6	146920135	147136597	ADGB	216462	0.357767
chr6	147122804	147124960	LOC729176	2156	0.360390
chr6	147162524	147525750	STXBP5-AS1	363226	0.382401
chr6	147162524	147237021	STXBP5-AS1	74497	0.400271
chr6	147525493	147711612	STXBP5	186119	0.343748
chr6	147646094	147661829	STXBP5	15735	0.325008
chr6	147829827	147891157	SAMD5	61330	0.395337
chr6	148048811	148051503	BC047626	2692	0.421248
chr6	148663728	148873184	SASH1	209456	0.429957
chr6	149068270	149398126	UST	329856	0.414035
chr6	149275396	149285820	LOC100128176	10424	0.440618
chr6	149639435	149732747	TAB2	93312	0.364037
chr6	149721494	149722182	SUMO4	688	0.401163
chr6	149768765	149806148	ZC3H12D	37383	0.501378
chr6	149825630	149867238	PPIL4	41608	0.384926
chr6	149887527	149912067	GINM1	24540	0.420212
chr6	149914751	149915720	RPS18P9	969	0.455108
chr6	149916010	149969940	KATNA1	53930	0.421027
chr6	149979288	150039392	LATS1	60104	0.412202
chr6	150045456	150067688	NUP43	22232	0.434509
chr6	150070830	150132557	PCMT1	61727	0.413741
chr6	150139893	150185480	LRP11	45587	0.441661
chr6	150184633	150240644	LOC100652739	56011	0.463105
chr6	150209600	150212170	RAET1E	2570	0.492218
chr6	150238013	150244214	RAET1G	6201	0.540558
chr6	150255662	150257455	BC040898	1793	0.498606
chr6	150263135	150270368	ULBP2	7233	0.529379
chr6	150285142	150294846	ULBP1	9704	0.518034
chr6	150319154	150326280	RAET1K	7126	0.529610
chr6	150341265	150346668	RAET1L	5403	0.535258
chr6	150385720	150390283	ULBP3	4563	0.540215
chr6	150464187	150571528	PPP1R14C	107341	0.439180
chr6	150690027	150725765	IYD	35738	0.416392
chr6	150920998	151164799	PLEKHG1	243801	0.423259
chr6	151186814	151423023	MTHFD1L	236209	0.434958
chr6	151260357	151260464	U6	107	0.457944
chr6	151517807	151549592	BC031960	31785	0.428661
chr6	151561133	151679694	AKAP12	118561	0.438686
chr6	151601649	151601747	U6	98	0.428571
chr6	151685249	151712677	ZBTB2	27428	0.443197
chr6	151725896	151773316	RMND1	47420	0.422944
chr6	151773421	151791232	C6orf211	17811	0.392342
chr6	151815174	151942328	CCDC170	127154	0.408450
chr6	151936907	151937014	U6	107	0.411215
chr6	152128453	152424408	ESR1	295955	0.392431
chr6	152442818	152958534	SYNE1	515716	0.384062
chr6	153019029	153045715	MYCT1	26686	0.355355
chr6	153071931	153080902	VIP	8971	0.337978
chr6	153291657	153304203	FBXO5	12546	0.375578
chr6	153308399	153323925	MTRF1L	15526	0.378140
chr6	153332031	153452389	RGS17	120358	0.377640
chr6	154360442	154414655	OPRM1	54213	0.373268
chr6	154475617	154831753	IPCEF1	356136	0.412073
chr6	155054511	155155194	SCAF8	100683	0.376499
chr6	155411422	155578857	TIAM2	167435	0.437435
chr6	155184661	155230000	AK124484	45339	0.427050
chr6	155226209	155226340	U8	131	0.328244
chr6	155572433	155575064	AB075492	2631	0.436716
chr6	155577263	155635617	TFB1M	58354	0.384327
chr6	155585146	155597682	CLDN20	12536	0.403717
chr6	155716501	155777037	NOX3	60536	0.407890
chr6	157099063	157531913	ARID1B	432850	0.408294
chr6	157100811	157100865	MIR4466	54	0.851852
chr6	157710053	157745253	TMEM242	35200	0.435313
chr6	157802556	158094977	ZDHHC14	292421	0.455706
chr6	157950163	157950232	MIR3692	69	0.507246
chr6	158244293	158366109	SNX9	121816	0.407894
chr6	158402887	158520207	SYNJ2	117320	0.496727
chr6	158422138	158423415	SYNJ2-IT1	1277	0.523884
chr6	158530535	158589312	SERAC1	58777	0.398098
chr6	158589378	158620376	GTF2H5	30998	0.408994
chr6	158733691	158932856	TULP4	199165	0.429819
chr6	158957467	159056467	TMEM181	99000	0.473737
chr6	158981118	158981146	DQ581726	28	0.678571
chr6	159031785	159031813	DQ586009	28	0.607143
chr6	159057506	159065804	DYNLT1	8298	0.454326
chr6	159071045	159185908	SYTL3	114863	0.460174
chr6	159185692	159185785	MIR3918	93	0.623656
chr6	159186772	159239340	EZR	52568	0.455448
chr6	159219681	159221893	AX747826	2212	0.440325
chr6	159239010	159243272	EZR-AS1	4262	0.564524
chr6	159262157	159278664	OSTCP1	16507	0.453686
chr6	159309618	159331385	C6orf99	21767	0.439702
chr6	159398265	159421198	RSPH3	22933	0.399599
chr6	159456026	159466184	TAGAP	10158	0.430793
chr6	159590428	159693140	FNDC1	102712	0.433883
chr6	160007986	160010201	AK130765	2215	0.451016
chr6	160100148	160114353	SOD2	14205	0.426399
chr6	160148029	160177352	WTAP	29323	0.384613
chr6	160181290	160183364	LOC100129518	2074	0.554484
chr6	160182988	160200087	ACAT2	17099	0.437862
chr6	160199529	160210735	TCP1	11206	0.408442
chr6	160201281	160201413	SNORA20	132	0.401515
chr6	160206625	160206765	SNORA29	140	0.364286
chr6	160211491	160219461	MRPL18	7970	0.427980
chr6	160221280	160241736	PNLDC1	20456	0.480299
chr6	160327973	160329107	MAS1	1134	0.468254
chr6	160390130	160527583	IGF2R	137453	0.455850
chr6	160424322	160428696	AIRN	4374	0.517604
chr6	160514113	160517244	LOC729603	3131	0.465347
chr6	160542862	160579750	SLC22A1	36888	0.463945
chr6	160637793	160679963	SLC22A2	42170	0.417572
chr6	160769404	160873611	SLC22A3	104207	0.416565
chr6	160888217	160932156	LPAL2	43939	0.409317
chr6	160952514	161087407	LPA	134893	0.420600
chr6	161123224	161175085	PLG	51861	0.404620
chr6	161412821	161538417	MAP3K4	125596	0.387743
chr6	161551056	161695107	AGPAT4	144051	0.453596
chr6	161581163	161583014	AGPAT4-IT1	1851	0.520800
chr6	161768589	163148834	PARK2	1380245	0.404234
chr6	163148163	163736524	PACRG	588361	0.395912
chr6	163464011	163475193	AK058177	11182	0.374441
chr6	163586445	163612840	AK296276	26395	0.438189
chr6	163731016	163745505	PACRG-AS1	14489	0.456415
chr6	163759373	163768065	DKFZp451B082	8692	0.492867
chr6	163834096	163834982	CAHM	886	0.606095
chr6	163835674	163999628	QKI	163954	0.362248
chr6	164092635	164195657	AK093114	103022	0.445536
chr6	165206863	165235542	AK090788	28679	0.394540
chr6	165693152	165723111	C6orf118	29959	0.411362
chr6	165740775	166075588	PDE10A	334813	0.384866
chr6	166193756	166399984	AK090688	206228	0.438316
chr6	166337535	166401527	LINC00473	63992	0.431991
chr6	166352947	166401527	LINC00473	48580	0.432400
chr6	166401038	166403103	LINC00602	2065	0.607748
chr6	166571145	166582157	T	11012	0.515438
chr6	166719167	166721871	PRR18	2704	0.619083
chr6	166733516	166755991	SFT2D1	22475	0.434171
chr6	166756118	166764957	LOC100289495	8839	0.427537
chr6	166778407	166796501	MPC1	18094	0.389356
chr6	166822853	167275771	RPS6KA2	452918	0.466064
chr6	166874150	166878871	RPS6KA2-IT1	4721	0.537598
chr6	166922841	166922921	MIR1913	80	0.637500
chr6	167343003	167370077	RNASET2	27074	0.481975
chr6	167346862	167370679	RNASET2	23817	0.482638
chr6	167411294	167411400	MIR3939	106	0.547170
chr6	167525294	167552629	CCR6	27335	0.456704
chr6	167412815	167454066	FGFR1OP	41251	0.404620
chr6	167570359	167571319	GPR31	960	0.623958
chr6	167584080	167596396	TCP10L2	12316	0.504547
chr6	167704802	167729502	UNC93A	24700	0.510121
chr6	167738573	167756177	TTLL2	17604	0.436264
chr6	167786576	167797998	TCP10	11422	0.507704
chr6	168067523	168079903	AK127120	12380	0.521729
chr6	168084340	168084736	LOC441178	396	0.492424
chr6	168185218	168197539	C6orf123	12321	0.473338
chr6	168224569	168227476	MLLT4-AS1	2907	0.527692
chr6	168227670	168372700	MLLT4	145030	0.387727
chr6	168376603	168377619	HGC6.3	1016	0.595472
chr6	168393501	168397757	HGC6.1.1	4256	0.541588
chr6	168418552	168445769	KIF25	27217	0.473748
chr6	168456463	168479839	FRMD1	23376	0.576788
chr6	168707583	168720402	DACT2	12819	0.553475
chr6	168841830	169068674	SMOC2	226844	0.472258
chr6	169575398	169582835	AF086258	7437	0.435794
chr6	169615874	169654137	THBS2	38263	0.495283
chr6	169773775	169788480	AK055570	14705	0.468480
chr6	169857302	170102159	WDR27	244857	0.420086
chr6	170102256	170106402	C6orf120	4146	0.422094
chr6	170104001	170124106	PHF10	20105	0.369212
chr6	170140214	170151638	TCTE3	11424	0.384191
chr6	170151720	170181617	C6orf70	29897	0.433120
chr6	170188885	170198921	LINC00242	10036	0.466122
chr6	170190168	170202969	LINC00574	12801	0.477541
chr6	170563421	170571657	LOC154449	8236	0.483487
chr6	170591293	170599697	DLL1	8404	0.578296
chr6	170615843	170714237	FAM120B	98394	0.434366
chr6	170639848	170639932	MIR4644	84	0.595238
chr6	170844203	170862417	PSMB1	18214	0.398045
chr6	170863420	170881958	TBP	18538	0.394217
chr6	170884659	170893780	PDCD2	9121	0.416950
chr6	171004401	171006035	BC036251	1634	0.432681
chr7	149596	154868	AK024243	5272	0.529590
chr7	192968	300740	FAM20C	107772	0.322579
chr7	227553	229557	AX746542	2004	0.561876
chr7	330135	331454	LOC100288524	1319	0.712661
chr7	419390	422845	LOC442497	3455	0.591317
chr7	536896	559481	PDGFA	22585	0.597520
chr7	560027	564869	FLJ44511	4842	0.620818
chr7	588833	767313	PRKAR1B	178480	0.541299
chr7	766337	826116	HEATR2	59779	0.532930
chr7	872141	914557	SUN1	42416	0.508204
chr7	916190	936071	GET4	19881	0.597455
chr7	937536	994306	ADAP1	56770	0.604950
chr7	1004485	1015235	COX19	10750	0.515628
chr7	1022834	1029276	CYP2W1	6442	0.668115
chr7	1036622	1177893	C7orf50	141271	0.576941
chr7	1062568	1062662	MIR339	94	0.734043
chr7	1064138	1067988	C7orf50	3850	0.620779
chr7	1097140	1098897	GPR146	1757	0.588503
chr7	1127722	1133451	GPER	5729	0.566940
chr7	1192542	1199855	ZFAND2A	7313	0.537536
chr7	1200127	1205594	AK090593	5467	0.507408
chr7	1272653	1276613	UNCX	3960	0.681313
chr7	1473994	1499109	MICALL2	25115	0.632610
chr7	1509912	1544018	INTS1	34106	0.635343
chr7	1570367	1582679	MAFK	12312	0.633772
chr7	1572088	1574516	FW339998	2428	0.608731
chr7	1581870	1596066	TMEM184A	14196	0.628276
chr7	1606969	1609668	PSMG3	2699	0.555020
chr7	1626206	1629259	KIAA1908	3053	0.569931
chr7	1654105	1656328	TFAMP1	2223	0.388214
chr7	1732445	1733961	LOC401296	1516	0.613456
chr7	1748797	1787590	ELFN1	38793	0.574459
chr7	1778265	1781929	JX046910	3664	0.609170
chr7	1855427	2272583	MAD1L1	417156	0.556461
chr7	1883815	1883889	MIR4655	74	0.689189
chr7	1884935	1889567	AK127048	4632	0.598877
chr7	2273925	2281833	FTSJ2	7908	0.500506
chr7	2281856	2290780	NUDT1	8924	0.567683
chr7	2291404	2354099	SNX8	62695	0.533583
chr7	2394473	2420377	EIF3B	25904	0.515017
chr7	2443194	2474216	CHST12	31022	0.493134
chr7	2477397	2487485	BC034268	10088	0.533803
chr7	2559478	2568063	LFNG	8585	0.642632
chr7	2566707	2566786	MIR4648	79	0.645570
chr7	2577443	2595392	BRAT1	17949	0.551006
chr7	2598631	2654368	IQCE	55737	0.528033
chr7	2671602	2704436	TTYH3	32834	0.622921
chr7	2719162	2755069	AMZ1	35907	0.564709
chr7	2767740	2883959	GNA12	116219	0.458677
chr7	2945709	3083509	CARD11	137800	0.492373
chr7	3186628	3214287	BC038729	27659	0.480748
chr7	3341079	4308631	SDK1	967552	0.431156
chr7	3549814	3549834	DL490859	20	0.400000
chr7	4721929	4811074	FOXK1	89145	0.520882
chr7	4815261	4834026	AP5Z1	18765	0.582627
chr7	4828195	4828270	MIR4656	75	0.706667
chr7	4836686	4923335	RADIL	86649	0.531270
chr7	4897368	4901625	PAPOLB	4257	0.404745
chr7	4936898	4938473	BC045805	1575	0.471746
chr7	4945619	4998844	MMD2	53225	0.498281
chr7	5085552	5109119	RBAK	23567	0.401536
chr7	5111690	5112854	RBAKDN	1164	0.658935
chr7	5160940	5172198	ZNF890P	11258	0.497957
chr7	5229834	5273486	WIPI2	43652	0.481994
chr7	5322560	5343704	SLC29A4	21144	0.589907
chr7	5346422	5463177	TNRC18	116755	0.545895
chr7	5515427	5553399	FBXL18	37972	0.556858
chr7	5535449	5535548	MIR589	99	0.626263
chr7	5553484	5564594	BC044606	11110	0.505581
chr7	5566778	5570232	ACTB	3454	0.614939
chr7	5632435	5646287	FSCN1	13852	0.596232
chr7	5659671	5821361	RNF216	161690	0.455229
chr7	5702062	5720092	RNF216-IT1	18030	0.484692
chr7	5817156	5819899	BC040728	2743	0.434196
chr7	5862790	5894066	ZNF815P	31276	0.483949
chr7	5920428	5925994	OCM	5566	0.464966
chr7	5938340	5965603	CCZ1	27263	0.461468
chr7	5965776	6010314	RSPH10B	44538	0.482554
chr7	6012869	6048737	PMS2	35868	0.450457
chr7	6048881	6063465	AIMP2	14584	0.469350
chr7	6061877	6098860	EIF2AK1	36983	0.447070
chr7	6071006	6076183	ANKRD61	5177	0.463009
chr7	6144549	6201195	USP42	56646	0.455584
chr7	6201411	6312242	CYTH3	110831	0.447627
chr7	6369039	6388590	FAM220A	19551	0.482379
chr7	6414125	6443598	RAC1	29473	0.458861
chr7	6448746	6487643	DAGLB	38897	0.499139
chr7	6500711	6523849	KDELR2	23138	0.455009
chr7	6536408	6591067	GRID2IP	54659	0.544467
chr7	6617064	6628610	ZDHHC4	11546	0.467954
chr7	6628426	6628462	DQ579268	36	0.583333
chr7	6629914	6648355	C7orf26	18441	0.527195
chr7	6655526	6663921	ZNF853	8395	0.565694
chr7	6692370	6692400	DQ594582	30	0.600000
chr7	6703604	6714110	AK123300	10506	0.497811
chr7	6728063	6746566	ZNF12	18503	0.434416
chr7	6769445	6777567	PMS2CL	8122	0.475376
chr7	6793739	6838396	RSPH10B2	44657	0.482567
chr7	6838565	6865926	CCZ1B	27361	0.460802
chr7	7115400	7136417	LOC100131257	21017	0.398059
chr7	7222245	7288280	C1GALT1	66035	0.372711
chr7	7398243	7575460	COL28A1	177217	0.385036
chr7	7606615	7647110	MIOS	40495	0.365625
chr7	7676574	7758238	RPA3	81664	0.372159
chr7	7680341	7918851	LOC729852	238510	0.373670
chr7	8008373	8128709	GLCCI1	120336	0.365036
chr7	8152814	8301682	ICA1	148868	0.401618
chr7	8384552	8387652	AX746880	3100	0.446129
chr7	8473584	8792593	NXPH1	319009	0.374522
chr7	9136900	9229487	RBSG3	92587	0.351324
chr7	9673899	9675447	PER4	1548	0.370155
chr7	10262423	10262638	U3	215	0.432558
chr7	10971579	10979813	NDUFA4	8234	0.376488
chr7	11013498	11147376	PHF14	133878	0.356825
chr7	11292739	11425306	BC040327	132567	0.364978
chr7	11410061	11871824	THSD7A	461763	0.355117
chr7	12250847	12276890	TMEM106B	26043	0.343739
chr7	12370508	12443852	VWDE	73344	0.340246
chr7	12596186	12616811	BC075797	20625	0.381915
chr7	12610202	12693228	SCIN	83026	0.385542
chr7	12641596	12641669	TRNA	73	0.493151
chr7	12726451	12730558	ARL4A	4107	0.430485
chr7	13930855	14029642	ETV1	98787	0.361070
chr7	14184673	14881075	DGKB	696402	0.351360
chr7	15239942	15601640	AGMO	361698	0.349878
chr7	15650836	15726308	MEOX2	75472	0.348248
chr7	15707571	15721604	BX538274	14033	0.342051
chr7	16127151	16460947	ISPD	333796	0.366403
chr7	16250110	16310229	LOC100506025	60119	0.359670
chr7	16501105	16505482	SOSTDC1	4377	0.363263
chr7	16566504	16621114	LRRC72	54610	0.388775
chr7	16639400	16685442	ANKMY2	46042	0.380109
chr7	16685758	16746148	BZW2	60390	0.377695
chr7	16793350	16824161	TSPAN13	30811	0.390477
chr7	16832263	16844738	AGR2	12475	0.396874
chr7	16899029	16921613	AGR3	22584	0.351842
chr7	17338275	17385775	AHR	47500	0.345347
chr7	17830384	17980131	SNX13	149747	0.350885
chr7	18066399	18067486	PRPS1L1	1087	0.459982
chr7	18535884	19036992	HDAC9	501108	0.359970
chr7	19155090	19157295	TWIST1	2205	0.575057
chr7	19183915	19185876	BC043576	1961	0.546660
chr7	19184404	19185044	FERD3L	640	0.625000
chr7	19735084	19748660	TWISTNB	13576	0.361889
chr7	19744980	19745059	MIR3146	79	0.379747
chr7	19758937	19812404	TMEM196	53467	0.347504
chr7	20174278	20257013	MACC1	82735	0.364380
chr7	20181538	20193154	MACC1-AS1	11616	0.363981
chr7	20370724	20455382	ITGB8	84658	0.372629
chr7	20416953	20417024	SNORD56	71	0.408451
chr7	20655244	20796637	ABCB5	141393	0.376369
chr7	20821893	20826508	SP8	4615	0.543012
chr7	20866916	20867439	RPL23P8	523	0.456979
chr7	21467688	21554151	SP4	86463	0.383713
chr7	21582832	21941186	DNAH11	358354	0.387226
chr7	21940516	21985542	CDCA7L	45026	0.413828
chr7	22157907	22396533	RAPGEF5	238626	0.393842
chr7	22478037	22539901	STEAP1B	61864	0.418385
chr7	22602955	22613617	LOC100506178	10662	0.447008
chr7	22765013	22767235	LOC541472	2222	0.490099
chr7	22766765	22771621	IL6	4856	0.449959
chr7	22852250	22862471	TOMM7	10221	0.416300
chr7	22896231	22896305	SNORD93	74	0.418919
chr7	22980877	23053770	FAM126A	72893	0.353834
chr7	23140846	23145322	KLHL7-AS1	4476	0.393878
chr7	23145352	23215038	KLHL7	69686	0.386936
chr7	23221445	23240630	NUPL2	19185	0.405160
chr7	23234021	23240630	NUPL2	6609	0.379936
chr7	23245631	23247664	AK057873	2033	0.465814
chr7	23286315	23314729	GPNMB	28414	0.418702
chr7	23338939	23349180	MALSU1	10241	0.424958
chr7	23349827	23509995	IGF2BP3	160168	0.416219
chr7	23436064	23436135	SNORD65	71	0.338028
chr7	23530006	23531031	RPS2P32	1025	0.606829
chr7	23544400	23571656	TRA2A	27256	0.410845
chr7	23624334	23626146	CLK2P	1812	0.529249
chr7	23636997	23684327	CCDC126	47330	0.419776
chr7	23719748	23742269	FAM221A	22521	0.399050
chr7	23749785	23872130	STK31	122345	0.374376
chr7	24323806	24331484	NPY	7678	0.434228
chr7	24613084	24727498	MPP6	114414	0.359493
chr7	24737973	24797083	DFNA5	59110	0.454982
chr7	24836163	25019760	OSBPL3	183597	0.405731
chr7	25158269	25164980	CYCS	6711	0.427656
chr7	25174315	25219817	C7orf31	45502	0.402202
chr7	25264190	25268105	NPVF	3915	0.359898
chr7	25304274	25304501	U3	227	0.475771
chr7	25632970	25702673	AK057379	69703	0.405219
chr7	25880600	25880630	RNU6-16P	30	0.400000
chr7	25989538	25989606	MIR148A	68	0.455882
chr7	26191846	26226756	NFE2L3	34910	0.446462
chr7	26229555	26240413	HNRNPA2B1	10858	0.387272
chr7	26241323	26253227	CBX3	11904	0.401630
chr7	26331514	26413949	SNX10	82435	0.426615
chr7	26438338	26538594	LOC441204	100256	0.421451
chr7	26572739	26578444	KIAA0087	5705	0.429273
chr7	26677489	26686924	C7orf71	9435	0.449285
chr7	26706687	26904341	SKAP2	197654	0.359623
chr7	27132613	27135625	HOXA1	3012	0.467463
chr7	27135712	27139877	HOTAIRM1	4165	0.531092
chr7	27139972	27142394	HOXA2	2422	0.497110
chr7	27145808	27159214	HOXA3	13406	0.514546
chr7	27161537	27168379	BC035889	6842	0.476177
chr7	27168125	27170399	HOXA4	2274	0.569481
chr7	27179982	27195547	HOXA-AS3	15565	0.544491
chr7	27180670	27183287	HOXA5	2617	0.535346
chr7	27185201	27187393	HOXA6	2192	0.546533
chr7	27193337	27196296	HOXA7	2959	0.549848
chr7	27202056	27205149	HOXA9	3093	0.517944
chr7	27208517	27211534	HOXA-AS4	3017	0.525025
chr7	27209098	27209182	MIR196B	84	0.476190
chr7	27210209	27213955	HOXA10	3746	0.550454
chr7	27220775	27224835	HOXA11	4060	0.543596
chr7	27227692	27228912	LOC402470	1220	0.600000
chr7	27236498	27239725	HOXA13	3227	0.525566
chr7	27240039	27246130	HOTTIP	6091	0.526350
chr7	27282163	27286192	EVX1	4029	0.634649
chr7	27451782	27452510	BC034444	728	0.401099
chr7	27565058	27702620	HIBADH	137562	0.368765
chr7	27655592	27667111	TSL-A	11519	0.396649
chr7	27779713	27869386	TAX1BP1	89673	0.355637
chr7	27870192	28220437	JAZF1	350245	0.414481
chr7	28157731	28157838	U6	107	0.373832
chr7	28220075	28280996	JAZF1-AS1	60921	0.410023
chr7	28475233	28865511	CREB5	390278	0.407994
chr7	28448994	28450372	BC087859	1378	0.621916
chr7	28992973	28998029	TRIL	5056	0.569225
chr7	28998746	28998776	DQ601810	30	0.433333
chr7	29019582	29052985	LOC100506497	33403	0.400413
chr7	29035246	29186153	CPVL	150907	0.410213
chr7	29234120	29553944	CHN2	319824	0.423023
chr7	29553839	29603273	BC038570	49434	0.391937
chr7	29603426	29606911	PRR15	3485	0.565280
chr7	29685537	29725437	LOC646762	39900	0.401028
chr7	29688993	29689733	BC121815	740	0.620270
chr7	29720349	29720444	MIR550A3	95	0.505263
chr7	29724769	29727859	DPY19L2P3	3090	0.414887
chr7	29757621	29782019	DPY19L2P3	24398	0.348102
chr7	29846169	29956682	WIPF3	110513	0.425570
chr7	29959718	30029905	SCRN1	70187	0.439070
chr7	30050198	30066417	FKBP14	16219	0.388125
chr7	30067976	30124278	PLEKHA8	56302	0.392348
chr7	30174551	30202381	C7orf41	27830	0.466439
chr7	30323922	30407308	ZNRF2	83386	0.367472
chr7	30329409	30329506	MIR550B1	97	0.505155
chr7	30329409	30329506	MIR550A1	97	0.505155
chr7	30409665	30412410	DKFZP586I1420	2745	0.386885
chr7	30464142	30518393	NOD1	54251	0.467678
chr7	30496336	30518393	NOD1	22057	0.455411
chr7	30536236	30544457	GGCT	8221	0.405425
chr7	30587972	30617395	LOC401320	29423	0.429528
chr7	30606019	30634419	LOC401320	28400	0.397887
chr7	30634180	30673648	GARS	39468	0.387554
chr7	30691558	30739719	CRHR2	48161	0.532298
chr7	30811032	30932002	FAM188B	120970	0.482244
chr7	30791750	30797218	INMT	5468	0.505304
chr7	31003635	31019146	GHRHR	15511	0.529495
chr7	31009147	31019146	GHRHR	9999	0.529153
chr7	31092075	31151093	ADCYAP1R1	59018	0.518859
chr7	31377074	31380538	NEUROD6	3464	0.362875
chr7	31553684	31693303	CCDC129	139619	0.380364
chr7	31726630	31748069	PPP1R17	21439	0.407388
chr7	31792631	32338383	PDE1C	545752	0.397287
chr7	31823140	31826510	BC043188	3370	0.377745
chr7	31826530	31828099	BC043188	1569	0.344168
chr7	32496509	32498106	LOC100130673	1597	0.467126
chr7	32524944	32530023	LSM5	5079	0.389644
chr7	32535175	32623779	AVL9	88604	0.403018
chr7	32620552	32758780	DPY19L1P1	138228	0.390109
chr7	32767561	32769595	ZNRF2P1	2034	0.610128
chr7	32772592	32772689	MIR550B2	97	0.536082
chr7	32772592	32772689	MIR550A2	97	0.536082
chr7	32797897	32802536	LOC401321	4639	0.435223
chr7	32865913	32878356	DPY19L1P2	12443	0.416379
chr7	32907777	32931468	KBTBD2	23691	0.401967
chr7	32956426	32982782	RP9P	26356	0.438117
chr7	32997004	33046543	FKBP9	49539	0.452653
chr7	33041561	33041666	U6	105	0.371429
chr7	33053724	33102409	NT5C3A	48685	0.379830
chr7	33075807	33076426	AX721280	619	0.365105
chr7	33102954	33102981	DQ584906	27	0.481481
chr7	33134409	33149002	RP9	14593	0.426917
chr7	33169151	33645680	BBS9	476529	0.373614
chr7	33923727	33925377	AK025321	1650	0.455152
chr7	33944522	34195484	BMPER	250962	0.405679
chr7	34337107	34337210	U6	103	0.330097
chr7	34386123	34797884	NPSR1-AS1	411761	0.385945
chr7	34697896	34917944	NPSR1	220048	0.396677
chr7	34968492	35077653	DPY19L1	109161	0.374401
chr7	35082722	35084164	BC084560	1442	0.488211
chr7	35120898	35225774	DPY19L2P1	104876	0.361208
chr7	35242041	35293711	TBX20	51670	0.368976
chr7	35353465	35416086	LOC401324	62621	0.421073
chr7	35672269	35734772	HERPUD2	62503	0.381454
chr7	35734847	35738524	DQ594967	3677	0.477019
chr7	35840595	35946715	SEPT7	106120	0.361119
chr7	35987319	35987345	DQ595191	26	0.423077
chr7	36134922	36140262	BC043264	5340	0.420599
chr7	36192835	36341152	EEPD1	148317	0.454459
chr7	36363758	36429734	KIAA0895	65976	0.395523
chr7	36429431	36493400	ANLN	63969	0.378668
chr7	36552548	36764154	AOAH	211606	0.415645
chr7	36637439	36639726	AOAH-IT1	2287	0.423262
chr7	36892510	37488555	ELMO1	596045	0.416662
chr7	36958961	36959037	MIR1200	76	0.486842
chr7	37538988	37539011	JB022662	23	0.391304
chr7	37723378	37875470	BC043356	152092	0.383886
chr7	37779995	37780913	GPR141	918	0.444444
chr7	37888198	37940002	NME8	51804	0.374739
chr7	37945534	37956525	SFRP4	10991	0.384860
chr7	37960162	37991542	EPDR1	31380	0.402709
chr7	38217807	38270272	STARD3NL	52465	0.384085
chr7	38299243	38313253	TARP	14010	0.365525
chr7	38339411	38339881	TCRGV	470	0.440426
chr7	38342348	38344378	AK096766	2030	0.397044
chr7	38369947	38370558	X06774	611	0.466448
chr7	38381177	38418238	LOC100506776	37061	0.418526
chr7	38388710	38389604	Y00482	894	0.498881
chr7	38397534	38398683	TRGV3	1149	0.488251
chr7	38402460	38403119	TCRGV	659	0.484067
chr7	38423296	38671167	AMPH	247871	0.391458
chr7	38724945	38726689	FAM183B	1744	0.521789
chr7	38763542	38948800	VPS41	185258	0.381409
chr7	39017608	39504390	POU6F2	486782	0.394086
chr7	39023849	39053161	AK023033	29312	0.388066
chr7	39444197	39445945	POU6F2-AS1	1748	0.372998
chr7	39606002	39612480	YAE1D1	6478	0.365545
chr7	39649085	39651687	LOC646999	2602	0.445042
chr7	39663151	39747723	RALA	84572	0.396621
chr7	39773166	39834222	LINC00265	61056	0.449161
chr7	39989958	40136733	CDK13	146775	0.387968
chr7	40172341	40174251	MPLKIP	1910	0.426702
chr7	40174574	40900366	C7orf10	725792	0.387108
chr7	41728600	41742706	INHBA	14106	0.440238
chr7	41733513	41818976	INHBA-AS1	85463	0.406410
chr7	42000547	42276618	GLI3	276071	0.416277
chr7	42948871	42952151	C7orf25	3280	0.504268
chr7	42956461	42971805	PSMA2	15344	0.383146
chr7	42971938	42977453	MRPL32	5515	0.398005
chr7	43152197	43602938	HECW1	450741	0.420727
chr7	43157494	43202786	AX748020	45292	0.400733
chr7	43190493	43190593	MIR3943	100	0.640000
chr7	43548326	43562141	LOC100506895	13815	0.421643
chr7	43622691	43666978	STK17A	44287	0.393840
chr7	43678845	43769140	COA1	90295	0.404751
chr7	43798271	43846941	BLVRA	48670	0.443168
chr7	43906156	43909145	MRPS24	2989	0.494480
chr7	43915500	43946231	URGCP	30731	0.458007
chr7	43966034	43995735	UBE2D4	29701	0.457931
chr7	44005862	44058748	POLR2J4	52886	0.528004
chr7	44040488	44049723	SPDYE1	9235	0.492258
chr7	44043644	44047465	AX747182	3821	0.528919
chr7	44054274	44054305	DQ575764	31	0.677419
chr7	44068485	44080222	RASA4CP	11737	0.567777
chr7	44078647	44081905	LINC00957	3258	0.610190
chr7	44084238	44101315	DBNL	17077	0.524390
chr7	44102325	44105186	PGAM2	2861	0.584761
chr7	44111846	44122129	POLM	10283	0.567247
chr7	44143959	44154164	AEBP1	10205	0.627046
chr7	44154278	44163169	POLD2	8891	0.544146
chr7	44178462	44180916	MYL7	2454	0.614099
chr7	44183869	44198887	GCK	15018	0.572247
chr7	44240577	44253893	YKT6	13316	0.481075
chr7	44256748	44365230	CAMK2B	108482	0.554295
chr7	44406738	44408891	AX746562	2153	0.498374
chr7	44421964	44530385	NUDCD3	108421	0.442073
chr7	44552134	44580914	NPC1L1	28780	0.514976
chr7	44605015	44614137	DDX56	9122	0.539027
chr7	44618761	44621827	TMED4	3066	0.511742
chr7	44622023	44623271	DQ574505	1248	0.509615
chr7	44646120	44748669	OGDH	102549	0.462423
chr7	44788529	44809479	ZMIZ2	20950	0.561480
chr7	44808453	44810735	BC008049	2282	0.518405
chr7	44836240	44842716	PPIA	6476	0.472051
chr7	44873212	44887725	H2AFV	14513	0.418521
chr7	44915891	44924960	PURB	9069	0.405778
chr7	45002259	45018704	MYO1G	16445	0.590757
chr7	45022626	45026236	SNHG15	3610	0.489197
chr7	45067232	45116069	CCM2	48837	0.468886
chr7	45120035	45128493	NACAD	8458	0.620951
chr7	45139698	45151346	TBRG4	11648	0.530735
chr7	45197366	45223850	RAMP3	26484	0.510686
chr7	45614124	45762714	ADCY1	148590	0.475503
chr7	45763385	45808617	SEPT7P2	45232	0.376238
chr7	45847141	45847172	DQ597235	31	0.483871
chr7	45847216	45847251	DQ584937	35	0.600000
chr7	45848328	45848418	DQ590432	90	0.577778
chr7	45848515	45848547	DQ574672	32	0.531250
chr7	45848866	45848906	DQ584939	40	0.600000
chr7	45848987	45849047	DQ599799	60	0.550000
chr7	45849142	45849190	DQ573852	48	0.541667
chr7	45850289	45850323	DQ583079	34	0.558824
chr7	45927958	45933267	IGFBP1	5309	0.488416
chr7	45951843	45960871	IGFBP3	9028	0.479730
chr7	46727476	46736720	AK125311	9244	0.366183
chr7	47314751	47621742	TNS3	306991	0.484356
chr7	47694841	47701246	C7orf65	6405	0.523810
chr7	47801073	47806370	LINC00525	5297	0.436851
chr7	47814249	47988071	PKD1L1	173822	0.442487
chr7	47834888	47859444	C7orf69	24556	0.461557
chr7	48002884	48019222	HUS1	16338	0.438915
chr7	48026745	48068716	SUN3	41971	0.389888
chr7	48075107	48100894	C7orf57	25787	0.429325
chr7	48128354	48148330	UPP1	19976	0.482028
chr7	48211056	48687091	ABCA13	476035	0.388371
chr7	48964156	48967049	CDC14C	2893	0.438299
chr7	49813256	49952138	VWC2	138882	0.402802
chr7	49977023	50132860	ZPBP	155837	0.352894
chr7	50135681	50198852	C7orf72	63171	0.374460
chr7	50344377	50472798	IKZF1	128421	0.296704
chr7	50511831	50518088	FIGNL1	6257	0.396196
chr7	50526133	50628768	DDC	102635	0.442373
chr7	50599456	50611161	LOC100129427	11705	0.487569
chr7	50657759	50800065	GRB10	142306	0.454387
chr7	51083908	51384515	COBL	300607	0.434411
chr7	51458325	51458373	DQ584971	48	0.541667
chr7	51458468	51458499	DQ593490	31	0.516129
chr7	51458609	51458649	DQ597892	40	0.600000
chr7	51458967	51458999	DQ574659	32	0.531250
chr7	51459096	51459139	DQ576962	43	0.581395
chr7	51460266	51460301	DQ600587	35	0.600000
chr7	51460345	51460376	DQ599872	31	0.483871
chr7	53103348	53104618	POM121L12	1270	0.638583
chr7	53723201	53879624	FLJ45974	156423	0.354321
chr7	54268916	54270114	HPVC1	1198	0.384808
chr7	54610018	54636948	VSTM2A	26930	0.403491
chr7	54637476	54641810	AB074160	4334	0.349562
chr7	54643745	54646487	BC036261	2742	0.374179
chr7	54819939	54826939	SEC61G	7000	0.377143
chr7	55086724	55275031	EGFR	188307	0.446016
chr7	55247442	55256642	EGFR-AS1	9200	0.503913
chr7	55277117	55279321	GU228584	2204	0.382486
chr7	55433140	55501435	LANCL2	68295	0.429138
chr7	55538305	55640200	VOPP1	101895	0.470681
chr7	55748766	55772260	FKBP9L	23494	0.460245
chr7	55753669	55753774	U6	105	0.361905
chr7	55813650	55813698	DQ584971	48	0.541667
chr7	55813793	55813823	DQ593490	30	0.500000
chr7	55813824	55813853	DQ575984	29	0.586207
chr7	55814293	55814325	DQ574659	32	0.531250
chr7	55814422	55814512	DQ584609	90	0.577778
chr7	55815671	55815702	DQ599872	31	0.483871
chr7	55840871	55841376	CO9	505	0.350495
chr7	55861236	55930482	SEPT14	69246	0.409468
chr7	55947025	55947046	DD413584	21	0.333333
chr7	55980327	56008433	ZNF713	28106	0.432043
chr7	56019610	56023033	MRPS17	3423	0.501023
chr7	56032269	56067875	GBAS	35606	0.443324
chr7	56078743	56119268	PSPH	40525	0.463418
chr7	56119377	56131682	CCT6A	12305	0.411946
chr7	56123057	56123195	SNORA22	138	0.405797
chr7	56128162	56128295	SNORA15	133	0.368421
chr7	56131916	56148365	SUMF2	16449	0.491762
chr7	56147975	56160689	PHKG1	12714	0.540035
chr7	56169265	56174187	CHCHD2	4922	0.449614
chr7	56182373	56184090	NUPR1L	1717	0.546302
chr7	56444124	56444172	DQ584971	48	0.541667
chr7	56444267	56444298	DQ593490	31	0.516129
chr7	56444767	56444799	DQ574659	32	0.531250
chr7	56444896	56444986	DQ584609	90	0.577778
chr7	56446066	56446101	DQ600587	35	0.600000
chr7	56446145	56446175	DQ599872	30	0.500000
chr7	56491396	56516068	LOC650226	24672	0.390848
chr7	56549797	56550988	BC036258	1191	0.463476
chr7	56563915	56564977	DKFZp434L192	1062	0.514124
chr7	56601922	56605823	BC035176	3901	0.414253
chr7	56877280	56880139	BC215	2859	0.660721
chr7	56897333	56897364	DQ593490	31	0.516129
chr7	56897474	56897514	DQ597892	40	0.600000
chr7	56897832	56897864	DQ574659	32	0.531250
chr7	56897961	56898004	DQ576962	43	0.581395
chr7	56900491	56900552	DQ600587	61	0.557377
chr7	56900599	56900631	DQ599872	32	0.468750
chr7	56943077	56949839	LOC100130849	6762	0.499113
chr7	57023491	57023571	MIR4283-1	80	0.600000
chr7	57076649	57076732	DL490813	83	0.602410
chr7	57187325	57207571	ZNF479	20246	0.394794
chr7	57233376	57247863	GUSBP10	14487	0.432733
chr7	57236363	57236431	TRNA	68	0.338235
chr7	57236782	57236849	TRNA	67	0.253731
chr7	57238482	57238551	TRNA	69	0.246377
chr7	57242152	57242220	TRNA	68	0.382353
chr7	57253979	57254051	TRNA	72	0.458333
chr7	57255156	57255224	TRNA	68	0.323529
chr7	57255233	57255302	TRNA	69	0.318841
chr7	57255303	57255376	TRNA	73	0.383562
chr7	57255474	57255539	TRNA	65	0.430769
chr7	57257216	57257284	TRNA	68	0.220588
chr7	57261909	57261980	TRNA	71	0.380282
chr7	57472730	57472796	MIR3147	66	0.666667
chr7	57476012	57476043	DQ578920	31	0.451613
chr7	57509882	57533265	ZNF716	23383	0.389471
chr7	57698645	57698804	L37717	159	0.534591
chr7	62751669	62764434	ZNF733P	12765	0.370231
chr7	62809447	62812152	LOC100287834	2705	0.510906
chr7	62856717	62859419	LOC100287834	2702	0.510363
chr7	63081467	63081547	MIR4283-1	80	0.600000
chr7	63204435	63204467	DQ597235	32	0.468750
chr7	63204514	63204575	DQ599768	61	0.557377
chr7	63207082	63207125	DQ590432	43	0.581395
chr7	63207222	63207254	DQ574660	32	0.531250
chr7	63207572	63207612	DQ584939	40	0.600000
chr7	63207693	63207753	DQ599799	60	0.550000
chr7	63361200	63378372	BC042811	17172	0.399255
chr7	63484795	63490480	LOC100506050	5685	0.466315
chr7	63505820	63538927	ZNF727	33107	0.367717
chr7	63570541	63570607	TRNA	66	0.393939
chr7	63570704	63570776	TRNA	72	0.375000
chr7	63570777	63570846	TRNA	69	0.304348
chr7	63570855	63570923	TRNA	68	0.294118
chr7	63667580	63680668	ZNF735	13088	0.369193
chr7	63688851	63727309	ZNF679	38458	0.419887
chr7	63773185	63810017	ZNF736	36832	0.370900
chr7	63813368	63817012	AK123141	3644	0.343853
chr7	63894070	63895895	LOC649395	1825	0.426849
chr7	63980254	64023505	ZNF680	43251	0.389910
chr7	64035072	64078967	LOC100128885	43895	0.442419
chr7	64042987	64044129	LOC641746	1142	0.433450
chr7	64126510	64171401	ZNF107	44891	0.400325
chr7	64141510	64147264	BC053669	5754	0.485401
chr7	64254765	64294059	ZNF138	39294	0.399857
chr7	64330549	64350233	AK097702	19684	0.548618
chr7	64363619	64391955	ZNF273	28336	0.388763
chr7	64434829	64451414	ZNF117	16585	0.343925
chr7	64450732	64467124	ERV3-1	16392	0.457296
chr7	64498731	64535091	CCT6P3	36360	0.406546
chr7	64538982	64541638	BC044608	2656	0.516566
chr7	64601602	64646832	INTS4	45230	0.401437
chr7	64646832	64693539	AK057766	46707	0.390520
chr7	64673115	64673146	DQ596928	31	0.548387
chr7	64838767	64865998	ZNF92	27231	0.391429
chr7	65111923	65235797	LOC441242	123874	0.425279
chr7	65112776	65183632	INTS4L2	70856	0.402902
chr7	65216091	65228662	CCT6P1	12571	0.408400
chr7	65220512	65220646	SNORA22	134	0.410448
chr7	65305191	65305610	DQ580039	419	0.587112
chr7	65338256	65419800	VKORC1L1	81544	0.411557
chr7	65425672	65447301	GUSB	21629	0.520366
chr7	65540775	65558329	ASL	17554	0.546143
chr7	65579804	65619553	CRCP	39749	0.449571
chr7	65670258	65825438	TPST1	155180	0.404260
chr7	65841030	65865395	LINC00174	24365	0.496901
chr7	65993454	66057371	LOC493754	63917	0.474553
chr7	66204982	66276448	RABGEF1	71466	0.428218
chr7	66093867	66108216	KCTD7	14349	0.478918
chr7	66274979	66309813	GTF2IRD1P1	34834	0.498909
chr7	66386202	66423538	TMEM248	37336	0.447879
chr7	66452689	66460588	SBDS	7899	0.428409
chr7	66461791	66704507	TYW1	242716	0.416042
chr7	66579308	66579384	MIR4650-2	76	0.460526
chr7	66657746	66767429	PMS2P4	109683	0.440798
chr7	66742731	66743114	BC006435	383	0.412533
chr7	66767624	66786513	STAG3L4	18889	0.447774
chr7	66800962	66805012	BC017910	4050	0.315309
chr7	68866187	68866289	U6	102	0.392157
chr7	69063904	70257885	AUTS2	1193981	0.410535
chr7	70597522	71178586	WBSCR17	581064	0.444801
chr7	70772657	70772756	MIR3914-1	99	0.363636
chr7	70772659	70772754	MIR3914-2	95	0.368421
chr7	71244475	71877360	CALN1	632885	0.431838
chr7	72039491	72298813	TYW1B	259322	0.416127
chr7	72162873	72162949	MIR4650-1	76	0.460526
chr7	72299951	72307978	SBDSP1	8027	0.429924
chr7	72333317	72339655	SPDYE7P	6338	0.518302
chr7	72334889	72334917	DQ601342	28	0.500000
chr7	72395659	72414061	POM121	18402	0.466688
chr7	72418831	72425302	NSUN5P2	6471	0.535311
chr7	72424049	72439870	NSUN5P2	15821	0.532773
chr7	72742299	72772641	FKBP6	30342	0.477226
chr7	72467988	72476448	STAG3L3	8460	0.473404
chr7	72476588	72519691	PMS2L2	43103	0.452381
chr7	72476588	72512018	PMS2L2	35430	0.452413
chr7	72490259	72500309	SPDYE8P	10050	0.484478
chr7	72491630	72491656	DQ596866	26	0.500000
chr7	72491730	72491760	DQ586658	30	0.433333
chr7	72518502	72524466	BC047594	5964	0.482394
chr7	72569011	72620603	LOC100093631	51592	0.468038
chr7	72634673	72644294	NCF1B	9621	0.530402
chr7	72639489	72639760	NCF1	271	0.450184
chr7	72656901	72685658	GTF2IRD2P1	28757	0.467504
chr7	72693842	72698885	BC018166	5043	0.528852
chr7	72712965	72716800	AK127026	3835	0.553585
chr7	72716513	72722864	NSUN5	6351	0.539600
chr7	72726534	72742085	TRIM50	15551	0.534371
chr7	72848108	72850450	FZD9	2342	0.684458
chr7	72854727	72936615	BAZ1B	81888	0.431931
chr7	72950682	72972065	BCL7B	21383	0.487771
chr7	72983276	72993013	TBL2	9737	0.526856
chr7	73007523	73038870	MLXIPL	31347	0.562510
chr7	73082173	73086440	VPS37D	4267	0.640262
chr7	73095247	73097781	DNAJC30	2534	0.542620
chr7	73097897	73112551	WBSCR22	14654	0.508598
chr7	73113534	73134017	STX1A	20483	0.588586
chr7	73125646	73125727	MIR4284	81	0.567901
chr7	73149398	73150330	LINC00035	932	0.621245
chr7	73150424	73153190	ABHD11	2766	0.600145
chr7	73183326	73184600	CLDN3	1274	0.691523
chr7	73245192	73247015	CLDN4	1823	0.606692
chr7	73248920	73256855	WBSCR27	7935	0.592943
chr7	73275488	73280223	WBSCR28	4735	0.535164
chr7	73442426	73484236	ELN	41810	0.548792
chr7	73498106	73536855	LIMK1	38749	0.542853
chr7	73588705	73611429	EIF4H	22724	0.452429
chr7	73605527	73605624	MIR590	97	0.350515
chr7	73624086	73644164	LAT2	20078	0.542086
chr7	73645831	73668738	RFC2	22907	0.489064
chr7	73703804	73820273	CLIP2	116469	0.520585
chr7	73868119	74016920	GTF2IRD1	148801	0.527241
chr7	74072029	74175022	GTF2I	102993	0.427748
chr7	74113791	74143187	BC070376	29396	0.387876
chr7	74188308	74203659	NCF1	15351	0.542180
chr7	74210483	74267841	GTF2IRD2	57358	0.466700
chr7	74233342	74233767	GTF2IRD2	425	0.437647
chr7	74298262	74306731	STAG3L2	8469	0.474318
chr7	74306893	74322330	PMS2P5	15437	0.436160
chr7	74323197	74323225	DQ601342	28	0.500000
chr7	74379082	74438803	GATSL1	59721	0.524020
chr7	74440308	74445630	AK095583	5322	0.552800
chr7	74441354	74445622	AL832384	4268	0.567479
chr7	74456282	74489699	WBSCR16	33417	0.498519
chr7	74508346	74565623	GTF2IRD2B	57277	0.466295
chr7	74572383	74587816	NCF1C	15433	0.541696
chr7	74601105	74867341	GTF2IP1	266236	0.401535
chr7	74698156	74704119	BC047594	5963	0.482643
chr7	74702862	74712617	PMS2L14	9755	0.429113
chr7	74765875	74789332	WBSCR16	23457	0.498018
chr7	74800776	74806099	AL831977	5323	0.552696
chr7	74800784	74805053	DQ571357	4269	0.567346
chr7	74807604	74867341	GATSL2	59737	0.524583
chr7	74912421	74918383	BC047594	5962	0.482724
chr7	74917063	74917093	DQ586658	30	0.433333
chr7	74917167	74917193	DQ596866	26	0.500000
chr7	74921335	74928921	PMS2P5	7586	0.419061
chr7	74940440	74946587	SPDYE8P	6147	0.479095
chr7	74945086	74945116	DQ586658	30	0.433333
chr7	74949357	74956946	PMS2P5	7589	0.419028
chr7	74968463	74974606	SPDYE8P	6143	0.479245
chr7	74973105	74973135	DQ586658	30	0.433333
chr7	74977378	74988306	PMS2L2	10928	0.430728
chr7	74991241	74996207	STAG3L1	4966	0.464760
chr7	75022300	75024682	FKBP6	2382	0.512175
chr7	75024902	75034888	TRIM73	9986	0.535650
chr7	75044869	75046065	NSUN5P1	1196	0.595318
chr7	75046064	75115568	POM121C	69504	0.457484
chr7	75124298	75133628	SPDYE5	9330	0.492176
chr7	75130660	75130688	DQ601342	28	0.500000
chr7	75137068	75157453	PMS2P3	20385	0.426098
chr7	75162618	75368283	HIP1	205665	0.483412
chr7	75398841	75419064	CCL26	20223	0.480591
chr7	75441113	75443092	CCL24	1979	0.524507
chr7	75508316	75518244	RHBDD2	9928	0.511281
chr7	75544419	75616173	POR	71754	0.511679
chr7	75544514	75544587	MIR4651	73	0.767123
chr7	75573100	75573234	SNORA14A	134	0.455224
chr7	75616154	75623992	TMEM120A	7838	0.616229
chr7	75625654	75677321	STYXL1	51667	0.484216
chr7	75677392	75695930	MDH2	18538	0.510789
chr7	75831215	75916605	SRRM3	85390	0.529336
chr7	75894681	75899301	SRRM3	4620	0.490476
chr7	75914374	75916618	BC063788	2244	0.602496
chr7	75931874	75933614	HSPB1	1740	0.633333
chr7	75935608	75937653	AX747594	2045	0.567237
chr7	75956107	75988342	YWHAG	32235	0.445479
chr7	76018645	76022807	SRCRB4D	4162	0.561028
chr7	76018645	76039012	SRCRB4D	20367	0.527520
chr7	76054271	76071388	ZP3	17117	0.521820
chr7	76090971	76135312	DTX2	44341	0.542974
chr7	76099336	76104317	FDPSP2	4981	0.482232
chr7	76139744	76157199	UPK3B	17455	0.530335
chr7	76163433	76163461	DQ601342	28	0.500000
chr7	76178657	76257299	LOC100133091	78642	0.418313
chr7	76178657	76182447	BC090058	3790	0.491821
chr7	76239302	76256620	POMZP3	17318	0.492840
chr7	76610138	76653076	DTX2P1-UPK3BP1-PMS2P11	42938	0.527295
chr7	76751933	76924521	CCDC146	172588	0.389564
chr7	76822687	76829150	FGL2	6463	0.357110
chr7	76940067	77045717	GSAP	105650	0.401836
chr7	77166772	77269388	PTPN12	102616	0.380915
chr7	77286976	77287972	BC037783	996	0.325301
chr7	77287972	77326662	RSBN1L-AS1	38690	0.442104
chr7	77325742	77409120	RSBN1L	83378	0.393893
chr7	77423044	77427747	TMEM60	4703	0.420795
chr7	77428108	77586821	PHTF2	158713	0.376503
chr7	77619733	77621940	AK124308	2207	0.491618
chr7	77646373	79082890	MAGI2	1436517	0.368297
chr7	77976558	77988770	RPL13AP17	12212	0.389453
chr7	77994023	77994043	MIR548AU	20	0.350000
chr7	78638303	78641593	MAGI2-AS2	3290	0.347416
chr7	79082272	79100524	MAGI2-AS3	18252	0.383848
chr7	79083275	79096783	MAGI2-AS3	13508	0.378887
chr7	79400571	79400606	MIR548M	35	0.371429
chr7	79764139	79848725	GNAI1	84586	0.365297
chr7	80275644	80303734	CD36	28090	0.340299
chr7	80087986	80141242	GNAT3	53256	0.342985
chr7	80371853	80548667	SEMA3C	176814	0.357579
chr7	81205702	81320722	AY927633	115020	0.345218
chr7	81331443	81399452	HGF	68009	0.345322
chr7	81575759	81578977	AK092048	3218	0.301119
chr7	81579417	82073031	CACNA2D1	493614	0.350162
chr7	81638492	81659271	AK055932	20779	0.330285
chr7	82383320	82792197	PCLO	408877	0.338031
chr7	82993221	83278479	SEMA3E	285258	0.347082
chr7	83587658	83824217	SEMA3A	236559	0.344865
chr7	84161791	84204159	BX647900	42368	0.338062
chr7	84624871	84751247	SEMA3D	126376	0.338719
chr7	86273229	86494192	GRM3	220963	0.369650
chr7	86506222	86689014	KIAA1324L	182792	0.373014
chr7	86780738	86781595	BC035377	857	0.442240
chr7	86781676	86825648	DMTF1	43972	0.358387
chr7	86825477	86849031	TMEM243	23554	0.430245
chr7	86954663	86974831	TP53TG1	20168	0.390123
chr7	86974950	87029112	CROT	54162	0.374525
chr7	87031360	87105019	ABCB4	73659	0.383755
chr7	87133178	87342639	ABCB1	209461	0.370446
chr7	87257728	87461613	RUNDC3B	203885	0.355470
chr7	87463813	87505692	SLC25A40	41879	0.356264
chr7	87505543	87538856	DBF4	33313	0.367064
chr7	87563565	87832204	ADAM22	268639	0.372798
chr7	87834431	87849399	SRI	14968	0.394441
chr7	87905743	87936228	STEAP4	30485	0.376644
chr7	88078184	88078205	DD413682	21	0.428571
chr7	88078406	88078546	SNORA67	140	0.500000
chr7	88388752	88966346	ZNF804B	577594	0.348833
chr7	88423419	88425031	C7orf62	1612	0.356079
chr7	89748713	89754914	DPY19L2P4	6201	0.377358
chr7	89783688	89794141	STEAP1	10453	0.381709
chr7	89840999	89866992	STEAP2	25993	0.366983
chr7	89874487	89940377	C7orf63	65890	0.361041
chr7	89975978	90020769	GTPBP10	44791	0.375522
chr7	90032647	90045268	CLDN12	12621	0.398701
chr7	90025605	90027550	LOC101409256	1945	0.387661
chr7	90338711	90839904	CDK14	501193	0.376685
chr7	90893782	90898132	FZD1	4350	0.564138
chr7	91502020	91510016	MTERF	7996	0.374562
chr7	91570188	91739987	AKAP9	169799	0.367234
chr7	91741462	91763840	CYP51A1	22378	0.379346
chr7	91763905	91809228	AL133568	45323	0.403327
chr7	91774197	91794590	LRRD1	20393	0.382239
chr7	91828282	91875414	KRIT1	47132	0.364211
chr7	91875547	92030698	ANKIB1	155151	0.367661
chr7	92076761	92089381	GATAD1	12620	0.418542
chr7	92098078	92099695	ERVW-1	1617	0.462585
chr7	92116336	92157845	PEX1	41509	0.371148
chr7	92158086	92166823	RBM48	8737	0.396933
chr7	92167788	92169079	MGC16142	1291	0.440744
chr7	92190071	92219706	FAM133B	29635	0.374355
chr7	92234234	92465941	CDK6	231707	0.382013
chr7	92728825	92747336	SAMD9	18511	0.377451
chr7	92759367	92777680	SAMD9L	18313	0.395784
chr7	92817898	92855782	HEPACAM2	37884	0.358383
chr7	92861652	92990435	CCDC132	128783	0.348245
chr7	93053798	93204042	CALCR	150244	0.352001
chr7	93112071	93112167	MIR653	96	0.364583
chr7	93113247	93113331	MIR489	84	0.476190
chr7	93346239	93346317	MIR4652	78	0.384615
chr7	93514708	93520303	TFPI2	5595	0.393387
chr7	93535819	93540485	GNGT1	4666	0.343335
chr7	93551015	93555826	GNG11	4811	0.382041
chr7	93620999	93633690	BET1	12691	0.365850
chr7	94023872	94060544	COL1A2	36672	0.375736
chr7	94139169	94186328	CASD1	47159	0.343116
chr7	94214535	94285521	SGCE	70986	0.352492
chr7	94285681	94299006	PEG10	13325	0.431820
chr7	94536948	94925727	PPP1R9A	388779	0.364209
chr7	94927668	94953884	PON1	26216	0.404333
chr7	95034173	95064384	PON2	30211	0.381616
chr7	95115212	95169543	ASB4	54331	0.383133
chr7	95212808	95225925	PDK4	13117	0.362812
chr7	95401817	95727736	DYNC1I1	325919	0.386170
chr7	95749531	95951459	SLC25A13	201928	0.397597
chr7	95848973	95849068	MIR591	95	0.410526
chr7	95936144	95936164	JB074828	20	0.400000
chr7	95970451	95970558	U6	107	0.411215
chr7	96110937	96132835	C7orf76	21898	0.385560
chr7	96250968	96293650	LOC100506136	42682	0.376013
chr7	96318078	96339203	SHFM1	21125	0.358911
chr7	96597826	96643377	DLX6-AS1	45551	0.438893
chr7	96635289	96640352	DLX6	5063	0.494371
chr7	96649701	96654143	DLX5	4442	0.556506
chr7	96745904	96811075	ACN9	65171	0.386844
chr7	97228244	97228572	7SK	328	0.454268
chr7	97361270	97369784	TAC1	8514	0.397346
chr7	97481428	97501854	ASNS	20426	0.384216
chr7	97503666	97601638	MGC72080	97972	0.453977
chr7	97595943	97596475	BC122864	532	0.501880
chr7	97614012	97619416	OCM2	5404	0.462435
chr7	97736196	97838944	LMTK2	102748	0.437264
chr7	97841567	97842271	BHLHA15	704	0.705966
chr7	97844754	97881563	TECPR1	36809	0.561357
chr7	97910978	97920839	BRI3	9861	0.594159
chr7	97920961	98030427	BAIAP2L1	109466	0.467880
chr7	98246596	98259181	NPTX2	12585	0.546365
chr7	98444110	98467673	TMEM130	23563	0.518695
chr7	98476112	98610866	TRRAP	134754	0.461255
chr7	98479272	98479352	MIR3609	80	0.387500
chr7	98625057	98741743	SMURF1	116686	0.427258
chr7	98771196	98805089	KPNA7	33893	0.460213
chr7	98870923	98895594	MYH16	24671	0.507843
chr7	98923495	98963885	ARPC1A	40390	0.452364
chr7	98972297	98992404	ARPC1B	20107	0.556920
chr7	98992297	99006305	PDAP1	14008	0.524200
chr7	99006600	99017239	BUD31	10639	0.479368
chr7	99014361	99063824	ATP5J2-PTCD1	49463	0.534177
chr7	99036562	99054996	CPSF4	18434	0.532006
chr7	99070514	99085217	ZNF789	14703	0.472285
chr7	99090853	99097877	ZNF394	7024	0.483770
chr7	99102272	99131445	ZKSCAN5	29173	0.460974
chr7	99143922	99149757	FAM200A	5835	0.430848
chr7	99156447	99174076	ZNF655	17629	0.421351
chr7	99195901	99208456	LOC100289187	12555	0.501951
chr7	99214570	99230030	ZSCAN25	15460	0.484411
chr7	99282301	99332819	CYP3A7-CYP3AP1	50518	0.417297
chr7	99354582	99381811	CYP3A4	27229	0.395718
chr7	99425635	99464173	CYP3A43	38538	0.405885
chr7	99473684	99474656	OR2AE1	972	0.486626
chr7	99488029	99517223	TRIM4	29194	0.423717
chr7	99520891	99527243	GJC3	6352	0.425693
chr7	99564349	99573735	AZGP1	9386	0.484338
chr7	99578384	99591588	AZGP1P1	13204	0.498940
chr7	99613218	99635403	ZKSCAN1	22185	0.452333
chr7	99647416	99662663	ZSCAN21	15247	0.478258
chr7	99667593	99679387	ZNF3	11794	0.488723
chr7	99686582	99689822	COPS6	3240	0.527469
chr7	99690403	99699427	MCM7	9024	0.540226
chr7	99691182	99691266	MIR25	84	0.630952
chr7	99691390	99691470	MIR93	80	0.600000
chr7	99691437	99691459	DD413568	22	0.500000
chr7	99691615	99691697	MIR106B	82	0.609756
chr7	99699129	99704803	AP4M1	5674	0.558513
chr7	99704692	99717481	TAF6	12789	0.539604
chr7	99717264	99723128	CNPY4	5864	0.505798
chr7	99724319	99726121	MBLAC1	1802	0.654828
chr7	99746529	99751833	LAMTOR4	5304	0.513198
chr7	99752042	99756302	C7orf43	4260	0.605164
chr7	99756864	99766373	GAL3ST4	9509	0.529078
chr7	99767228	99774990	GPC2	7762	0.554496
chr7	99775537	99812010	STAG3	36473	0.459299
chr7	99798277	99869855	GATS	71578	0.515298
chr7	99816871	99819111	PVRIG	2240	0.635714
chr7	99905324	99919819	SPDYE3	14495	0.508106
chr7	99917162	99917190	DQ601342	28	0.500000
chr7	99918262	99933930	PMS2P1	15668	0.439941
chr7	99927418	99930239	PMS2P1	2821	0.384615
chr7	99933766	99949523	PILRB	15757	0.472235
chr7	99955625	99965454	PILRB	9829	0.499033
chr7	99971067	99997722	PILRA	26655	0.474508
chr7	99998494	100026431	ZCWPW1	27937	0.446719
chr7	100027253	100031749	MEPCE	4496	0.584742
chr7	100032911	100034094	PPP1R35	1183	0.677937
chr7	100054237	100061894	C7orf61	7657	0.499282
chr7	100064141	100076902	TSC22D4	12761	0.588825
chr7	100081549	100092424	NYAP1	10875	0.592184
chr7	100136833	100165843	AGFG2	29010	0.498242
chr7	100169852	100171270	SAP25	1418	0.662906
chr7	100171633	100183776	LRCH4	12143	0.603640
chr7	100187195	100198740	FBXO24	11545	0.526029
chr7	100187023	100201661	PCOLCE-AS1	14638	0.539281
chr7	100199881	100205798	PCOLCE	5917	0.609768
chr7	100210113	100213000	MOSPD3	2887	0.565985
chr7	100218038	100239201	TFR2	21163	0.534801
chr7	100240725	100254084	ACTL6B	13359	0.531028
chr7	100254183	100264332	AK055267	10149	0.488127
chr7	100271362	100276792	GNB2	5430	0.659853
chr7	100277129	100286870	GIGYF1	9741	0.620573
chr7	100303675	100305123	POP7	1448	0.598066
chr7	100318422	100321323	EPO	2901	0.580145
chr7	100331248	100395419	ZAN	64171	0.526905
chr7	100400186	100425143	EPHB4	24957	0.547742
chr7	100450340	100464634	SLC12A9	14294	0.557367
chr7	100464949	100471076	TRIP6	6127	0.560307
chr7	100472700	100486285	SRRT	13585	0.531837
chr7	100486343	100487339	UFSP1	996	0.667671
chr7	100487614	100493541	ACHE	5927	0.639278
chr7	100488709	100488760	DJ051769	51	0.666667
chr7	100550749	100611111	MUC3A	60362	0.094182
chr7	100606877	100611410	AK096803	4533	0.601147
chr7	100612903	100662230	MUC12	49327	0.519350
chr7	100663363	100702140	MUC17	38777	0.481265
chr7	100728785	100733889	TRIM56	5104	0.606779
chr7	100770369	100782547	SERPINE1	12178	0.504270
chr7	100797685	100804557	AP1S1	6872	0.551222
chr7	100802753	100802836	MIR4653	83	0.445783
chr7	100805789	100808852	VGF	3063	0.681685
chr7	100813773	100823557	NAT16	9784	0.570625
chr7	100839012	100844302	MOGAT3	5290	0.555577
chr7	100849257	100861011	PLOD3	11754	0.587800
chr7	100860984	100867471	ZNHIT1	6487	0.540466
chr7	100875372	100881227	CLDN15	5855	0.601025
chr7	100882892	100888371	FIS1	5479	0.538602
chr7	100893615	100895601	AK091729	1986	0.500504
chr7	100951620	100954265	BC032716	2645	0.542533
chr7	100956647	100965093	RABL5	8446	0.495146
chr7	100958773	100965093	RABL5	6320	0.505222
chr7	101006121	101202304	COL26A1	196183	0.501216
chr7	101208596	101212286	BC027906	3690	0.426829
chr7	101256604	101272576	MYL10	15972	0.566679
chr7	101460881	101901513	CUX1	440632	0.480918
chr7	101928404	101962178	SH2B2	33774	0.572896
chr7	101936368	101936453	MIR4285	85	0.611765
chr7	101979403	101979439	DQ595418	36	0.555556
chr7	101986191	101996889	SPDYE6	10698	0.495420
chr7	101989114	101989142	DQ601342	28	0.500000
chr7	102036803	102067129	PRKRIP1	30326	0.477082
chr7	102063377	102067120	AK097289	3743	0.549025
chr7	102073976	102097268	ORAI2	23292	0.542890
chr7	102096666	102105321	ALKBH4	8655	0.544194
chr7	102105389	102113612	LRWD1	8223	0.610604
chr7	102106188	102106273	MIR5090	85	0.635294
chr7	102111915	102111978	MIR4467	63	0.666667
chr7	102113547	102119381	POLR2J	5834	0.550737
chr7	102123585	102158224	RASA4B	34639	0.567482
chr7	102133833	102135811	AK311374	1978	0.658241
chr7	102178365	102184517	POLR2J3	6152	0.572822
chr7	102178365	102213068	POLR2J3	34703	0.517736
chr7	102188513	102189359	BC041025	846	0.587470
chr7	102191678	102202757	SPDYE2B	11079	0.512862
chr7	102201021	102201049	DQ601342	28	0.500000
chr7	102220092	102257205	RASA4	37113	0.563334
chr7	102233002	102234980	AK311374	1978	0.658746
chr7	102277194	102283238	POLR2J2	6044	0.571310
chr7	102277194	102312176	POLR2J2	34982	0.518981
chr7	102287607	102288458	BC041025	851	0.588719
chr7	102290771	102301847	SPDYE2B	11076	0.512911
chr7	102300111	102300139	DQ601342	28	0.500000
chr7	102321131	102328837	AK301666	7706	0.566052
chr7	102389398	102449672	FAM185A	60274	0.377028
chr7	102453307	102715015	FBXL13	261708	0.398138
chr7	102553343	102585556	LRRC17	32213	0.391177
chr7	102715327	102740210	ARMC10	24883	0.400836
chr7	102740022	102789569	NAPEPLD	49547	0.400509
chr7	102781716	102782850	RPL19P12	1134	0.485009
chr7	102815461	102920759	DPY19L2P2	105298	0.363283
chr7	102913538	102920913	DPY19L2P2	7375	0.436610
chr7	102937872	102955133	PMPCB	17261	0.381728
chr7	102952920	102985320	DNAJC2	32400	0.405556
chr7	102987970	103009842	PSMC2	21872	0.384373
chr7	103014654	103086624	SLC26A5	71970	0.411185
chr7	103112230	103629963	RELN	517733	0.374819
chr7	103124654	103124986	7SK	332	0.469880
chr7	103766787	103848495	ORC5	81708	0.360295
chr7	103969103	104549003	LHFPL3	579900	0.400078
chr7	103969740	103969760	JB175200	20	0.800000
chr7	104439446	104444539	LHFPL3-AS1	5093	0.444139
chr7	104535074	104567092	LHFPL3-AS2	32018	0.425979
chr7	104581652	104602781	BC061919	21129	0.452506
chr7	104622193	104631612	LOC100216546	9419	0.398981
chr7	104650988	104654588	LOC100216545	3600	0.500833
chr7	104654636	104754532	KMT2E	99896	0.374469
chr7	104748533	104749020	AF520793	487	0.310062
chr7	104754024	104754437	AF520792	413	0.295400
chr7	104754466	104755465	AF520792	999	0.338338
chr7	104756820	105029377	SRPK2	272557	0.410112
chr7	105096959	105162685	PUS7	65726	0.430454
chr7	105172531	105208124	RINT1	35593	0.415475
chr7	105206771	105221976	EFCAB10	15205	0.406314
chr7	105208141	105208836	BC007100	695	0.408633
chr7	105245220	105517031	ATXN7L1	271811	0.455533
chr7	105603656	105676877	CDHR3	73221	0.449816
chr7	105730813	105753093	SYPL1	22280	0.382720
chr7	105848612	105848713	U6	101	0.386139
chr7	105888731	105925638	NAMPT	36907	0.366191
chr7	106130171	106410653	AF086203	280482	0.398742
chr7	106297210	106301634	CCDC71L	4424	0.446655
chr7	106505923	106547592	PIK3CG	41669	0.393746
chr7	106685177	106802256	PRKAR2B	117079	0.386047
chr7	106809405	106842974	HBP1	33569	0.379547
chr7	106842188	107204959	COG5	362771	0.371011
chr7	107110501	107116125	GPR22	5624	0.305832
chr7	107204401	107218968	DUS4L	14567	0.370632
chr7	107221203	107263762	BCAP29	42559	0.363096
chr7	107243807	107243952	SnoU109	145	0.324138
chr7	107296960	107302243	SLC26A4-AS1	5283	0.423055
chr7	107301079	107358252	SLC26A4	57173	0.399052
chr7	107384278	107402083	CBLL1	17805	0.362988
chr7	107405911	107443678	SLC26A3	37767	0.392724
chr7	107531585	107561643	DLD	30058	0.363331
chr7	107564245	107643804	LAMB1	79559	0.424603
chr7	107640235	107640427	U3	192	0.427083
chr7	107663995	107770801	LAMB4	106806	0.407103
chr7	107788070	107880614	NRCAM	92544	0.384822
chr7	108110865	108166762	PNPLA8	55897	0.368213
chr7	108202670	108210167	THAP5	7497	0.363079
chr7	108210188	108215294	DNAJB9	5106	0.377399
chr7	108524037	108524637	C7orf66	600	0.398333
chr7	109599283	109600270	EIF3IP1	987	0.485309
chr7	110303105	111202573	IMMP2L	899468	0.361070
chr7	110731061	110765509	LRRN3	34448	0.349367
chr7	111366163	111846462	DOCK4	480299	0.391760
chr7	111448593	111461829	BC043243	13236	0.384331
chr7	111846642	111983989	ZNF277	137347	0.373703
chr7	112063198	112117258	IFRD1	54060	0.393137
chr7	112120907	112130943	LSMEM1	10036	0.404843
chr7	112405786	112430478	TMEM168	24692	0.355621
chr7	112459201	112579932	C7orf60	120731	0.369690
chr7	112720467	112726542	GPR85	6075	0.379259
chr7	112756772	112758637	LOC401397	1865	0.369437
chr7	113516881	113559082	PPP1R3A	42201	0.342670
chr7	114055051	114333827	FOXP2	278776	0.339825
chr7	114293399	114293510	MIR3666	111	0.486486
chr7	114562208	114659970	MDFIC	97762	0.367515
chr7	114719011	114766368	BC022431	47357	0.360665
chr7	115221368	115221496	SNORA25	128	0.429688
chr7	115319400	115322672	BC039665	3272	0.386614
chr7	115575201	115670867	TFEC	95666	0.348055
chr7	115849285	115851565	BC040208	2280	0.531579
chr7	115850546	115898837	TES	48291	0.377255
chr7	115893169	115895118	BD495725	1949	0.385326
chr7	115915659	115926718	AK097428	11059	0.374537
chr7	116139654	116148595	CAV2	8941	0.397607
chr7	116164838	116201239	CAV1	36401	0.418230
chr7	115929931	115930105	DQ656011	174	0.339080
chr7	116312458	116438440	MET	125982	0.390254
chr7	116370967	116371019	U7	52	0.365385
chr7	116502562	116559313	CAPZA2	56751	0.373262
chr7	116592500	116594388	ST7-AS1	1888	0.585805
chr7	116593380	116863961	ST7	270581	0.390401
chr7	116593952	116599867	ST7-OT4	5915	0.415385
chr7	116712125	116730835	ST7OT2	18710	0.376323
chr7	116752345	116785614	ST7-AS2	33269	0.374463
chr7	116916685	116963343	WNT2	46658	0.422671
chr7	117003275	117067577	ASZ1	64302	0.351078
chr7	117120016	117308718	CFTR	188702	0.358777
chr7	117350705	117513561	CTTNBP2	162856	0.386943
chr7	117824085	117844093	NAA38	20008	0.354208
chr7	117864711	117882784	ANKRD7	18073	0.357218
chr7	119913721	120390387	KCND2	476666	0.351540
chr7	120427373	120498177	TSPAN12	70804	0.371180
chr7	120590816	120615711	ING3	24895	0.357100
chr7	120628750	120937498	CPED1	308748	0.365965
chr7	120969089	120981158	WNT16	12069	0.367968
chr7	120988904	121036422	FAM3C	47518	0.359169
chr7	121376496	121376779	7SK	283	0.438163
chr7	121513158	121702090	PTPRZ1	188932	0.356001
chr7	121713597	121784344	AASS	70747	0.364044
chr7	121721773	121721835	U7	62	0.435484
chr7	121941447	121944565	FEZF1	3118	0.498396
chr7	121943711	121950131	FEZF1-AS1	6420	0.494704
chr7	121958477	122526813	CADPS2	568336	0.365546
chr7	122337765	122339208	RNF133	1443	0.401247
chr7	122341719	122343021	RNF148	1302	0.410138
chr7	122634758	122635754	TAS2R16	996	0.422691
chr7	122753587	122840025	SLC13A1	86438	0.357285
chr7	123092235	123174718	IQUB	82483	0.364766
chr7	123181082	123197958	NDUFA5	16876	0.356127
chr7	123249111	123277932	ASB15	28821	0.378301
chr7	123295860	123304147	LMOD2	8287	0.428744
chr7	123321996	123389116	WASL	67120	0.354395
chr7	123389268	123391034	AL110181	1766	0.389581
chr7	123454192	123459484	HYALP1	5292	0.362812
chr7	123485222	123517531	HYAL4	32309	0.396391
chr7	123565285	123611461	SPAM1	46176	0.364302
chr7	123634678	123667700	BC041947	33022	0.397281
chr7	123670969	123673523	TMEM229A	2554	0.567737
chr7	123672258	124035172	EU233817	362914	0.362838
chr7	123977433	123992154	BC031318	14721	0.368385
chr7	124385654	124406079	GPR37	20425	0.388494
chr7	124417345	124430864	LOC154872	13519	0.382055
chr7	124462439	124570037	POT1	107598	0.343687
chr7	124569951	124785287	BC142949	215336	0.365178
chr7	124869632	124904345	EF565094	34713	0.377553
chr7	126078651	126883569	GRM8	804918	0.374049
chr7	126698141	126698238	MIR592	97	0.453608
chr7	126855180	126869975	BC040328	14795	0.415073
chr7	127010353	127032767	ZNF800	22414	0.353440
chr7	127220681	127225654	GCC1	4973	0.514780
chr7	127228405	127231759	ARF5	3354	0.564401
chr7	127233688	127241851	FSCN3	8163	0.480583
chr7	127250345	127255780	PAX4	5435	0.519411
chr7	127292201	127732659	SND1	440458	0.424420
chr7	127637561	127640130	SND1-IT1	2569	0.432853
chr7	127667123	127671002	LRRC4	3879	0.508121
chr7	127700597	127701075	BC150500	478	0.497908
chr7	127721912	127722012	MIR593	100	0.610000
chr7	127847924	127847996	MIR129-1	72	0.486111
chr7	127881330	127897682	LEP	16352	0.490399
chr7	127937737	127947816	MGC27345	10079	0.468697
chr7	127950435	127983962	RBM28	33527	0.420318
chr7	127990378	128001739	PRRT4	11361	0.573717
chr7	128032330	128050036	IMPDH1	17706	0.568508
chr7	128032600	128032635	DQ596633	35	0.600000
chr7	128034565	128034595	DQ596753	30	0.466667
chr7	128034942	128034970	DQ595173	28	0.535714
chr7	128043763	128043804	DQ579129	41	0.414634
chr7	128095883	128098472	HILPDA	2589	0.516802
chr7	128116782	128142978	METTL2B	26196	0.453199
chr7	128281294	128301052	FLJ45340	19758	0.505567
chr7	128312345	128323379	FAM71F2	11034	0.466558
chr7	128355442	128371797	FAM71F1	16355	0.446041
chr7	128379345	128413477	CALU	34132	0.399303
chr7	128412542	128415844	OPN1SW	3302	0.485766
chr7	128423503	128423575	TRNA	72	0.611111
chr7	128432049	128462187	CCDC136	30138	0.479362
chr7	128470482	128499328	FLNC	28846	0.608369
chr7	128502856	128505903	ATP6V1F	3047	0.526419
chr7	128506463	128512101	LOC100130705	5638	0.569883
chr7	128516918	128550773	KCP	33855	0.545621
chr7	128577993	128590088	IRF5	12095	0.560314
chr7	128594233	128695227	TNPO3	100994	0.398043
chr7	128695276	128697293	TPI1P2	2017	0.500248
chr7	128766324	128768050	LOC407835	1726	0.645423
chr7	128784711	128809534	TSPAN33	24823	0.481811
chr7	128828712	128853385	SMO	24673	0.491752
chr7	128864854	129070052	AHCYL2	205198	0.399755
chr7	129074273	129128239	STRIP2	53966	0.438146
chr7	129142319	129152773	SMKR1	10454	0.460398
chr7	129251554	129396922	NRF1	145368	0.411466
chr7	129410222	129410332	MIR182	110	0.572727
chr7	129414532	129414609	MIR96	77	0.480519
chr7	129414744	129414854	MIR183	110	0.490909
chr7	129470572	129592800	UBE2H	122228	0.418488
chr7	129594599	129594679	JA611275	80	0.462500
chr7	129658125	129691233	ZC3HC1	33108	0.444394
chr7	129710348	129775560	KLHDC10	65212	0.401368
chr7	129804554	129845338	TMEM209	40784	0.371788
chr7	129847703	129856684	SSMEM1	8981	0.395056
chr7	129906702	129929637	CPA2	22935	0.446436
chr7	129932973	129964020	CPA4	31047	0.467292
chr7	129984629	130008571	CPA5	23942	0.505847
chr7	130007189	130009387	AK097910	2198	0.551865
chr7	130020289	130027949	CPA1	7660	0.560574
chr7	130033611	130081051	CEP41	47440	0.398482
chr7	130131898	130146138	MEST	14240	0.421980
chr7	130126897	130131013	MESTIT1	4116	0.460155
chr7	130135951	130136045	MIR335	94	0.382979
chr7	130146079	130353598	COPG2	207519	0.206911
chr7	130353485	130371406	TSGA13	17921	0.427878
chr7	130417395	130418888	KLF14	1493	0.661085
chr7	130565750	130598069	LOC646329	32319	0.454779
chr7	130561505	130561569	MIR29A	64	0.328125
chr7	130562217	130562298	MIR29B1	81	0.395062
chr7	130628918	130794653	FLJ43663	165735	0.416587
chr7	131012594	131181398	MKLN1	168804	0.356182
chr7	130994502	131012535	AK054623	18033	0.410082
chr7	131185020	131241376	PODXL	56356	0.502466
chr7	131808090	132261323	PLXNA4	453233	0.473176
chr7	132333552	132413528	FLJ40288	79976	0.449297
chr7	132437782	132437886	SNORD46	104	0.480769
chr7	132469622	132766828	CHCHD3	297206	0.390201
chr7	132937822	133750513	EXOC4	812691	0.382893
chr7	133812104	133948933	LRGUK	136829	0.395961
chr7	133974089	134001827	SLC35B4	27738	0.405184
chr7	134127106	134143888	AKR1B1	16782	0.498749
chr7	134212343	134226166	AKR1B10	13823	0.453737
chr7	134233848	134264592	AKR1B15	30744	0.455699
chr7	134331530	134364567	BPGM	33037	0.396798
chr7	134464163	134655480	CALD1	191317	0.398219
chr7	134671258	134820530	AGBL3	149272	0.367684
chr7	134777116	134855578	C7orf49	78462	0.400410
chr7	134832765	134850967	TMEM140	18202	0.430008
chr7	134850531	134855578	C7orf49	5047	0.556965
chr7	134868589	134896316	WDR91	27727	0.474051
chr7	134916730	134943244	STRA8	26514	0.484763
chr7	135046546	135194875	CNOT4	148329	0.371903
chr7	135242661	135333499	NUP205	90838	0.389914
chr7	135347220	135361160	C7orf73	13940	0.410976
chr7	135365986	135412933	SLC13A4	46947	0.467804
chr7	135414345	135433594	FAM180A	19249	0.463453
chr7	135611502	135662204	LUZP6	50702	0.364562
chr7	136553831	136701771	CHRM2	147940	0.371732
chr7	136583519	136849088	LOC349160	265569	0.360648
chr7	136587913	136588041	MIR490	128	0.515625
chr7	136767728	136767748	JB175331	20	0.250000
chr7	136912091	137028546	PTN	116455	0.382440
chr7	136972433	136972509	SNORD81	76	0.355263
chr7	137003338	137011700	AK094915	8362	0.377302
chr7	137074384	137531609	DGKI	457225	0.391956
chr7	137559724	137686847	CREB3L2	127123	0.436648
chr7	137638093	137642712	LOC100130880	4619	0.422169
chr7	137761177	137803050	AKR1D1	41873	0.396031
chr7	137735907	137735928	JB074968	21	0.523810
chr7	137776062	137776213	7SK	151	0.490066
chr7	137808503	137808567	MIR4468	64	0.546875
chr7	138087838	138087864	JB175279	26	0.346154
chr7	138125546	138125585	DQ573766	39	0.410256
chr7	138127398	138127428	DQ587956	30	0.600000
chr7	138145078	138270332	TRIM24	125254	0.392131
chr7	138279029	138363790	SVOPL	84761	0.437182
chr7	138391038	138458782	ATP6V0A4	67744	0.461443
chr7	138482738	138490769	TMEM213	8031	0.478147
chr7	138516126	138666064	KIAA1549	149938	0.442523
chr7	138561104	138561211	U6	107	0.439252
chr7	138710451	138720775	ZC3HAV1L	10324	0.464839
chr7	138728265	138794465	ZC3HAV1	66200	0.434048
chr7	138818489	138874550	TTC26	56061	0.381531
chr7	138916230	138992982	UBN2	76752	0.387586
chr7	138940642	138944134	BC045656	3492	0.360538
chr7	139025877	139108203	C7orf55-LUC7L2	82326	0.402497
chr7	139025445	139025518	TRNA	73	0.589041
chr7	139102208	139112272	LOC100129148	10064	0.407790
chr7	139138087	139168457	KLRG2	30370	0.494238
chr7	139208673	139229731	CLEC2L	21058	0.500048
chr7	139246315	139477693	HIPK2	231378	0.406253
chr7	139528951	139720125	TBXAS1	191174	0.447812
chr7	139723548	139763521	PARP12	39973	0.458084
chr7	139784545	139876741	JHDM1D	92196	0.391427
chr7	139877060	139879440	LOC100134229	2380	0.495798
chr7	140033551	140098311	SLC37A3	64760	0.451776
chr7	140100135	140104233	AK131347	4098	0.458028
chr7	140103842	140126050	RAB19	22208	0.474919
chr7	140152839	140179369	MKRN1	26530	0.457821
chr7	140218219	140302342	DENND2A	84123	0.474115
chr7	140372952	140394908	ADCK2	21956	0.506194
chr7	140395135	140396877	NDUFB2-AS1	1742	0.557405
chr7	140396480	140406446	NDUFB2	9966	0.457255
chr7	140419137	140421887	AK098095	2750	0.376364
chr7	140433812	140624564	BRAF	190752	0.379566
chr7	140705960	140714781	MRPS33	8821	0.416166
chr7	140774031	141180179	TMEM178B	406148	0.432719
chr7	141251077	141354209	AGK	103132	0.395629
chr7	141356527	141401953	KIAA1147	45426	0.435103
chr7	141404137	141438030	WEE2-AS1	33893	0.400378
chr7	141408152	141431071	WEE2	22919	0.396963
chr7	141438120	141450288	SSBP1	12168	0.384451
chr7	141463896	141464997	TAS2R3	1101	0.456857
chr7	141478288	141479188	TAS2R4	900	0.415556
chr7	141490016	141491166	TAS2R5	1150	0.484348
chr7	141505071	141505102	DQ571874	31	0.451613
chr7	141536077	141541221	PRSS37	5144	0.414269
chr7	141618675	141619620	OR9A4	945	0.451852
chr7	141627156	141646783	CLEC5A	19627	0.400163
chr7	141672430	141673573	TAS2R38	1143	0.482065
chr7	141695678	141806547	MGAM	110869	0.391678
chr7	141811548	141843783	LOC93432	32235	0.367520
chr7	141870969	141919974	AK131337	49005	0.383410
chr7	141940555	141946886	MOXD2P	6331	0.473385
chr7	141951957	141957878	PRSS58	5921	0.386759
chr7	141968100	141972068	LOC730441	3968	0.414567
chr7	142000775	142211011	TCRBV22S1A2N1T	210236	0.336175
chr7	142008362	142008868	TCRBV9S1A1T	506	0.474308
chr7	142013006	142013487	TCRBV7S1A1N2T	481	0.505198
chr7	142020708	142470314	TCRBV5S1A1T	449606	0.327940
chr7	142028196	142028611	T-cell receptor IGR b 14 Vbeta 13	415	0.527711
chr7	142032005	142032693	TCRBV20S1	688	0.498547
chr7	142045253	142045814	TCRBV7S3A2	561	0.520499
chr7	142099459	142099938	TCRBV6S2A1N1T	479	0.505219
chr7	142104123	142104534	AY124788	411	0.540146
chr7	142131415	142131921	TCRBV5S2	506	0.565217
chr7	142139277	142139815	TCRBV6S3A1N1T	538	0.522305
chr7	142143653	142144065	AF397448	412	0.526699
chr7	142148931	142149474	TCRBV5S3A2T	543	0.558011
chr7	142157416	142157464	CDR3	48	0.541667
chr7	142180516	142251152	BV13S1J2.7	70636	0.423976
chr7	142168381	142169010	TCRBV5S6A3N2T	629	0.556439
chr7	142176330	142176408	TCRBV	78	0.551282
chr7	142197571	142198055	TRB	484	0.493802
chr7	142206513	142207007	TCRBV12S3	494	0.526316
chr7	142223824	142224284	TCRBV21S1	460	0.502174
chr7	142231577	142232120	TCRBV12S2	543	0.526703
chr7	142239538	142240022	TCRBV1S1A1N1	484	0.516529
chr7	142247109	142247590	TCRBV6S1A1N1	481	0.548857
chr7	142326375	142327044	TCRBV17S1A1T	669	0.506726
chr7	142334185	142494579	TCRBV2S1	160394	0.412890
chr7	142344413	142344880	TCRBV10S1P	467	0.468951
chr7	142353907	142428289	TCRBV19S1P	74382	0.392729
chr7	142364199	142364707	TCRBV15S1	508	0.466535
chr7	142374130	142375525	MTRNR2L6	1395	0.390681
chr7	142378608	142379075	TCRBV11S1A1T	467	0.460385
chr7	142423182	142423934	TCRBV14S1	752	0.523936
chr7	142428486	142428988	TCRBV3S1	502	0.478088
chr7	142448088	142448741	TCRBV4S1A1T	653	0.488515
chr7	142457318	142460927	PRSS1	3609	0.519812
chr7	142462183	142494293	BV6S4-BJ2S2	32110	0.478854
chr7	142470098	142470118	TCRB	20	0.500000
chr7	142478756	142482399	PRSS3P2	3643	0.508098
chr7	142493821	142494029	X04930	208	0.591346
chr7	142494243	142494293	AY006148	50	0.560000
chr7	142495138	142495186	TCRB	48	0.666667
chr7	142510272	142511084	TCRBV20S1A1N2	812	0.552956
chr7	142552791	142568847	EPHB6	16056	0.524228
chr7	142568959	142583490	TRPV6	14531	0.511045
chr7	142605647	142630820	TRPV5	25173	0.457792
chr7	142636602	142637957	C7orf34	1355	0.537269
chr7	142638200	142659503	KEL	21303	0.471530
chr7	142723286	142724219	OR9A2	933	0.448017
chr7	142749437	142750379	OR6V1	942	0.530786
chr7	142759380	142760882	OR6W1P	1502	0.518642
chr7	142829173	142836834	PIP	7661	0.421747
chr7	142880511	142881528	TAS2R39	1017	0.438545
chr7	142919171	142920143	TAS2R40	972	0.471193
chr7	142960521	142966222	GSTK1	5701	0.492721
chr7	142982039	142985141	TMEM139	3102	0.534172
chr7	142985307	143004789	CASP2	19482	0.434350
chr7	143013218	143049097	CLCN1	35879	0.460409
chr7	143050492	143059840	FAM131B	9348	0.550171
chr7	143078359	143088206	ZYX	9847	0.579872
chr7	143088204	143105985	EPHA1	17781	0.523536
chr7	143104905	143220540	EPHA1-AS1	115635	0.419717
chr7	143140545	143141502	TAS2R60	957	0.475444
chr7	143174965	143175889	TAS2R41	924	0.501082
chr7	143268893	143271480	CTAGE15	2587	0.412833
chr7	143306373	143306812	DQ786304	439	0.405467
chr7	143318044	143422176	FAM115C	104132	0.216590
chr7	143339348	143533304	LOC154761	193956	0.300599
chr7	143452181	143454843	CTAGE6	2662	0.417731
chr7	143548460	143599172	FAM115A	50712	0.390144
chr7	143632325	143633279	OR2F2	954	0.498952
chr7	143657019	143658108	OR2F1	1089	0.488522
chr7	143701089	143702025	OR6B1	936	0.477564
chr7	143747494	143748430	OR2A5	936	0.521368
chr7	143771312	143772245	OR2A25	933	0.486602
chr7	143792200	143793133	OR2A12	933	0.486602
chr7	143806675	143807632	OR2A2	957	0.500522
chr7	143826205	143827138	OR2A14	933	0.528403
chr7	143839226	143840031	BAC05914.1	805	0.491925
chr7	143880547	143883173	CTAGE4	2626	0.417365
chr7	143883175	143892791	ARHGEF35	9616	0.454451
chr7	143906939	143906966	RNU6-57P	27	0.555556
chr7	143929003	143929936	OR2A1	933	0.559486
chr7	143947563	143948696	OR2A9P	1133	0.511915
chr7	143955788	143956721	OR2A7	933	0.500536
chr7	143963766	143966392	CTAGE4	2626	0.416984
chr7	143970522	143991256	ARHGEF34P	20734	0.481673
chr7	143996465	143997598	OR2A9P	1133	0.511915
chr7	144015217	144016150	OR2A1	933	0.560557
chr7	144038210	144038237	RNU6-57P	27	0.555556
chr7	144052488	144077725	ARHGEF5	25237	0.479613
chr7	144094332	144107320	NOBOX	12988	0.502926
chr7	144148773	144148910	U6atac	137	0.496350
chr7	144149033	144533146	TPK1	384113	0.372750
chr7	145694483	145694512	DQ597485	29	0.586207
chr7	145813452	148118088	CNTNAP2	2304636	0.375191
chr7	146643907	146643927	MIR548AR	20	0.250000
chr7	146643907	146643927	MIR548AQ	20	0.250000
chr7	146749440	146749460	JB023059	20	0.300000
chr7	146991341	147254962	MIR548I4	263621	0.371909
chr7	147075108	147075213	MIR548F4	105	0.285714
chr7	147797616	147797648	MIR548F3	32	0.312500
chr7	148043899	148043927	MIR548T	28	0.357143
chr7	148287656	148312952	C7orf33	25296	0.425838
chr7	148395932	148498202	CUL1	102270	0.409934
chr7	148504463	148581441	EZH2	76978	0.392190
chr7	148700153	148725782	PDIA4	25629	0.509033
chr7	148766732	148787869	ZNF786	21137	0.461182
chr7	148799877	148823438	ZNF425	23561	0.470905
chr7	148844559	148880118	ZNF398	35559	0.461402
chr7	148892576	148923339	ZNF282	30763	0.518512
chr7	148936741	148952700	ZNF212	15959	0.457547
chr7	148959261	148982085	ZNF783	22824	0.490799
chr7	148982371	148990914	LOC155060	8543	0.546178
chr7	148983532	148983604	SNORD112	72	0.388889
chr7	148991289	148994393	AF035281	3104	0.584729
chr7	149128453	149158053	ZNF777	29600	0.472568
chr7	149169883	149194898	ZNF746	25015	0.469838
chr7	149244244	149321881	ZNF767	77637	0.463722
chr7	149412147	149431664	KRBA1	19517	0.569657
chr7	149461452	149470295	ZNF467	8843	0.594708
chr7	149473130	149531053	SSPO	57923	0.610155
chr7	149535508	149564568	ZNF862	29060	0.488919
chr7	149564782	149570951	ATP6V0E2-AS1	6169	0.534122
chr7	149570056	149577787	ATP6V0E2	7731	0.549347
chr7	149578563	149579188	DQ590227	625	0.587200
chr7	149736256	149742182	AL162052	5926	0.544381
chr7	149944300	150020758	ACTR3C	76458	0.434500
chr7	150006629	150035245	LRRC61	28616	0.493535
chr7	150020295	150035245	LRRC61	14950	0.540134
chr7	150026937	150029811	ZBED6CL	2874	0.557063
chr7	150035406	150038763	RARRES2	3357	0.624069
chr7	150064035	150064063	RNU6-34P	28	0.464286
chr7	150065878	150071133	REPIN1	5255	0.615794
chr7	150069197	150070033	REPIN1	836	0.702153
chr7	150076405	150095719	ZNF775	19314	0.525267
chr7	150102839	150109558	LOC728743	6719	0.581485
chr7	150130741	150145228	LOC285972	14487	0.451301
chr7	150147961	150176483	GIMAP8	28522	0.430790
chr7	150211944	150218161	GIMAP7	6217	0.358533
chr7	150264457	150271041	GIMAP4	6584	0.440766
chr7	150322463	150329736	GIMAP6	7273	0.490169
chr7	150382793	150390728	GIMAP2	7935	0.441840
chr7	150413644	150440737	GIMAP1-GIMAP5	27093	0.430222
chr7	150474295	150478201	AK125599	3906	0.408602
chr7	150488375	150497621	TMEM176B	9246	0.498702
chr7	150497853	150502208	TMEM176A	4355	0.560964
chr7	150549564	150558379	ABP1	8815	0.536358
chr7	150642043	150675402	KCNH2	33359	0.595761
chr7	150688143	150711687	NOS3	23544	0.575943
chr7	150709296	150721586	ATG9B	12290	0.581123
chr7	150725509	150744869	ABCB8	19360	0.570351
chr7	150745378	150749843	ASIC3	4465	0.635610
chr7	150750898	150755052	CDK5	4154	0.576312
chr7	150756656	150773614	SLC4A2	16958	0.598538
chr7	150771828	150773617	AK296065	1789	0.608720
chr7	150773707	150777970	FASTK	4263	0.618344
chr7	150778171	150780620	TMUB1	2449	0.676194
chr7	150783825	150841523	AGAP3	57698	0.574405
chr7	150845675	150864867	GBX1	19192	0.444456
chr7	150872784	150884478	ASB10	11694	0.531298
chr7	150890564	150894388	IQCA1L	3824	0.554132
chr7	150904922	150924317	ABCF2	19395	0.491828
chr7	150909575	150912320	ABCF2	2745	0.518397
chr7	150929584	150935905	CHPF2	6321	0.568423
chr7	150936058	150945749	SMARCD3	9691	0.580642
chr7	151038846	151075548	NUB1	36702	0.448967
chr7	151062455	151065689	AK055458	3234	0.436920
chr7	151078206	151107124	WDR86	28918	0.568573
chr7	151106321	151110132	WDR86-AS1	3811	0.615062
chr7	151127055	151137099	CRYGN	10044	0.576961
chr7	151130574	151130725	MIR3907	151	0.662252
chr7	151163097	151217010	RHEB	53913	0.419194
chr7	151253200	151574316	PRKAG2	321116	0.489194
chr7	151503819	151507545	BC040865	3726	0.529522
chr7	151574126	151576308	PRKAG2-AS1	2182	0.601283
chr7	151653463	151717019	GALNTL5	63556	0.423799
chr7	151722777	151819427	GALNT11	96650	0.412230
chr7	151832009	152133090	KMT2C	301081	0.386451
chr7	152133979	152140100	FABP5P3	6121	0.433916
chr7	152161208	152162630	LOC100128822	1422	0.582982
chr7	152343586	152373250	XRCC2	29664	0.429645
chr7	152456833	152552464	ACTR3B	95631	0.433562
chr7	153749776	154685995	DPP6	936219	0.391809
chr7	153752669	153756646	AK127966	3977	0.525019
chr7	154720226	154741196	LOC100132707	20970	0.407487
chr7	154735399	154794682	PAXIP1	59283	0.407199
chr7	154795142	154797413	LOC202781	2271	0.486129
chr7	154858778	154863267	LOC100128264	4489	0.471152
chr7	154862033	154879102	HTR5A	17069	0.418361
chr7	155022390	155023284	AX746871	894	0.538031
chr7	155023290	155025215	AX746871	1925	0.510649
chr7	155089485	155101945	INSIG1	12460	0.444141
chr7	155174770	155189051	BC150495	14281	0.534276
chr7	155250823	155257526	EN2	6703	0.557213
chr7	155293952	155326539	CNPY1	32587	0.453310
chr7	155434167	155437113	AX747269	2946	0.479294
chr7	155437202	155574179	RBM33	136977	0.407747
chr7	155595557	155604967	SHH	9410	0.636132
chr7	156230482	156238282	LOC285889	7800	0.487949
chr7	156333184	156333795	LINC00244	611	0.482815
chr7	156431059	156433348	C7orf13	2289	0.530363
chr7	156435670	156469820	RNF32	34150	0.414583
chr7	156473569	156685902	LMBR1	212333	0.387665
chr7	156742416	156765876	NOM1	23460	0.470162
chr7	156786744	156802129	MNX1	15385	0.542086
chr7	156797546	156803347	MNX1	5801	0.623513
chr7	156803550	156809118	LOC645249	5568	0.546157
chr7	156931654	157062066	UBE3C	130412	0.421058
chr7	157129709	157210133	DNAJB6	80424	0.479882
chr7	157172509	157174439	DNAJB6	1930	0.444041
chr7	157331749	158380482	PTPRN2	1048733	0.513940
chr7	157367027	157367114	MIR153-2	87	0.436782
chr7	157647276	157658782	LOC100506585	11506	0.582913
chr7	157859627	157862199	DQ583756	2572	0.547823
chr7	158325409	158325505	MIR595	96	0.531250
chr7	158384307	158384388	MIR5707	81	0.370370
chr7	158424002	158497520	NCAPG2	73518	0.417938
chr7	158523688	158622319	ESYT2	98631	0.432217
chr7	158649268	158738883	WDR60	89615	0.453228
chr7	158801044	158818929	LINC00689	17885	0.515516
chr7	158809148	158822882	LINC00689	13734	0.530144
chr7	158820865	158937649	VIPR2	116784	0.491745
chr8	116085	117024	OR4F21	939	0.456869
chr8	158344	182318	RPL23AP53	23974	0.427630
chr8	182199	197339	ZNF596	15140	0.397622
chr8	356807	419875	FBXO25	63068	0.420324
chr8	424454	427966	AK056623	3512	0.358770
chr8	439789	494845	TDRP	55056	0.423351
chr8	590407	594400	AK128400	3993	0.520160
chr8	614199	681226	ERICH1	67027	0.509377
chr8	687586	1087777	ERICH1-AS1	400191	0.477777
chr8	1244293	1250827	LOC286083	6534	0.521579
chr8	1449531	1656642	DLGAP2	207111	0.473046
chr8	1552720	1570583	AK093412	17863	0.433522
chr8	1711869	1734736	CLN8	22867	0.490270
chr8	1765396	1765473	MIR596	77	0.727273
chr8	1772148	1906807	ARHGEF10	134659	0.499959
chr8	1922043	1955109	KBTBD11	33066	0.501815
chr8	1993157	2093380	MYOM2	100223	0.470800
chr8	2147222	2148357	AX747124	1135	0.451982
chr8	2148443	2149988	AX747124	1545	0.384466
chr8	2447075	2480453	BC045738	33378	0.386572
chr8	2554055	2585957	AK128880	31902	0.386089
chr8	2792874	4852328	CSMD1	2059454	0.384662
chr8	5768466	5768758	7SK	292	0.506849
chr8	6261076	6264069	LOC100287015	2993	0.456398
chr8	6264112	6501140	MCPH1	237028	0.422296
chr8	6357174	6420784	ANGPT2	63610	0.406854
chr8	6565877	6619021	AGPAT5	53144	0.384183
chr8	6602684	6602765	MIR4659A	81	0.382716
chr8	6602688	6602761	MIR4659B	73	0.397260
chr8	6666040	6693166	XKR5	27126	0.496498
chr8	6693075	6699975	LOC100652791	6900	0.449130
chr8	6728096	6735529	DEFB1	7433	0.444908
chr8	6782215	6783598	DEFA6	1383	0.453362
chr8	6793344	6795786	DEFA4	2442	0.450860
chr8	6808247	6809121	DEFA8P	874	0.473684
chr8	6816810	6817683	DEFA9P	873	0.490263
chr8	6825662	6826635	DEFA10P	973	0.454265
chr8	6835170	6837614	DEFA1	2444	0.438625
chr8	6844699	6847243	DEFT1P	2544	0.444575
chr8	6854287	6856724	DEFA1	2437	0.438654
chr8	6863802	6866346	DEFT1P	2544	0.444575
chr8	6873390	6875823	DEFA1B	2433	0.438964
chr8	6886122	6887011	DEFA11P	889	0.490439
chr8	6912828	6914259	DEFA5	1431	0.411600
chr8	7010238	7044422	BC030294	34184	0.422800
chr8	7118140	7143880	FLJ00326	25740	0.535043
chr8	7170367	7177473	DEFB109P1B	7106	0.366732
chr8	7189908	7191501	USP17L1P	1593	0.520402
chr8	7194636	7196229	USP17L4	1593	0.513497
chr8	7215497	7220490	ZNF705G	4993	0.360905
chr8	7272384	7274354	DEFB4B	1970	0.430964
chr8	7286415	7287870	DEFB103A	1455	0.449485
chr8	7308085	7321192	SPAG11B	13107	0.421378
chr8	7327829	7332604	DEFB104B	4775	0.444817
chr8	7340025	7343909	DEFB106A	3884	0.360968
chr8	7345242	7347073	DEFB105A	1831	0.377936
chr8	7353367	7366833	DEFB107A	13466	0.404129
chr8	7413659	7431920	FAM90A7P	18261	0.545589
chr8	7627105	7628835	FAM90A10P	1730	0.567630
chr8	7669241	7673238	DEFB107B	3997	0.372029
chr8	7679529	7681360	DEFB105A	1831	0.377936
chr8	7682693	7686575	DEFB106A	3882	0.360381
chr8	7693992	7698764	DEFB104B	4772	0.444677
chr8	7705401	7707807	SPAG11B	2406	0.504572
chr8	7738725	7740180	DEFB103A	1455	0.449485
chr8	7752198	7754237	DEFB4A	2039	0.434036
chr8	7783858	7809935	ZNF705B	26077	0.388618
chr8	7812534	7866277	FAM66E	53743	0.418976
chr8	7829182	7830775	USP17L8	1593	0.511613
chr8	7833914	7835507	USP17L3	1593	0.519146
chr8	7847936	7855043	DEFB109P1B	7107	0.366821
chr8	7946462	7946611	MIR548I3	149	0.375839
chr8	8086091	8096448	FAM86B3P	10357	0.549483
chr8	8175257	8239257	SGK223	64000	0.434734
chr8	8559665	8561617	CLDN23	1952	0.588115
chr8	8641998	8751131	MFHAS1	109133	0.442011
chr8	8860313	8890849	ERI1	30536	0.374181
chr8	8905954	8906028	MIR4660	74	0.540541
chr8	8993763	9008220	PPP1R3B	14457	0.447396
chr8	9046508	9060363	BC017578	13855	0.435078
chr8	9144981	9145088	U6	107	0.401869
chr8	9182560	9192590	LOC157273	10030	0.450548
chr8	9413444	9639856	TNKS	226412	0.370740
chr8	9599181	9599278	MIR597	97	0.443299
chr8	9757573	9760588	AK091593	3015	0.488226
chr8	9760897	9760982	MIR124-1	85	0.505882
chr8	9911829	10286401	MSRA	374572	0.435494
chr8	10340387	10405095	AK307207	64708	0.451521
chr8	10383055	10396333	PRSS55	13278	0.474394
chr8	10463859	10512617	RP1L1	48758	0.515669
chr8	10530146	10558103	C8orf74	27957	0.522696
chr8	10581277	10588022	SOX7	6745	0.521572
chr8	10586823	10622667	BC043573	35844	0.441775
chr8	10641564	10641629	SNORD112	65	0.353846
chr8	10682882	10682953	MIR1322	71	0.338028
chr8	10713594	10716946	AK094525	3352	0.459726
chr8	10753656	11058875	XKR6	305219	0.460912
chr8	10892715	10892812	MIR598	97	0.536082
chr8	10980890	10982327	C8orf15	1437	0.408490
chr8	11141999	11185654	MTMR9	43655	0.378101
chr8	11173370	11177524	CR749668	4154	0.399615
chr8	11177525	11182938	CR749668	5413	0.376686
chr8	11188494	11189695	SLC35G5	1201	0.603664
chr8	11197145	11225961	TDH	28816	0.440727
chr8	11203436	11204999	BC038546	1563	0.557262
chr8	11278972	11324276	FAM167A	45304	0.525715
chr8	11351520	11422108	BLK	70588	0.474075
chr8	11434043	11438850	LINC00208	4807	0.518203
chr8	11561716	11617509	GATA4	55793	0.473339
chr8	11618764	11620732	C8orf49	1968	0.475610
chr8	11627171	11644854	NEIL2	17683	0.489057
chr8	11660189	11696818	FDFT1	36629	0.436594
chr8	11700033	11725646	CTSB	25613	0.517042
chr8	11831445	11832108	DEFB136	663	0.490196
chr8	11839829	11842099	DEFB135	2270	0.444053
chr8	11851488	11853760	DEFB134	2272	0.372799
chr8	11871650	11874981	DQ580909	3331	0.598019
chr8	11921897	11929256	DEFB130	7359	0.363229
chr8	11946846	11973025	ZNF705D	26179	0.396463
chr8	12294521	12408558	LOC100506990	114037	0.452134
chr8	11985366	11986806	LOC392196	1440	0.484028
chr8	11989925	11991518	USP17L7	1593	0.500314
chr8	11994676	11996269	USP17L2	1593	0.521030
chr8	12030962	12034776	FAM90A2P	3814	0.519402
chr8	12039612	12051624	FAM86B1	12012	0.536380
chr8	12168470	12175825	DEFB130	7355	0.363562
chr8	12208140	12219262	ZNF705A	11122	0.368639
chr8	12236775	12237298	LOC649352	523	0.499044
chr8	12250792	12257874	DEFB109P1	7082	0.367552
chr8	12272029	12275541	FAM90A25P	3512	0.569476
chr8	12281921	12282230	DQ587039	309	0.533981
chr8	12282230	12282893	AK308439	663	0.539970
chr8	12283123	12293852	FAM86B2	10729	0.534999
chr8	12426978	12428991	AX747586	2013	0.444610
chr8	12435814	12438798	AX747590	2984	0.420576
chr8	12452478	12523120	LOC729732	70642	0.470938
chr8	12579405	12612992	LONRF1	33587	0.380147
chr8	12584740	12584813	MIR3926-1	73	0.479452
chr8	12584745	12584808	MIR3926-2	63	0.539683
chr8	12623570	12668910	LOC340357	45340	0.409616
chr8	12651751	12675800	LINC00681	24049	0.428874
chr8	12803182	12887284	KIAA1456	84102	0.412951
chr8	12940871	13372429	DLC1	431558	0.390337
chr8	13196082	13200263	BC035181	4181	0.396317
chr8	13424351	13425797	C8orf48	1446	0.422545
chr8	13947372	15095792	SGCZ	1148420	0.354827
chr8	14176963	14177025	U7	62	0.403226
chr8	14345284	14345388	U6	104	0.442308
chr8	14710946	14711019	MIR383	73	0.493151
chr8	15183104	15183164	DPB	60	0.366667
chr8	15397595	15624158	TUSC3	226563	0.362548
chr8	15965386	16050300	MSR1	84914	0.357750
chr8	16850333	16859674	FGF20	9341	0.398137
chr8	16884746	16980148	MICU3	95402	0.359741
chr8	17013835	17080241	ZDHHC2	66406	0.382300
chr8	17086739	17104387	CNOT7	17648	0.374320
chr8	17104400	17155533	VPS37A	51133	0.370289
chr8	17154305	17271040	MTMR7	116735	0.402613
chr8	17396285	17428077	SLC7A2	31792	0.393684
chr8	17433941	17500642	PDGFRL	66701	0.446905
chr8	17501302	17658426	MTUS1	157124	0.408887
chr8	17721899	17753047	FGL1	31148	0.366701
chr8	17780365	17887457	PCM1	107092	0.365303
chr8	17913924	17942507	ASAH1	28583	0.408320
chr8	18067617	18081198	NAT1	13581	0.408733
chr8	18248754	18258723	NAT2	9969	0.370850
chr8	18384812	18871196	PSD3	486384	0.396569
chr8	19041185	19103032	LOC100128993	61847	0.406503
chr8	19171486	19253729	SH2D4A	82243	0.425495
chr8	19261671	19540094	CSGALNACT1	278423	0.417358
chr8	19674917	19709586	INTS10	34669	0.409761
chr8	19796581	19824770	LPL	28189	0.420909
chr8	20002365	20040717	SLC18A1	38352	0.439951
chr8	20054703	20079207	ATP6V1B2	24504	0.386263
chr8	20103675	20112803	LZTS1	9128	0.562774
chr8	20133283	20147969	LZTS1-AS1	14686	0.469971
chr8	20831496	20852630	LOC286114	21134	0.402385
chr8	21155749	21166960	AK057515	11211	0.349211
chr8	21549529	21646346	GFRA2	96817	0.526054
chr8	21766383	21771205	DOK2	4822	0.601410
chr8	21777179	21864096	XPO7	86917	0.399197
chr8	21882353	21894408	NPM2	12055	0.474575
chr8	21900427	21906319	FGF17	5892	0.600475
chr8	21912327	21940036	DMTN	27709	0.541340
chr8	21946713	21961891	FAM160B2	15178	0.573000
chr8	21964382	21967456	NUDT18	3074	0.640208
chr8	21971931	21988565	HR	16634	0.606529
chr8	21995532	21999448	REEP4	3916	0.620786
chr8	22004342	22014344	LGI3	10002	0.561788
chr8	22019183	22021991	SFTPC	2808	0.587251
chr8	22022652	22069840	BMP1	47188	0.538315
chr8	22077215	22089851	PHYHIP	12636	0.566952
chr8	22102474	22102556	MIR320A	82	0.597561
chr8	22102618	22108680	POLR3D	6062	0.518806
chr8	22132809	22213584	PIWIL2	80775	0.428536
chr8	22225049	22280249	SLC39A14	55200	0.488170
chr8	22298482	22398657	PPP3CC	100175	0.391455
chr8	22398357	22402918	AK125860	4561	0.392677
chr8	22409250	22433008	SORBS3	23758	0.571639
chr8	22436253	22451810	PDLIM2	15557	0.588802
chr8	22457113	22461662	C8orf58	4549	0.606067
chr8	22462538	22477983	KIAA1967	15445	0.496989
chr8	22477946	22526661	BIN3	48715	0.495617
chr8	22497883	22499722	FLJ14107	1839	0.537248
chr8	22545173	22550815	EGR3	5642	0.557249
chr8	22570764	22785421	PEBP4	214657	0.491920
chr8	22735496	22745535	AK124682	10039	0.504532
chr8	22853360	22877710	RHOBTB2	24350	0.539138
chr8	22863895	22876848	BC043400	12953	0.523662
chr8	22877647	22926700	TNFRSF10B	49053	0.432328
chr8	22925741	22941132	LOC286059	15391	0.480086
chr8	22960326	22974950	TNFRSF10C	14624	0.458425
chr8	22993100	23021543	TNFRSF10D	28443	0.452941
chr8	23048969	23082680	TNFRSF10A	33711	0.454036
chr8	23082733	23088439	LOC389641	5706	0.415177
chr8	23101149	23119512	CHMP7	18363	0.467298
chr8	23145611	23153792	R3HCC1	8181	0.569246
chr8	23154409	23261722	LOXL2	107313	0.487863
chr8	23193720	23223638	LOC100507156	29918	0.493917
chr8	23286664	23315244	ENTPD4	28580	0.421449
chr8	23386362	23430063	SLC25A37	43701	0.485115
chr8	23430967	23432976	FP15737	2009	0.457939
chr8	23457538	23457651	U4	113	0.362832
chr8	23536205	23540450	NKX3-1	4245	0.493286
chr8	23559963	23564111	NKX2-6	4148	0.579315
chr8	23699433	23712320	STC1	12887	0.437961
chr8	24151579	24212726	ADAM28	61147	0.356812
chr8	24241797	24263526	ADAMDEC1	21729	0.363523
chr8	24298508	24367077	ADAM7	68569	0.362102
chr8	24770531	24772230	AK308605	1699	0.623896
chr8	24771273	24776606	NEFM	5333	0.485093
chr8	24808468	24814383	NEFL	5915	0.447168
chr8	25042286	25270619	DOCK5	228333	0.424052
chr8	25272425	25273231	DKFZp451J181	806	0.344913
chr8	25276773	25282556	GNRH1	5783	0.396853
chr8	25285363	25315984	KCTD9	30621	0.372914
chr8	25316512	25365425	CDCA2	48913	0.397399
chr8	25699245	25902640	EBF2	203395	0.420010
chr8	26236776	26240469	BC034827	3693	0.409152
chr8	26240522	26270644	BNIP3L	30122	0.403360
chr8	26362195	26371483	PNMA2	9288	0.482666
chr8	26371708	26515693	DPYSL2	143985	0.449366
chr8	26627221	26722922	ADRA1A	95701	0.406370
chr8	26723016	26724760	AK311558	1744	0.597477
chr8	27093813	27115903	STMN4	22090	0.481711
chr8	27142403	27168834	TRIM35	26431	0.456850
chr8	27182995	27316908	PTK2B	133913	0.471530
chr8	27317277	27336813	CHRNA2	19536	0.506091
chr8	27348518	27402439	EPHX2	53921	0.473878
chr8	27454433	27472328	CLU	17895	0.496843
chr8	27491576	27530537	SCARA3	38961	0.500423
chr8	27559189	27559284	MIR3622B	95	0.578947
chr8	27559193	27559276	MIR3622A	83	0.602410
chr8	27590832	27630170	CCDC25	39338	0.400707
chr8	27632057	27662424	ESCO2	30367	0.367866
chr8	27667137	27695349	PBK	28212	0.370197
chr8	27727398	27850369	SCARA5	122971	0.490603
chr8	27743555	27743633	MIR4287	78	0.500000
chr8	27879480	27941388	NUGGC	61908	0.450733
chr8	27950583	28048669	ELP3	98086	0.398885
chr8	28174648	28200868	PNOC	26220	0.469565
chr8	28203101	28243977	ZNF395	40876	0.482679
chr8	28285925	28347835	FBXO16	61910	0.433597
chr8	28351721	28431785	FZD3	80064	0.362797
chr8	28362632	28362699	MIR4288	67	0.522388
chr8	28553718	28558836	BC043205	5118	0.472450
chr8	28558989	28611207	EXTL3	52218	0.441400
chr8	28625174	28747432	INTS9	122258	0.419654
chr8	28747910	28910242	HMBOX1	162332	0.370481
chr8	28912742	28914744	DQ591785	2002	0.449051
chr8	28918209	28920183	DQ595103	1974	0.504559
chr8	28924794	29120610	KIF13B	195816	0.419108
chr8	28968089	28998197	AF086219	30108	0.410024
chr8	29190578	29208267	DUSP4	17689	0.511335
chr8	29578775	29605625	LINC00589	26850	0.445438
chr8	29605840	29656008	BC015784	50168	0.419391
chr8	29779028	29811123	LOC286135	32095	0.391556
chr8	29814787	29814864	MIR3148	77	0.363636
chr8	29920257	30108213	MIR548O2	187956	0.429962
chr8	29920630	29940649	TMEM66	20019	0.400869
chr8	29952921	29995222	LEPROTL1	42301	0.421148
chr8	29989186	30002200	MBOAT4	13014	0.452359
chr8	30013812	30041155	DCTN6	27343	0.415646
chr8	30239634	30242917	LOC100128750	3283	0.572952
chr8	30241943	30405029	RBPMS	163086	0.410838
chr8	30436030	30515738	GTF2E2	79708	0.394038
chr8	30496116	30503469	SMIM18	7353	0.365293
chr8	30535579	30585486	GSR	49907	0.447372
chr8	30601689	30624520	UBXN8	22831	0.433402
chr8	30643125	30670352	PPP2CB	27227	0.409667
chr8	30689059	30706533	TEX15	17474	0.357331
chr8	30888356	30890317	PURG	1961	0.430393
chr8	30890777	31031277	WRN	140500	0.361153
chr8	32405727	32622558	NRG1	216831	0.371939
chr8	31883734	31957254	BC037250	73520	0.373912
chr8	32298261	32300241	NRG1-IT3	1980	0.380808
chr8	32785487	32902373	BC034319	116886	0.376469
chr8	33228343	33330664	FUT10	102321	0.430635
chr8	33342684	33358778	MAK16	16094	0.399590
chr8	33356026	33370703	TTI2	14677	0.431900
chr8	33405272	33424643	RNF122	19371	0.490734
chr8	33448853	33457439	DUSP26	8586	0.528884
chr8	35092974	35652181	UNC5D	559207	0.385768
chr8	36124002	36124282	7SK	280	0.364286
chr8	36641841	36793643	KCNU1	151802	0.381049
chr8	37526415	37526523	U6	108	0.416667
chr8	37553300	37556396	ZNF703	3096	0.705749
chr8	37575096	37591011	BC031939	15915	0.456362
chr8	37592278	37594944	AX747135	2666	0.530007
chr8	37594096	37615319	ERLIN2	21223	0.443622
chr8	37604073	37605564	LOC728024	1491	0.433266
chr8	37620100	37637286	PROSC	17186	0.436053
chr8	37654400	37701504	GPR124	47104	0.559422
chr8	37701397	37707431	BRF2	6034	0.499171
chr8	37716464	37757015	RAB11FIP1	40551	0.458336
chr8	37791799	37797647	GOT1L1	5848	0.489398
chr8	37820513	37824184	ADRB3	3671	0.591664
chr8	37888019	37917883	EIF4EBP1	29864	0.492031
chr8	37963010	37997598	ASH2L	34588	0.428501
chr8	38000217	38008600	STAR	8383	0.503161
chr8	38020838	38034248	LSM1	13410	0.429605
chr8	38034105	38070819	BAG4	36714	0.418042
chr8	38089470	38120287	DDHD2	30817	0.410780
chr8	38120649	38126738	PPAPDC1B	6089	0.452619
chr8	38132560	38239790	WHSC1L1	107230	0.388436
chr8	38243958	38266062	LETM2	22104	0.445394
chr8	38268655	38325363	FGFR1	56708	0.500899
chr8	38368351	38386180	C8orf86	17829	0.458298
chr8	38457692	38458775	RNF5P1	1083	0.525392
chr8	38644721	38710546	TACC1	65825	0.419385
chr8	38758752	38831430	PLEKHA2	72678	0.465354
chr8	38831667	38846181	HTRA4	14514	0.459419
chr8	38846326	38854041	TM2D2	7715	0.414517
chr8	38854504	38962779	ADAM9	108275	0.374445
chr8	38876133	38876202	SNORD38	69	0.362319
chr8	38965049	39142436	ADAM32	177387	0.376713
chr8	39172181	39274897	ADAM5	102716	0.356741
chr8	39308563	39380508	ADAM3A	71945	0.350726
chr8	39420630	39437653	LOC100130964	17023	0.324091
chr8	39442086	39587583	ADAM18	145497	0.344000
chr8	39601254	39695808	ADAM2	94554	0.350213
chr8	39771327	39786309	IDO1	14982	0.402216
chr8	39792473	39873910	IDO2	81437	0.417734
chr8	40010986	40012827	C8orf4	1841	0.361217
chr8	40388110	40755343	ZMAT4	367233	0.409171
chr8	41119475	41166990	SFRP1	47515	0.486036
chr8	41348080	41368499	GOLGA7	20419	0.396444
chr8	41386724	41402565	GINS4	15841	0.467584
chr8	41435706	41482520	AGPAT6	46814	0.454351
chr8	41503828	41504875	NKX6-3	1047	0.638968
chr8	41510743	41754280	ANK1	243537	0.493157
chr8	41517958	41518026	MIR486	68	0.632353
chr8	41517958	41518026	JB175081	68	0.632353
chr8	41786996	41909505	KAT6A	122509	0.388927
chr8	42010463	42028701	AP3M2	18238	0.413806
chr8	42032235	42065194	PLAT	32959	0.486969
chr8	42128819	42190171	IKBKB	61352	0.482446
chr8	42195972	42229331	POLB	33359	0.404359
chr8	42231585	42234674	DKK4	3089	0.452574
chr8	42249278	42263455	VDAC3	14177	0.401495
chr8	42273979	42396655	SLC20A2	122676	0.440706
chr8	42396297	42408140	SMIM19	11843	0.447606
chr8	42552561	42592209	CHRNB3	39648	0.448093
chr8	42607779	42623929	CHRNA6	16150	0.463591
chr8	42691816	42698474	THAP1	6658	0.410333
chr8	42708437	42751866	RNF170	43429	0.419927
chr8	42752032	42885682	HOOK3	133650	0.404751
chr8	42911441	42940932	FNTA	29491	0.405344
chr8	42948648	42978323	SGK196	29675	0.452772
chr8	42995591	43057970	HGSNAT	62379	0.441142
chr8	43147584	43218328	POTEA	70744	0.370703
chr8	47752507	47767407	LINC00293	14900	0.438658
chr8	48100929	48104439	LOC100287846	3510	0.450997
chr8	48173488	48648563	KIAA0146	475075	0.407622
chr8	48649475	48650726	CEBPD	1251	0.659472
chr8	48685668	48872743	PRKDC	187075	0.419318
chr8	48872762	48890719	MCM4	17957	0.457649
chr8	48920994	48974454	UBE2V2	53460	0.427217
chr8	49635952	49647870	EFCAB1	11918	0.403675
chr8	49830238	49833999	SNAI2	3761	0.400957
chr8	49966894	49988642	C8orf22	21748	0.388633
chr8	50047179	50047788	BC042029	609	0.384236
chr8	50824596	51705427	SNTG1	880831	0.358532
chr8	50900169	50900189	JB175331	20	0.250000
chr8	52232136	52722005	PXDNL	489869	0.386865
chr8	52730139	52811735	PCMTD1	81596	0.367395
chr8	52812208	52859733	AK299452	47525	0.402483
chr8	52860661	52862694	AX747167	2033	0.395475
chr8	53023391	53322439	ST18	299048	0.392847
chr8	53446596	53478021	FAM150A	31425	0.409547
chr8	53535017	53627026	RB1CC1	92009	0.370094
chr8	53852467	53853454	NPBWR1	987	0.668693
chr8	54138275	54164194	OPRK1	25919	0.420194
chr8	54427730	54436491	AK056897	8761	0.436366
chr8	54628102	54755871	ATP6V1H	127769	0.391370
chr8	54764367	54871863	RGS20	107496	0.423244
chr8	54879115	54935008	TCEA1	55893	0.393949
chr8	54955551	54957513	BC039537	1962	0.467380
chr8	54958937	55014577	LYPLA1	55640	0.415457
chr8	55047780	55061074	MRPL15	13294	0.433353
chr8	55370494	55373456	SOX17	2962	0.593180
chr8	55528626	55543394	RP1	14768	0.381771
chr8	56015016	56438710	XKR4	423694	0.402300
chr8	56361756	56367881	SBF1P1	6125	0.613388
chr8	56651319	56685885	TMEM68	34566	0.389111
chr8	56685790	56738005	TGS1	52215	0.399521
chr8	56792385	56925006	LYN	132621	0.431463
chr8	56980738	56987140	RPS20	6402	0.422212
chr8	56986397	56986460	SNORD54	63	0.428571
chr8	57025500	57026541	MOS	1041	0.609990
chr8	57033800	57033911	SNORA3	111	0.531532
chr8	57073467	57123859	PLAG1	50392	0.387145
chr8	57124314	57131176	CHCHD7	6862	0.414748
chr8	57212569	57233241	SDR16C5	20672	0.446546
chr8	57353512	57358593	PENK	5081	0.400905
chr8	57358365	57464626	AX747062	106261	0.405822
chr8	57430877	57472382	LOC100507632	41505	0.426503
chr8	57829642	57829749	U6	107	0.448598
chr8	57870487	57906430	IMPAD1	35943	0.382272
chr8	58131647	58145388	LOC100507651	13741	0.414453
chr8	58173784	58179170	LOC286177	5386	0.372447
chr8	58192101	58197290	LINC00588	5189	0.390441
chr8	58256345	58277415	BC048118	21070	0.450356
chr8	58658707	58662754	AX746596	4047	0.384235
chr8	58907112	59062277	FAM110B	155165	0.404602
chr8	59168329	59184660	BC032030	16331	0.373768
chr8	59323822	59364060	UBXN2B	40238	0.380287
chr8	59402736	59412720	CYP7A1	9984	0.371494
chr8	59465727	59495419	SDCBP	29692	0.355954
chr8	59496063	59571966	NSMAF	75903	0.381869
chr8	59571857	59573985	AX747379	2128	0.518327
chr8	59717976	60031767	TOX	313791	0.375705
chr8	60049930	60050061	SNORA51	131	0.435115
chr8	61101422	61193954	CA8	92532	0.392632
chr8	61315770	61326377	AK124262	10607	0.462148
chr8	61429468	61536203	RAB2A	106735	0.391615
chr8	61591323	61780586	CHD7	189263	0.399888
chr8	61878679	61880307	LOC100130298	1628	0.435504
chr8	62200524	62414204	CLVS1	213680	0.393500
chr8	62413114	62627199	ASPH	214085	0.381685
chr8	62544238	62544571	7SK	333	0.498498
chr8	62627346	62627418	MIR4470	72	0.569444
chr8	62671658	62678528	BC047540	6870	0.391703
chr8	63161500	63903628	NKAIN3	742128	0.374186
chr8	63890419	63897460	UG0898H09	7041	0.399517
chr8	63927638	63951610	GGH	23972	0.387494
chr8	63972047	63998612	TTPA	26565	0.381254
chr8	64080283	64081001	LOC101410533	718	0.552925
chr8	64081185	64125346	YTHDF3	44161	0.375105
chr8	64297396	64330488	AK093370	33092	0.383839
chr8	64521911	64522158	7SK	247	0.437247
chr8	64681987	64698054	LOC286184	16067	0.378104
chr8	65285774	65291386	LOC100130155	5612	0.478439
chr8	65291705	65291814	MIR124-2	109	0.495413
chr8	65486865	65494445	LOC401463	7580	0.515831
chr8	65486865	65489820	LOC401463	2955	0.428088
chr8	65492794	65496191	BHLHE22	3397	0.529879
chr8	65508528	65711348	CYP7B1	202820	0.377123
chr8	66073379	66092575	LINC00251	19196	0.407950
chr8	66439242	66474901	LOC286186	35659	0.412463
chr8	66514690	66546452	ARMC1	31762	0.426044
chr8	66582107	66622798	MTFR1	40691	0.402005
chr8	66626568	66753969	PDE7A	127401	0.376543
chr8	66933790	67012755	DNAJC5B	78965	0.405420
chr8	67039277	67087718	TRIM55	48441	0.409426
chr8	67088611	67090846	CRH	2235	0.548993
chr8	67104348	67109554	LOC100505659	5206	0.442182
chr8	67331821	67341212	LOC100505676	9391	0.411138
chr8	67341262	67342968	RRS1	1706	0.563306
chr8	67344717	67381044	ADHFE1	36327	0.435296
chr8	67405490	67430759	C8orf46	25269	0.457794
chr8	67474409	67525480	MYBL1	51071	0.362672
chr8	67542487	67579452	VCPIP1	36965	0.398620
chr8	67624652	67774257	SGK3	149605	0.401912
chr8	67579786	67593377	C8orf44	13591	0.408358
chr8	67679631	67680240	PTTG3P	609	0.441708
chr8	67782983	67834283	MCMDC2	51300	0.397193
chr8	67834164	67837777	SNHG6	3613	0.431221
chr8	67834708	67834784	SNORD87	76	0.328947
chr8	67858735	67874825	TCF24	16090	0.414667
chr8	67900366	67940786	PPP1R42	40420	0.391564
chr8	67924006	67924105	U2	99	0.363636
chr8	67955314	67974562	COPS5	19248	0.394898
chr8	67960635	67960655	JA611241	20	0.500000
chr8	67976602	68108849	CSPP1	132247	0.379041
chr8	68109883	68255912	ARFGEF1	146029	0.382301
chr8	68334404	68658620	CPA6	324216	0.400748
chr8	68497703	68497734	DQ584699	31	0.483871
chr8	68864602	69143897	PREX2	279295	0.372062
chr8	69215702	69243726	LOC286189	28024	0.400193
chr8	69242956	69731258	C8orf34	488302	0.367103
chr8	69824037	70016425	LOC100505718	192388	0.367445
chr8	70378858	70573147	SULF1	194289	0.403414
chr8	70540006	70573147	SULF1	33141	0.410700
chr8	70584567	70747299	SLCO5A1	162732	0.401249
chr8	70963885	70983562	PRDM14	19677	0.468059
chr8	71024266	71316020	NCOA2	291754	0.382754
chr8	71485452	71520694	TRAM1	35242	0.383208
chr8	71520811	71575513	LOC286190	54702	0.393313
chr8	71549500	71581447	LACTB2	31947	0.384481
chr8	71581599	71648177	XKR9	66578	0.382484
chr8	72109667	72268979	EYA1	159312	0.376111
chr8	72315674	72459892	BC048982	144218	0.376513
chr8	72753776	72756731	MSC	2955	0.586464
chr8	72755357	72968547	LOC100132891	213190	0.380252
chr8	72933485	72987819	TRPA1	54334	0.362388
chr8	73117533	73163869	LOC392232	46336	0.360195
chr8	73449625	73850584	KCNB2	400959	0.388823
chr8	73921096	73959987	TERF1	38891	0.370420
chr8	73976777	74005507	SBSPON	28730	0.441037
chr8	74153658	74171737	LOC100130301	18079	0.368439
chr8	74202873	74205869	RPL7	2996	0.401535
chr8	74206836	74237520	RDH10	30684	0.416862
chr8	74223140	74268696	AK128216	45556	0.431952
chr8	74332308	74353753	STAU2-AS1	21445	0.444672
chr8	74332603	74659162	STAU2	326559	0.381781
chr8	74698454	74791145	UBE2W	92691	0.391397
chr8	74857372	74884522	TCEB1	27150	0.407219
chr8	74888376	74895018	TMEM70	6642	0.428937
chr8	74903563	74941307	LY96	37744	0.419934
chr8	74960911	74961019	U6	108	0.453704
chr8	75146938	75233562	JPH1	86624	0.397107
chr8	75262617	75279335	GDAP1	16718	0.383000
chr8	75460777	75460852	MIR5681A	75	0.400000
chr8	75460784	75460844	MIR5681B	60	0.450000
chr8	75512100	75670587	FLJ39080	158487	0.374567
chr8	75617927	75617982	MIR2052	55	0.327273
chr8	75728285	75779174	AK024242	50889	0.361787
chr8	75736771	75767264	PI15	30493	0.348801
chr8	75896707	75946793	CRISPLD1	50086	0.352354
chr8	76135660	76190696	BC062758	55036	0.355422
chr8	76452202	76479061	HNF4G	26859	0.340370
chr8	77523113	77595510	ZFHX4-AS1	72397	0.357708
chr8	77593514	77779521	ZFHX4	186007	0.363804
chr8	77892493	77913280	PEX2	20787	0.383653
chr8	79428335	79517502	PKIA	89167	0.347550
chr8	79446126	79470738	BC036404	24612	0.347960
chr8	79578281	79631997	ZC2HC1A	53716	0.347904
chr8	79635082	79636609	LOC101241902	1527	0.345776
chr8	79645006	79717758	IL7	72752	0.363509
chr8	80523048	80578410	STMN2	55362	0.382067
chr8	80676244	80680098	HEY1	3854	0.464453
chr8	80681614	80783972	AK055332	102358	0.420407
chr8	80712367	80712430	U7	63	0.412698
chr8	80831094	80942506	MRPS28	111412	0.371827
chr8	80947104	80993010	TPD52	45906	0.392106
chr8	81153623	81153708	MIR5708	85	0.447059
chr8	81397767	81398304	DJ031142	537	0.620112
chr8	81398447	81438500	ZBTB10	40053	0.384590
chr8	81540685	81787016	ZNF704	246331	0.402649
chr8	81880045	82024303	PAG1	144258	0.405648
chr8	82192717	82197012	FABP5	4295	0.446799
chr8	82352563	82359719	PMP2	7156	0.340553
chr8	82370617	82373758	FABP9	3141	0.364852
chr8	82390731	82395473	FABP4	4742	0.349009
chr8	82437280	82443550	FABP12	6270	0.366507
chr8	82569150	82598589	IMPA1	29439	0.374333
chr8	82605890	82607207	SLC10A5	1317	0.373576
chr8	82613565	82633539	ZFAND1	19974	0.353359
chr8	82644687	82671748	CHMP4C	27061	0.380622
chr8	82711817	82754521	SNX16	42704	0.349101
chr8	84315992	84321132	BC038578	5140	0.328794
chr8	85097099	85834078	RALYL	736979	0.352709
chr8	86019322	86058314	LRRCC1	38992	0.361279
chr8	86089618	86126753	E2F5	37135	0.394910
chr8	86126287	86132643	C8orf59	6356	0.387036
chr8	86126823	86129387	AB209185	2564	0.373635
chr8	86157715	86196302	CA13	38587	0.403011
chr8	86240457	86290342	CA1	49885	0.371214
chr8	86351055	86361267	CA3	10212	0.391206
chr8	86376130	86393721	CA2	17591	0.385822
chr8	86566827	86567905	REXO1L2P	1078	0.638219
chr8	86568694	86575726	REXO1L1	7032	0.526451
chr8	86727072	86749604	REXO1L1	22532	0.469066
chr8	86756683	86757761	REXO1L2P	1078	0.638219
chr8	86758550	86789306	REXO1L1	30756	0.467714
chr8	87060690	87081851	PSKH2	21161	0.401352
chr8	87111138	87166454	ATP6V0D2	55316	0.396323
chr8	87226287	87242604	SLC7A13	16317	0.365263
chr8	87345502	87355543	BC038731	10041	0.420974
chr8	87354993	87480178	WWP1	125185	0.375532
chr8	87484577	87521009	RMDN1	36432	0.380407
chr8	87526655	87573726	CPNE3	47071	0.376219
chr8	87586162	87755903	CNGB3	169741	0.380892
chr8	87878675	88394955	CNBD1	516280	0.359814
chr8	88882970	88886296	DCAF4L2	3326	0.419122
chr8	89044236	89046790	DKFZp761D112	2554	0.320282
chr8	89049459	89339717	MMP16	290258	0.351387
chr8	90769974	90803292	RIPK2	33318	0.360106
chr8	90914761	90940095	OSGIN2	25334	0.373806
chr8	90945563	90996899	NBN	51336	0.362144
chr8	91013579	91064227	DECR1	50648	0.382128
chr8	91070837	91095107	CALB1	24270	0.342645
chr8	91233715	91400187	LINC00534	166472	0.380112
chr8	91634222	91658133	TMEM64	23911	0.368282
chr8	91658668	91663985	BC040572	5317	0.429001
chr8	91803920	91971630	NECAB1	167710	0.370193
chr8	91970705	91997485	LOC100127983	26780	0.330097
chr8	92006501	92053203	TMEM55A	46702	0.356195
chr8	92080142	92082417	BC067244	2275	0.352088
chr8	92082423	92099323	OTUD6B	16900	0.349408
chr8	92114846	92231464	LRRC69	116618	0.369488
chr8	92217712	92217786	MIR4661	74	0.472973
chr8	92261515	92406946	SLC26A7	145431	0.359971
chr8	92607192	92607469	7SK	277	0.548736
chr8	92967194	93107882	RUNX1T1	140688	0.378334
chr8	93725189	93798288	FLJ46284	73099	0.365203
chr8	93895757	93978372	TRIQK	82615	0.337336
chr8	94146323	94179079	C8orf87	32756	0.373611
chr8	94358694	94712661	LINC00535	353967	0.400484
chr8	94712772	94740671	FAM92A1	27899	0.380587
chr8	94743730	94753224	RBM12B	9494	0.396356
chr8	94752338	94753047	RBM12B-AS1	709	0.499295
chr8	94767071	94830347	TMEM67	63276	0.373538
chr8	94928249	94928347	MIR378D2	98	0.418367
chr8	94929082	94938296	PDP1	9214	0.418494
chr8	95139393	95220815	CDH17	81422	0.405971
chr8	95261484	95274547	GEM	13063	0.441476
chr8	95384187	95487343	RAD54B	103156	0.367221
chr8	95439939	95449180	FSBP	9241	0.322259
chr8	95500004	95565746	KIAA1429	65742	0.387454
chr8	95649512	95651695	LOC100288748	2183	0.463124
chr8	95653363	95719694	ESRP1	66331	0.402949
chr8	95732102	95806076	DPY19L4	73974	0.399789
chr8	95835517	95892721	INTS8	57204	0.396598
chr8	95892452	95907482	CCNE2	15030	0.389887
chr8	95938199	95961615	TP53INP1	23416	0.424880
chr8	96037213	96070944	NDUFAF6	33731	0.398535
chr8	96079036	96085148	AX747981	6112	0.450589
chr8	96085141	96085221	MIR3150A	80	0.625000
chr8	96145948	96168913	PLEKHF2	22965	0.373220
chr8	96219234	96228602	C8orf69	9368	0.497331
chr8	96257140	96281462	C8orf37	24322	0.374352
chr8	96281063	96822371	LOC100616530	541308	0.396953
chr8	96959212	96960576	LOC100500773	1364	0.382698
chr8	97154557	97173020	GDF6	18463	0.517034
chr8	97238903	97247862	UQCRB	8959	0.382520
chr8	97251644	97273796	MTERFD1	22152	0.387279
chr8	97274166	97346774	PTDSS1	72608	0.436040
chr8	97505881	97624037	SDC2	118156	0.413614
chr8	97657498	98155722	CPQ	498224	0.381102
chr8	98285713	98290176	TSPYL5	4463	0.497647
chr8	98656406	98742488	MTDH	86082	0.406113
chr8	98787808	98864830	LAPTM4B	77022	0.439926
chr8	98881310	99048946	MATN2	167636	0.446861
chr8	99053937	99057818	RPL30	3881	0.421541
chr8	99054313	99054445	SNORA72	132	0.401515
chr8	99076749	99105838	C8orf47	29089	0.424937
chr8	99114566	99129418	HRSP12	14852	0.390318
chr8	99129520	99172069	POP1	42549	0.418083
chr8	99204386	99306621	NIPAL2	102235	0.390140
chr8	99439249	99443023	KCNS2	3774	0.565713
chr8	99466858	99837909	STK3	371051	0.375215
chr8	99933460	99933778	7SK	318	0.493711
chr8	99956630	99964326	OSR2	7696	0.510265
chr8	100025493	100889814	VPS13B	864321	0.366490
chr8	100548863	100548958	MIR599	95	0.421053
chr8	100549013	100549089	MIR875	76	0.394737
chr8	100890222	100906242	COX6C	16020	0.410237
chr8	100973275	101118344	RGS22	145069	0.373981
chr8	101016810	101016877	SNORD77	67	0.328358
chr8	101145587	101158099	FBXO43	12512	0.390825
chr8	101162838	101166230	POLR2K	3392	0.373231
chr8	101170262	101254132	SPAG1	83870	0.405950
chr8	101269287	101315487	RNF19A	46200	0.360801
chr8	101394990	101395073	MIR4471	83	0.301205
chr8	101521979	101572014	ANKRD46	50035	0.397382
chr8	101585111	101661893	SNX31	76782	0.423328
chr8	101715143	101734315	PABPC1	19172	0.409660
chr8	101930803	101965221	YWHAZ	34418	0.406183
chr8	101946567	101949291	AX746867	2724	0.399046
chr8	102064281	102088479	FLJ42969	24198	0.464501
chr8	102150186	102150541	7SK	355	0.476056
chr8	102209265	102218292	ZNF706	9027	0.400244
chr8	102381120	102381823	NACAP1	703	0.455192
chr8	102504667	102681952	GRHL2	177285	0.409160
chr8	102698769	103136562	NCALD	437793	0.405461
chr8	103137659	103137743	MIR5680	84	0.500000
chr8	103216728	103251059	RRM2B	34331	0.376890
chr8	103255836	103265561	AK095151	9725	0.379332
chr8	103264501	103424917	UBR5	160416	0.382967
chr8	103563847	103573245	ODF1	9398	0.438178
chr8	103661004	103667983	KLF10	6979	0.479152
chr8	103819049	103822199	AK127183	3150	0.562222
chr8	103838535	103876397	AZIN1	37862	0.393693
chr8	104033247	104085285	ATP6V1C1	52038	0.384219
chr8	104133259	104147519	AK001351	14260	0.434151
chr8	104145190	104153570	C8orf56	8380	0.463365
chr8	104152920	104242533	BAALC	89613	0.427538
chr8	104166841	104166917	MIR3151	76	0.644737
chr8	104177736	104298135	LOC100499183	120399	0.413832
chr8	104310660	104345094	FZD6	34434	0.376488
chr8	104383742	104395232	CTHRC1	11490	0.399217
chr8	104410865	104427563	SLC25A32	16698	0.372080
chr8	104426941	104455680	DCAF13	28739	0.370890
chr8	104512975	105266656	RIMS2	753681	0.353711
chr8	105352023	105368917	DCSTAMP	16894	0.443471
chr8	105391651	105479277	DPYS	87626	0.406729
chr8	105501458	105601252	LRP12	99794	0.356855
chr8	106331146	106816767	ZFPM2	485621	0.360483
chr8	107460151	107764921	OXR1	304770	0.364488
chr8	107771710	107782472	ABRA	10762	0.402434
chr8	108261709	108510254	ANGPT1	248545	0.360466
chr8	108911543	109095913	RSPO2	184370	0.377458
chr8	109213971	109260959	EIF3E	46988	0.360688
chr8	109455852	109499136	EMC2	43284	0.346710
chr8	109795345	109799770	TMEM74	4425	0.453107
chr8	110099652	110131812	TRHR	32160	0.378794
chr8	110253147	110346350	NUDCD1	93203	0.365439
chr8	110346551	110358189	ENY2	11638	0.371112
chr8	110374705	110543500	PKHD1L1	168795	0.354460
chr8	110551928	110577391	EBAG9	25463	0.351608
chr8	110586404	110657051	SYBU	70647	0.403089
chr8	110608471	110608543	SNORD112	72	0.347222
chr8	110656343	110660313	AX748380	3970	0.499244
chr8	110886141	110886247	U2	106	0.320755
chr8	110979232	110987421	KCNV1	8189	0.425205
chr8	113235158	114449242	CSMD3	1214084	0.337440
chr8	113655721	113655812	MIR2053	91	0.296703
chr8	116420723	116681228	TRPS1	260505	0.354396
chr8	116962735	117337297	LINC00536	374562	0.373842
chr8	117657054	117768062	EIF3H	111008	0.377856
chr8	117778741	117786921	UTP23	8180	0.376528
chr8	117858172	117887105	RAD21	28933	0.360177
chr8	117886662	117889107	RAD21-AS1	2445	0.424540
chr8	117947898	117950697	AL832163	2799	0.418364
chr8	117950463	117956239	AARD	5776	0.433691
chr8	118147336	118188953	SLC30A8	41617	0.379100
chr8	118325766	118325900	SNORA31	134	0.440298
chr8	118532964	118552501	MED30	19537	0.345754
chr8	118811601	119124058	EXT1	312457	0.412086
chr8	119097732	119100498	AK025288	2766	0.356110
chr8	119390226	119634184	SAMD12	243958	0.396117
chr8	119633239	119738306	SAMD12-AS1	105067	0.387543
chr8	119935795	119964383	TNFRSF11B	28588	0.375822
chr8	120079423	120119202	COLEC10	39779	0.377863
chr8	120220609	120257914	MAL2	37305	0.403431
chr8	120428551	120436678	NOV	8127	0.420819
chr8	120569316	120651106	ENPP2	81790	0.389192
chr8	120743013	120845074	TAF2	102061	0.374923
chr8	120846180	120868170	DSCC1	21990	0.418918
chr8	120885899	121063157	DEPTOR	177258	0.431856
chr8	121137346	121384273	COL14A1	246927	0.381173
chr8	121408082	121457647	MRPL13	49565	0.349622
chr8	121457637	121535875	MTBP	78238	0.346865
chr8	121547984	121824309	SNTB1	276325	0.403333
chr8	121773492	121789072	AK057448	15580	0.403723
chr8	122625270	122653630	HAS2	28360	0.392983
chr8	122651585	122657564	HAS2-AS1	5979	0.457100
chr8	122966844	123139423	BC052578	172579	0.371592
chr8	123793900	123986755	ZHX2	192855	0.463016
chr8	124025403	124054663	DERL1	29260	0.412577
chr8	124084919	124164392	WDR67	79473	0.386836
chr8	124194265	124221207	FAM83A	26942	0.499555
chr8	124192549	124192765	U3	216	0.481481
chr8	124213411	124214983	FAM83A-AS1	1572	0.493003
chr8	124228027	124228103	MIR4663	76	0.605263
chr8	124232195	124253638	C8orf76	21443	0.437439
chr8	124260689	124286727	ZHX1	26038	0.376795
chr8	124275082	124275189	U6	107	0.392523
chr8	124332090	124408705	ATAD2	76615	0.389597
chr8	124412917	124412958	DQ573774	41	0.414634
chr8	124414122	124414161	DQ594696	39	0.615385
chr8	124414224	124414255	DQ599993	31	0.516129
chr8	124414756	124414789	DQ587954	33	0.606061
chr8	124428964	124454260	WDYHV1	25296	0.453669
chr8	124510126	124553493	FBXO32	43367	0.441096
chr8	124600998	124601286	7SK	288	0.486111
chr8	124657914	124665190	KLHL38	7276	0.465366
chr8	124693033	124749647	ANXA13	56614	0.442505
chr8	124780881	124827690	FAM91A1	46809	0.367942
chr8	124864226	125132302	FER1L6	268076	0.416054
chr8	124996377	125053023	FER1L6-AS1	56646	0.412456
chr8	125058313	125183763	AK057332	125450	0.415823
chr8	125323158	125384940	TMEM65	61782	0.356771
chr8	125463047	125465266	TRMT12	2219	0.477242
chr8	125474737	125486804	CR933665	12067	0.414850
chr8	125487007	125500859	RNF139	13852	0.386587
chr8	125500734	125551329	TATDN1	50595	0.405969
chr8	125551342	125562227	NDUFB9	10885	0.432246
chr8	125563027	125740730	MTSS1	177703	0.456576
chr8	125928360	125928395	DQ589437	35	0.514286
chr8	125934286	125934355	DQ572100	69	0.478261
chr8	125937529	125937561	DQ585837	32	0.437500
chr8	125940247	125940290	DQ601943	43	0.418605
chr8	125940317	125940380	DQ597408	63	0.428571
chr8	125940395	125940430	DQ589253	35	0.485714
chr8	125944825	125944854	DQ570460	29	0.482759
chr8	125949163	125949190	DQ581357	27	0.481481
chr8	125950896	125950926	DQ579449	30	0.533333
chr8	125951615	125951646	DQ583712	31	0.580645
chr8	125954249	125963337	LOC157381	9088	0.408891
chr8	125953392	125953948	DQ580489	556	0.417266
chr8	125955296	125955326	DQ573086	30	0.400000
chr8	125985538	125991630	ZNF572	6092	0.398555
chr8	126010719	126034525	SQLE	23806	0.376250
chr8	126036502	126104061	KIAA0196	67559	0.401353
chr8	126104082	126379367	NSMCE2	275285	0.398779
chr8	126442562	126450644	TRIB1	8082	0.513858
chr8	126913194	126913298	U6	104	0.423077
chr8	126953375	126963441	LINC00861	10066	0.389032
chr8	127564682	127570711	FAM84B	6029	0.506552
chr8	128025398	128033259	PCAT1	7861	0.396387
chr8	128197724	128200455	JX003871	2731	0.382278
chr8	128219628	128231333	CCAT1	11705	0.390944
chr8	128240803	128241377	BC106081	574	0.311847
chr8	128301928	128494384	LOC727677	192456	0.409787
chr8	128427856	128429441	POU5F1B	1585	0.543218
chr8	128428232	128428613	POU5F1P1	381	0.619423
chr8	128698587	128746211	BC042052	47624	0.435054
chr8	128748314	128753680	MYC	5366	0.535222
chr8	128750485	128750513	HV975509	28	0.750000
chr8	128902834	129113499	PVT1	210665	0.464026
chr8	128958804	128960969	TMEM75	2165	0.459584
chr8	128972878	128972941	MIR1205	63	0.523810
chr8	129021143	129021202	MIR1206	59	0.423729
chr8	129022627	129022857	U4	230	0.456522
chr8	129061397	129061484	MIR1207	87	0.620690
chr8	129162361	129162434	MIR1208	73	0.589041
chr8	129417515	129440162	BC009730	22647	0.391133
chr8	129571389	129573380	BC014119	1991	0.462079
chr8	130228712	130253486	LOC728724	24774	0.372689
chr8	130303228	130303521	7SK	293	0.498294
chr8	130363939	130365228	CCDC26	1289	0.354538
chr8	130760441	130799134	GSDMC	38693	0.393198
chr8	130851838	130952118	FAM49B	100280	0.382808
chr8	130880835	130880962	SNORA25	127	0.417323
chr8	131020579	131020699	MIR5194	120	0.450000
chr8	131064350	131455906	ASAP1	391556	0.421521
chr8	131094983	131097014	LOC100507117	2031	0.450025
chr8	131307600	131308779	ASAP1-IT1	1179	0.425785
chr8	131792546	132052835	ADCY8	260289	0.403936
chr8	132872694	132872961	7SK	267	0.445693
chr8	132916355	133025886	EFR3A	109531	0.353124
chr8	133036466	133071627	OC90	35161	0.452262
chr8	133073732	133117512	HHLA1	43780	0.428757
chr8	133133104	133493004	KCNQ3	359900	0.435427
chr8	133572744	133573726	HPYR1	982	0.462322
chr8	133584200	133687863	LRRC6	103663	0.390612
chr8	133722191	133772914	TMEM71	50723	0.398991
chr8	133787603	133861052	PHF20L1	73449	0.347683
chr8	133879204	134147143	TG	267939	0.458959
chr8	134048972	134072603	SLA	23631	0.471457
chr8	134203281	134243932	WISP1	40651	0.481169
chr8	134249413	134256746	NDRG1	7333	0.498841
chr8	134249413	134309547	NDRG1	60134	0.503808
chr8	134467090	134584183	ST3GAL1	117093	0.493958
chr8	135490030	135725292	ZFAT	235262	0.447875
chr8	135610313	135612932	ZFAT-AS1	2619	0.416571
chr8	135812762	135812850	MIR30B	88	0.431818
chr8	135817118	135817188	MIR30D	70	0.457143
chr8	136246373	136308995	LOC286094	62622	0.419900
chr8	136469715	136659848	KHDRBS3	190133	0.382448
chr8	136594120	136659848	KHDRBS3	65728	0.388039
chr8	136754585	136754738	U1	153	0.379085
chr8	139142265	139509065	FAM135B	366800	0.422988
chr8	139600477	139926236	COL22A1	325759	0.465086
chr8	140623579	140715299	KCNK9	91720	0.519669
chr8	140742585	141468678	TRAPPC9	726093	0.474928
chr8	141111256	141113775	AX748239	2519	0.442636
chr8	141521396	141527252	CHRAC1	5856	0.476264
chr8	141531042	141535875	DQ574852	4833	0.424788
chr8	141541263	141645646	AGO2	104383	0.518906
chr8	141668480	142011412	PTK2	342932	0.400024
chr8	142138719	142205900	DENND3	67181	0.512169
chr8	142220869	142238673	SLC45A4	17804	0.565322
chr8	142350647	142354720	LOC731779	4073	0.601522
chr8	142366586	142377365	GPR20	10779	0.617590
chr8	142432006	142441620	PTP4A3	9614	0.633347
chr8	142443928	142517330	MROH5	73402	0.513610
chr8	143257699	143257779	MIR4472-1	80	0.562500
chr8	143279716	143290364	LINC00051	10648	0.564801
chr8	143293440	143484543	TSNARE1	191103	0.556914
chr8	143545376	143626368	BAI1	80992	0.620913
chr8	143692404	143695833	ARC	3429	0.667542
chr8	143738873	143751401	JRK	12528	0.571839
chr8	143751725	143764145	PSCA	12420	0.560789
chr8	143760854	143763384	AX747544	2530	0.598814
chr8	143761873	143764145	PSCA	2272	0.635123
chr8	143781528	143785584	LY6K	4056	0.572978
chr8	143783669	143808391	LOC100288181	24722	0.443208
chr8	143808620	143818350	THEM6	9730	0.528571
chr8	143822361	143823829	SLURP1	1468	0.636240
chr8	143831627	143833952	LYPD2	2325	0.652473
chr8	143852614	143858744	LYNX1	6130	0.632626
chr8	143866297	143868008	LY6D	1711	0.620690
chr8	143916216	143928262	GML	12046	0.481073
chr8	143953772	143961236	CYP11B1	7464	0.583735
chr8	143991974	143999259	CYP11B2	7285	0.598902
chr8	144063447	144099807	LOC100133669	36360	0.490264
chr8	144077244	144079080	CDC42P3	1836	0.412309
chr8	144099901	144103827	LY6E	3926	0.633469
chr8	144120678	144135720	C8orf31	15042	0.542481
chr8	144239330	144241755	LY6H	2425	0.690309
chr8	144295067	144299044	GPIHBP1	3977	0.634398
chr8	144329097	144344875	ZFP41	15778	0.570541
chr8	144349606	144359101	GLI4	9495	0.640021
chr8	144373558	144382120	ZNF696	8562	0.554193
chr8	144391496	144417061	TOP1MT	25565	0.568707
chr8	144448792	144450805	RHPN1-AS1	2013	0.560358
chr8	144451024	144466390	RHPN1	15366	0.650007
chr8	144510229	144512602	MAFA	2373	0.653603
chr8	144519824	144623620	ZC3H3	103796	0.583799
chr8	144640476	144645231	GSDMD	4755	0.660778
chr8	144648362	144654928	MROH6	6566	0.670728
chr8	144656954	144660513	NAPRT1	3559	0.678561
chr8	144661866	144679845	EEF1D	17979	0.606763
chr8	144674958	144675116	BC034020	158	0.613924
chr8	144680073	144682485	TIGD5	2412	0.700663
chr8	144686082	144691784	PYCRL	5702	0.606103
chr8	144694787	144699732	TSTA3	4945	0.643074
chr8	144731953	144735900	ZNF623	3947	0.458069
chr8	144766621	144777555	ZNF707	10934	0.557253
chr8	144779284	144780583	BREA2	1299	0.581986
chr8	144788863	144790279	CCDC166	1416	0.718927
chr8	144798506	144804633	MAPK15	6127	0.647788
chr8	144806102	144815914	FAM83H	9812	0.648288
chr8	144815252	144815323	MIR4664	71	0.661972
chr8	144816309	144828507	LOC100128338	12198	0.602066
chr8	144824176	144828506	AX746851	4330	0.525635
chr8	144873089	144897549	SCRIB	24460	0.625020
chr8	144895126	144895212	MIR937	86	0.697674
chr8	144898513	144911556	PUF60	13043	0.618186
chr8	144915754	144923146	NRBP2	7392	0.611201
chr8	144939911	144947434	EPPK1	7523	0.639240
chr8	144989320	145025044	PLEC	35724	0.671425
chr8	145019358	145019447	MIR661	89	0.696629
chr8	145051319	145060635	PARP10	9316	0.585659
chr8	145064225	145067583	GRINA	3358	0.666766
chr8	145086581	145102015	SPATC1	15434	0.548594
chr8	145106166	145115584	OPLAH	9418	0.675515
chr8	145133521	145135551	EXOSC4	2030	0.586699
chr8	145137523	145141119	GPAA1	3596	0.642380
chr8	145149959	145152428	CYC1	2469	0.633455
chr8	145153535	145159140	SHARPIN	5605	0.590187
chr8	145159304	145162515	MAF1	3211	0.633759
chr8	145164237	145166389	KIAA1875	2152	0.677509
chr8	145167371	145173218	KIAA1875	5847	0.609714
chr8	145192671	145195620	FAM203A	2949	0.650051
chr8	145202918	145316843	MROH1	113925	0.531727
chr8	145317005	145331180	BOP1	14175	0.673792
chr8	145321516	145323045	SCXB	1529	0.682799
chr8	145437879	145440828	FAM203A	2949	0.650051
chr8	145474167	145485887	HEATR7A	11720	0.610239
chr8	145486055	145515120	BOP1	29065	0.624290
chr8	145490602	145492131	SCXB	1529	0.682799
chr8	145515269	145538385	HSF1	23116	0.568048
chr8	145538246	145550567	DGAT1	12321	0.629657
chr8	145554453	145559943	SCRT1	5490	0.668670
chr8	145576885	145578574	TMEM249	1689	0.681468
chr8	145579087	145582183	FBXL6	3096	0.653424
chr8	145582275	145584948	SLC52A2	2673	0.650580
chr8	145597730	145618453	ADCK5	20723	0.570622
chr8	145618445	145634733	CPSF1	16288	0.601117
chr8	145619363	145619445	MIR939	82	0.743902
chr8	145637797	145642273	SLC39A4	4476	0.682082
chr8	145648999	145653927	VPS28	4928	0.632305
chr8	145654162	145669812	TONSL	15650	0.628946
chr8	145660550	145665276	AK298596	4726	0.638172
chr8	145675314	145690479	CYHR1	15165	0.616485
chr8	145691737	145699499	KIFC2	7762	0.631281
chr8	145699114	145701718	FOXH1	2604	0.649770
chr8	145721843	145727504	PPP1R16A	5661	0.669493
chr8	145721000	145724363	AK094577	3363	0.650907
chr8	145729464	145732555	GPT	3091	0.688450
chr8	145734551	145736589	MFSD3	2038	0.668793
chr8	145736666	145743210	RECQL4	6544	0.654951
chr8	145743348	145750559	LRRC14	7211	0.632922
chr8	145743870	145743906	DQ579335	36	0.583333
chr8	145747760	145752416	LRRC24	4656	0.630799
chr8	145751602	145754458	C8orf82	2856	0.700280
chr8	145754562	145838888	ARHGAP39	84326	0.532303
chr8	145932591	145932618	DQ588968	27	0.518519
chr8	145946293	145980970	ZNF251	34677	0.472792
chr8	145998500	146012725	ZNF34	14225	0.497364
chr8	146015153	146017805	RPL8	2652	0.598793
chr8	146024260	146034529	ZNF517	10269	0.559840
chr8	146052902	146068606	ZNF7	15704	0.508214
chr8	146075550	146078451	COMMD5	2901	0.580489
chr8	146102335	146126846	ZNF250	24511	0.466158
chr8	146155743	146176274	ZNF16	20531	0.473917
chr8	146198974	146228285	ZNF252P	29311	0.416567
chr8	146220250	146224283	TMED10P1	4033	0.395487
chr8	146228196	146231432	ZNF252P-AS1	3236	0.486712
chr8	146277823	146281416	C8orf33	3593	0.511829
chr9	11986	14525	DDX11L5	2539	0.571879
chr9	14510	29739	WASH1	15229	0.540219
chr9	34393	35864	FAM138C	1471	0.507138
chr9	72697	75294	AY343892	2597	0.571429
chr9	100993	102941	AY343902	1948	0.475359
chr9	116230	118417	FOXD4	2187	0.597165
chr9	121037	179075	CBWD1	58038	0.362263
chr9	213107	215893	C9orf66	2786	0.521536
chr9	214864	465259	DOCK8	250395	0.415016
chr9	504694	746106	KANK1	241412	0.418724
chr9	841689	969090	DMRT1	127401	0.431598
chr9	976967	991732	DMRT3	14765	0.437183
chr9	1001857	1001963	U6	106	0.443396
chr9	1050619	1057554	DMRT2	6935	0.471521
chr9	2015341	2193623	SMARCA2	178282	0.405649
chr9	2422701	2622373	FLJ35024	199672	0.396585
chr9	2422701	2621413	FLJ35024	198712	0.394959
chr9	2621792	2654485	VLDLR	32693	0.424831
chr9	2717525	2730037	KCNV2	12512	0.418878
chr9	2804154	2844130	KIAA0020	39976	0.374325
chr9	3224646	3525983	RFX3	301337	0.350408
chr9	3479873	3481238	BC069756	1365	0.377289
chr9	3824127	4300035	GLIS3	475908	0.400205
chr9	3898645	3901248	GLIS3-AS1	2603	0.379946
chr9	4490426	4587469	SLC1A1	97043	0.421246
chr9	4598315	4666674	SPATA6L	68359	0.403210
chr9	4662293	4665272	PPAPDC2	2979	0.475999
chr9	4679565	4706594	CDC37L1	27029	0.371379
chr9	4709556	4741309	AK3	31753	0.408654
chr9	4792833	4861064	RCL1	68231	0.421480
chr9	4850296	4850375	MIR101-2	79	0.405063
chr9	4985244	5128183	JAK2	142939	0.374796
chr9	5163862	5185618	INSL6	21756	0.395293
chr9	5231418	5233967	INSL4	2549	0.399372
chr9	5299865	5304611	RLN2	4746	0.387695
chr9	5334931	5339873	RLN1	4942	0.389721
chr9	5357966	5437937	PLGRKT	79971	0.399007
chr9	5450502	5470567	CD274	20065	0.381510
chr9	5510544	5571282	PDCD1LG2	60738	0.405463
chr9	5629118	5776556	KIAA1432	147438	0.374496
chr9	5784571	5833081	ERMP1	48510	0.389363
chr9	5890908	5909822	MLANA	18914	0.416781
chr9	5919007	6008003	KIAA2026	88996	0.358522
chr9	6007825	6007904	MIR4665	79	0.772152
chr9	6011018	6015640	RANBP6	4622	0.391389
chr9	6215785	6257983	IL33	42198	0.377459
chr9	6328348	6330918	TPD52L3	2570	0.428016
chr9	6413150	6507051	UHRF2	93901	0.389900
chr9	6532463	6645692	GLDC	113229	0.442864
chr9	6757640	7175648	KDM4C	418008	0.398923
chr9	6834701	6835011	DQ580140	310	0.603226
chr9	7796490	7799799	C9orf123	3309	0.400121
chr9	8314245	10612723	PTPRD	2298478	0.355285
chr9	8858133	8861724	AK094342	3591	0.456419
chr9	8888135	8888207	SNORD27	72	0.347222
chr9	11754033	11754053	JB175300	20	0.300000
chr9	12693385	12710266	TYRP1	16881	0.344055
chr9	12775011	12823059	LURAP1L	48048	0.367279
chr9	13105702	13279563	MPDZ	173861	0.358056
chr9	13406378	13431328	FLJ41200	24950	0.370581
chr9	13927969	13945606	LINC00583	17637	0.376992
chr9	14081841	14314045	NFIB	232204	0.368383
chr9	14433937	14434009	TRNA	72	0.569444
chr9	14555480	14693480	ZDHHC21	138000	0.368014
chr9	14611068	14693480	ZDHHC21	82412	0.351878
chr9	14719731	14722715	CER1	2984	0.401810
chr9	14734663	14910993	FREM1	176330	0.393886
chr9	14987299	15146399	AK127963	159100	0.389629
chr9	14993324	15019722	LOC389705	26398	0.378930
chr9	15163621	15166031	AK021570	2410	0.342324
chr9	15170841	15307358	TTC39B	136517	0.402785
chr9	15422781	15461627	SNAPC3	38846	0.402924
chr9	15464064	15511003	PSIP1	46939	0.378683
chr9	15553096	15971897	CCDC171	418801	0.366981
chr9	15888034	15890767	BC042022	2733	0.364069
chr9	16203932	16253105	C9orf92	49173	0.434181
chr9	16216805	16219226	BX648501	2421	0.473358
chr9	16409500	16870786	BNC2	461286	0.388984
chr9	17135037	17503917	CNTLN	368880	0.364211
chr9	17578952	17797122	SH3GL2	218170	0.390008
chr9	18474078	18910947	ADAMTSL1	436869	0.393592
chr9	18573303	18573377	MIR3152	74	0.459459
chr9	18651144	18651448	7SK	304	0.440789
chr9	18927890	19033256	FAM154A	105366	0.426390
chr9	19049371	19051021	RRAGA	1650	0.519394
chr9	19053134	19102940	HAUS6	49806	0.396278
chr9	19063653	19063784	SCARNA8	131	0.473282
chr9	19115758	19127604	PLIN2	11846	0.448421
chr9	19129734	19149253	AK094196	19519	0.446591
chr9	19200876	19200903	DQ572382	27	0.518519
chr9	19230762	19374137	DENND4C	143375	0.386364
chr9	19376253	19380235	RPS6	3982	0.413611
chr9	19408924	19452500	ACER2	43576	0.434643
chr9	19507449	19787017	SLC24A2	279568	0.396755
chr9	20344967	20622514	MLLT3	277547	0.371577
chr9	20411145	20411236	MIR4473	91	0.472527
chr9	20418318	20418425	U4	107	0.429907
chr9	20502262	20502340	MIR4474	78	0.461538
chr9	20658308	20995954	FOCAD	337646	0.369245
chr9	20716103	20716187	MIR491	84	0.511905
chr9	20786925	20787054	SNORA30	129	0.534884
chr9	21006364	21031635	PTPLAD2	25271	0.370583
chr9	21077103	21077943	IFNB1	840	0.417857
chr9	21140630	21142144	IFNW1	1514	0.382431
chr9	21165635	21166659	IFNA21	1024	0.393555
chr9	21186617	21187598	IFNA4	981	0.413863
chr9	21201467	21202204	IFNA7	737	0.447761
chr9	21206179	21207142	IFNA10	963	0.411215
chr9	21216371	21217310	IFNA16	939	0.397231
chr9	21227241	21228221	IFNA17	980	0.403061
chr9	21239200	21239978	IFNA14	778	0.443445
chr9	21277686	21278562	IFNA22P	876	0.383562
chr9	21304612	21305312	IFNA5	700	0.462857
chr9	21331017	21335429	KLHL9	4412	0.408205
chr9	21350316	21350886	IFNA6	570	0.492982
chr9	21367370	21368075	IFNA13	705	0.489362
chr9	21384253	21385396	IFNA2	1143	0.398075
chr9	21409145	21410184	IFNA8	1039	0.406160
chr9	21440452	21441315	IFNA1	863	0.443801
chr9	21454266	21559697	MIR31HG	105431	0.375611
chr9	21480838	21482312	IFNE	1474	0.354817
chr9	21512113	21512184	MIR31	71	0.507042
chr9	21802634	21865969	MTAP	63335	0.417684
chr9	21967137	21967753	C9orf53	616	0.487013
chr9	21967750	21975132	CDKN2A	7382	0.468166
chr9	21967750	21994490	CDKN2A	26740	0.404936
chr9	21994789	22121093	CDKN2B-AS1	126304	0.387866
chr9	22002901	22009312	CDKN2B	6411	0.411012
chr9	22446839	22452472	DMRTA1	5633	0.400320
chr9	22646198	22824212	FLJ35282	178014	0.354461
chr9	23500688	23672385	CR627240	171697	0.397299
chr9	23690102	23826063	ELAVL2	135961	0.386125
chr9	23765006	23765097	Hel-N1	91	0.549451
chr9	24543212	24545674	IZUMO3	2462	0.402518
chr9	25330278	25330299	JA375049	21	0.238095
chr9	25375041	25399654	JA374875	24613	0.345346
chr9	25676386	25678856	TUSC1	2470	0.527125
chr9	25780053	25812966	BC043546	32913	0.368365
chr9	25889745	25889766	JA374875	21	0.333333
chr9	26066672	26118406	LOC100506422	51734	0.366625
chr9	26625555	26625584	DQ598339	29	0.482759
chr9	26632546	26632574	DQ591605	28	0.428571
chr9	26636781	26636812	DQ574229	31	0.483871
chr9	26641231	26641267	DQ599043	36	0.416667
chr9	26641827	26641886	DQ586829	59	0.576271
chr9	26642273	26642313	DQ571132	40	0.450000
chr9	26642853	26643938	DQ582785	1085	0.409217
chr9	26840682	26892826	CAAP1	52144	0.372430
chr9	26903367	26947468	PLAA	44101	0.380581
chr9	26956370	27062931	IFT74	106561	0.372885
chr9	26993134	27005691	LRRC19	12557	0.347376
chr9	27109146	27230172	TEK	121026	0.405491
chr9	27245681	27282791	LINC00032	37110	0.393614
chr9	27284653	27297137	EQTN	12484	0.372397
chr9	27325206	27529850	MOB3B	204644	0.418927
chr9	27374228	27378942	AK172755	4714	0.432329
chr9	27524311	27526496	IFNK	2185	0.387643
chr9	27546542	27573491	C9orf72	26949	0.355115
chr9	27937618	27944495	BX538226	6877	0.369929
chr9	27948083	29212998	LINGO2	1264915	0.357973
chr9	28863623	28863704	MIR876	81	0.370370
chr9	28888876	28888953	MIR873	77	0.467532
chr9	30388932	30408452	LOC401497	19520	0.321465
chr9	32384600	32450832	ACO1	66232	0.415766
chr9	32443796	32445852	AX747756	2056	0.398346
chr9	32455299	32526322	DDX58	71023	0.396167
chr9	32540541	32552626	TOPORS	12085	0.420770
chr9	32551714	32553015	TOPORS-AS1	1301	0.485012
chr9	32553523	32573182	NDUFB6	19659	0.413398
chr9	32629451	32635667	TAF1L	6216	0.466055
chr9	32633451	32648683	AX747113	15232	0.402967
chr9	32783496	32789199	TMEM215	5703	0.396809
chr9	32972603	33001639	APTX	29036	0.419996
chr9	33025208	33039062	DNAJA1	13854	0.415837
chr9	33041849	33076714	SMU1	34865	0.412276
chr9	33110638	33167356	B4GALT1	56718	0.469833
chr9	33174167	33174293	U4atac	126	0.444444
chr9	33240195	33248565	SPINK4	8370	0.492832
chr9	33252469	33264759	BAG1	12290	0.452563
chr9	33264876	33282067	CHMP5	17191	0.416497
chr9	33290417	33371155	NFX1	80738	0.425958
chr9	33384947	33402517	AQP7	17570	0.533523
chr9	33441151	33447631	AQP3	6480	0.556481
chr9	33461350	33473941	NOL6	12591	0.543960
chr9	33504534	33511164	SUGT1P1	6630	0.393665
chr9	33524410	33573001	ANKRD18B	48591	0.363792
chr9	33575759	33575789	DQ587539	30	0.566667
chr9	33576014	33576044	DQ590589	30	0.566667
chr9	33597856	33597885	DQ590442	29	0.551724
chr9	33598680	33598708	DQ596206	28	0.500000
chr9	33624222	33625532	ANXA2P2	1310	0.497710
chr9	33624287	33624316	DJ439583	29	0.517241
chr9	33624381	33624404	DJ439557	23	0.391304
chr9	33624901	33624924	DJ439530	23	0.521739
chr9	33625154	33625178	DJ439561	24	0.416667
chr9	33659003	33659034	DQ571524	31	0.451613
chr9	33673501	33677418	PTENP1	3917	0.415879
chr9	33750463	33799229	PRSS3	48766	0.428372
chr9	33817181	33920401	UBE2R2	103220	0.422447
chr9	33921690	34048947	UBAP2	127257	0.432621
chr9	33952761	33952852	SNORD121A	91	0.373626
chr9	34086380	34126771	DCAF12	40391	0.457602
chr9	34132719	34132746	DQ587955	27	0.592593
chr9	34132897	34132928	DQ597117	31	0.580645
chr9	34133316	34133352	DQ594696	36	0.472222
chr9	34133396	34133432	DQ585850	36	0.583333
chr9	34133755	34133782	DQ574810	27	0.592593
chr9	34179002	34252521	UBAP1	73519	0.428025
chr9	34252377	34329198	KIF24	76821	0.426120
chr9	34329503	34343711	NUDT2	14208	0.463753
chr9	34368906	34376894	KIAA1161	7988	0.561843
chr9	34379016	34397849	C9orf24	18833	0.451973
chr9	34398181	34458568	FAM219A	60387	0.471641
chr9	34458810	34520982	DNAI1	62172	0.474410
chr9	34478619	34478903	7SK	284	0.471831
chr9	34521039	34523037	ENHO	1998	0.628629
chr9	34551429	34589735	CNTFR	38306	0.560461
chr9	34568009	34583070	LOC415056	15061	0.563044
chr9	34610481	34612110	RPP25L	1629	0.588705
chr9	34613547	34620496	DCTN3	6949	0.498057
chr9	34621454	34628011	ARID3C	6557	0.556657
chr9	34634718	34637768	SIGMAR1	3050	0.569180
chr9	34646585	34650595	GALT	4010	0.548379
chr9	34652181	34661898	IL11RA	9717	0.541937
chr9	34661892	34662689	CCL27	797	0.533250
chr9	34689566	34691274	CCL19	1708	0.552693
chr9	34709001	34710164	CCL21	1163	0.589854
chr9	34723049	34729535	FAM205A	6486	0.500308
chr9	34830263	34838583	FAM205B	8320	0.485697
chr9	34958191	34982541	KIAA1045	24350	0.471417
chr9	34989637	34998430	DNAJB5	8793	0.556465
chr9	35042222	35045988	C9orf131	3766	0.535050
chr9	35056064	35072739	VCP	16675	0.476822
chr9	35073834	35080013	FANCG	6179	0.532449
chr9	35088684	35096546	PIGO	7862	0.533070
chr9	35099888	35103154	STOML2	3266	0.533680
chr9	35104117	35115893	FAM214B	11776	0.542884
chr9	35161988	35405332	UNC13B	243344	0.416287
chr9	35406751	35451105	ATP8B5P	44354	0.389322
chr9	35480463	35480492	DQ580826	29	0.413793
chr9	35490006	35561895	RUSC2	71889	0.442682
chr9	35561826	35563896	FAM166B	2070	0.552657
chr9	35605280	35610038	TESK1	4758	0.592686
chr9	35608090	35608156	MIR4667	66	0.560606
chr9	35609975	35618424	CD72	8449	0.517339
chr9	35649296	35650947	SIT1	1651	0.600848
chr9	35657747	35658015	RMRP	268	0.630597
chr9	35658286	35661500	CCDC107	3214	0.529247
chr9	35659340	35665278	ARHGEF39	5938	0.520377
chr9	35673914	35681154	CA9	7240	0.525276
chr9	35681989	35690053	TPM2	8064	0.549107
chr9	35697333	35732392	TLN1	35059	0.512080
chr9	35732316	35737005	CREB3	4689	0.490936
chr9	35736862	35749225	GBA2	12363	0.506997
chr9	35749276	35753264	RGP1	3988	0.538867
chr9	35752987	35754274	MSMP	1287	0.529915
chr9	35754030	35754060	DQ589555	30	0.533333
chr9	35792405	35809728	NPR2	17323	0.480113
chr9	35807781	35812259	SPAG8	4478	0.512282
chr9	35812956	35815042	HINT2	2086	0.547459
chr9	35817013	35828744	FAM221B	11731	0.488876
chr9	35829221	35854844	TMEM8B	25623	0.499902
chr9	35829494	35847232	TMEM8B	17738	0.510317
chr9	35860270	35865515	LINC00950	5245	0.493422
chr9	35869459	35870398	OR13J1	939	0.588924
chr9	35906188	35907138	HRCT1	950	0.609474
chr9	35909479	35911617	LOC158376	2138	0.540692
chr9	35957104	35958151	OR2S2	1047	0.528176
chr9	36036909	36124452	RECK	87543	0.392299
chr9	36136741	36163903	GLIPR2	27162	0.508505
chr9	36169388	36171331	CCIN	1943	0.525476
chr9	36190852	36212059	CLTA	21207	0.453577
chr9	36214438	36277053	GNE	62615	0.438202
chr9	36336398	36400296	RNF38	63898	0.386929
chr9	36572858	36677680	MELK	104822	0.419845
chr9	36823535	36823596	MIR4475	61	0.377049
chr9	36838530	37034476	PAX5	195946	0.492554
chr9	36864250	36864305	MIR4540	55	0.527273
chr9	36893458	36893528	MIR4476	70	0.542857
chr9	37079892	37090398	LOC100506710	10506	0.385208
chr9	37120468	37358145	ZCCHC7	237677	0.366266
chr9	37422706	37436986	GRHPR	14280	0.530252
chr9	37438099	37465407	ZBTB5	27308	0.442398
chr9	37485944	37503693	POLR1E	17749	0.462618
chr9	37505586	37510379	BC014180	4793	0.474233
chr9	37510888	37576250	FBXO10	65362	0.463985
chr9	37588411	37592636	TOMM5	4225	0.435266
chr9	37651051	37746901	FRMPD1	95850	0.441304
chr9	37753801	37778969	TRMT10B	25168	0.425580
chr9	37779710	37785089	EXOSC3	5379	0.414575
chr9	37789212	37800732	AK098263	11520	0.413542
chr9	37800789	37867665	DCAF10	66876	0.384428
chr9	37881889	37882757	BC062753	868	0.360599
chr9	37886104	37886139	DQ590189	35	0.542857
chr9	37887593	37904350	SLC25A51	16757	0.430566
chr9	37910720	37912138	BC021061	1418	0.497179
chr9	37915894	38069210	SHB	153316	0.509986
chr9	38392660	38398662	ALDH1B1	6002	0.514828
chr9	38406524	38424444	IGFBPL1	17920	0.492020
chr9	38571360	38620360	ANKRD18A	49000	0.367143
chr9	38546348	38546377	DQ596352	29	0.551724
chr9	38566269	38567982	DQ573539	1713	0.444834
chr9	38568366	38568396	DQ587539	30	0.566667
chr9	38568621	38568651	DQ590589	30	0.566667
chr9	38621084	38623277	FAM201A	2193	0.587779
chr9	38680002	38680101	U6	99	0.464646
chr9	39072763	39288300	CNTNAP3	215537	0.382357
chr9	39355698	39361959	SPATA31A2	6261	0.528829
chr9	39443817	39447188	ZNF658B	3371	0.396322
chr9	39884974	39891210	SPATA31A2	6236	0.530629
chr9	39900199	39907240	FAM74A1	7041	0.387303
chr9	40311209	40311239	DQ586551	30	0.566667
chr9	40498480	40633261	CNTNAP3B	134781	0.382866
chr9	40700290	40706537	SPATA31A3	6247	0.528734
chr9	40715523	40722679	FAM74A3	7156	0.388904
chr9	40771401	40792112	ZNF658	20711	0.394525
chr9	41321106	41327397	SPATA31A4	6291	0.528374
chr9	41500678	41506925	SPATA31A5	6247	0.528894
chr9	41516045	41522322	BC121813	6277	0.397801
chr9	41588836	41592207	ZNF658B	3371	0.396322
chr9	41952398	41955076	MGC21881	2678	0.486184
chr9	41963838	42019584	KGFLP2	55746	0.389571
chr9	42004535	42008563	LOC643648	4028	0.357746
chr9	42018943	42020413	LOC554249	1470	0.541497
chr9	42368302	42411863	ANKRD20A3	43561	0.360896
chr9	42435179	42435213	DQ573253	34	0.617647
chr9	42436794	42436827	DQ590943	33	0.575758
chr9	42436838	42436877	DQ588135	39	0.538462
chr9	42436920	42436949	DQ593719	29	0.551724
chr9	42437690	42437730	DQ587539	40	0.600000
chr9	42466316	42474238	FAM95B1	7922	0.536986
chr9	42500526	42506814	AK094644	6288	0.410305
chr9	42669320	42714593	CBWD5	45273	0.358536
chr9	42717233	42720342	FOXD4L2	3109	0.542297
chr9	42771707	42782614	AK310876	10907	0.392684
chr9	42844369	42859085	LOC286297	14716	0.459160
chr9	42858151	42893137	AQP7P3	34986	0.456440
chr9	42995102	43001391	AK094644	6289	0.409763
chr9	43027662	43035584	FAM95B1	7922	0.536733
chr9	43064171	43064211	DQ582260	40	0.600000
chr9	43064952	43064981	DQ579969	29	0.551724
chr9	43065024	43065063	DQ570938	39	0.538462
chr9	43065074	43065107	DQ581981	33	0.575758
chr9	43066688	43066722	DQ593430	34	0.617647
chr9	43089971	43133544	ANKRD20A3	43573	0.361072
chr9	43140536	43145484	LOC642929	4948	0.411479
chr9	43624501	43630730	SPATA31A6	6229	0.529298
chr9	43684884	43922473	CNTNAP3B	237589	0.382838
chr9	44021300	44021335	DQ574527	35	0.600000
chr9	44021363	44021391	DQ600788	28	0.428571
chr9	44023488	44023516	DQ586768	28	0.500000
chr9	44048006	44048046	DQ587539	40	0.600000
chr9	44049019	44049048	DQ579969	29	0.551724
chr9	44049098	44049130	DQ570938	32	0.500000
chr9	44387386	44391416	LOC643648	4030	0.357320
chr9	44990235	44991492	FAM27C	1257	0.592681
chr9	44997776	44999352	FAM27E3	1576	0.559645
chr9	45441936	45563563	LOC100132167	121627	0.336389
chr9	45727028	45728283	FAM27A	1255	0.592829
chr9	46686628	46688098	LOC554249	1470	0.541497
chr9	46687556	46746820	KGFLP1	59264	0.390018
chr9	46698573	46705305	AK126080	6732	0.350119
chr9	46829290	46833319	LOC643648	4029	0.357409
chr9	47297430	47314222	AL953854.2-002	16792	0.392866
chr9	65487272	65494386	FAM74A4	7114	0.388108
chr9	65503362	65509610	SPATA31A5	6248	0.527529
chr9	65647280	65664071	AL953854.2-002	16791	0.392829
chr9	66368737	66368772	DQ574527	35	0.600000
chr9	66368799	66368828	DQ600787	29	0.413793
chr9	66370925	66370953	DQ586768	28	0.500000
chr9	66395443	66395483	DQ587539	40	0.600000
chr9	66396456	66396485	DQ579969	29	0.551724
chr9	66396535	66396567	DQ570938	32	0.500000
chr9	66454656	66457142	AK308561	2486	0.578439
chr9	66457288	66469310	CR627148	12022	0.409915
chr9	66499190	66500030	X97876	840	0.542857
chr9	66513679	66553531	AK309896	39852	0.378726
chr9	66553275	66555595	BC000869	2320	0.485345
chr9	66688085	66699951	BC065763	11866	0.353278
chr9	66922966	66933829	AK310876	10863	0.394090
chr9	67017374	67032072	LOC286297	14698	0.459382
chr9	67270214	67289492	AQP7P1	19278	0.526818
chr9	67785048	67786625	FAM27E3	1577	0.561192
chr9	67792166	67794649	DQ594366	2483	0.586387
chr9	67792928	67794189	FAM27B	1261	0.592387
chr9	67926760	67970293	ANKRD20A3	43533	0.361013
chr9	68409997	68413434	AK308561	3437	0.576375
chr9	68413445	68414929	BC080605	1484	0.551887
chr9	68427782	68454375	LOC642236	26593	0.355996
chr9	68726540	68748372	LOC100132352	21832	0.364511
chr9	68743530	68769869	AK096159	26339	0.393105
chr9	68795666	68798213	AX747850	2547	0.418139
chr9	69065545	69106241	AK311167	40696	0.386524
chr9	69080243	69147854	PGM5P2	67611	0.385470
chr9	69174213	69181041	LOC440896	6828	0.513327
chr9	69199479	69202204	FOXD4L6	2725	0.559633
chr9	69204537	69262593	CBWD6	58056	0.358344
chr9	69379291	69380714	LOC441426	1423	0.426564
chr9	69381980	69425109	ANKRD20A4	43129	0.360778
chr9	69450467	69450499	DQ581988	32	0.500000
chr9	69450549	69450578	DQ593719	29	0.551724
chr9	69451319	69451359	DQ587539	40	0.600000
chr9	69451564	69451604	DQ582260	40	0.600000
chr9	69474939	69474967	DQ596206	28	0.500000
chr9	69476016	69481675	BC064148	5659	0.515462
chr9	69478752	69478779	DQ584320	27	0.518519
chr9	69478806	69478835	DQ593554	29	0.586207
chr9	69633348	69651314	BC070322	17966	0.526327
chr9	69651360	69664949	LOC100133920	13589	0.451394
chr9	69746916	69757784	AK310876	10868	0.394093
chr9	70175706	70178815	FOXD4L5	3109	0.542297
chr9	70181136	70195743	CBWD5	14607	0.348189
chr9	70364017	70374924	AK310876	10907	0.392684
chr9	70426622	70429731	FOXD4L2	3109	0.542297
chr9	70431999	70490177	CBWD3	58178	0.358366
chr9	70646052	70648956	AK056618	2904	0.631198
chr9	70856838	70914932	CBWD3	58094	0.358540
chr9	70917782	70920000	FOXD4L3	2218	0.573039
chr9	70970108	70972757	PGM5-AS1	2649	0.550774
chr9	70971814	71145977	PGM5	174163	0.400297
chr9	71150805	71154670	AK130904	3865	0.418370
chr9	71151497	71155783	TMEM252	4286	0.440504
chr9	71320329	71624092	PIP5K1B	303763	0.402175
chr9	71394963	71398609	FAM122A	3646	0.415798
chr9	71568003	71590757	AK057188	22754	0.403182
chr9	71627448	71629039	PRKACG	1591	0.571339
chr9	71650478	71693993	FXN	43515	0.462576
chr9	71820077	71870124	TJP2	50047	0.423462
chr9	71780234	71785971	AK096834	5737	0.445006
chr9	71911596	71921972	BANCR	10376	0.414514
chr9	71939487	72007370	FAM189A2	67883	0.408482
chr9	72042448	72287275	APBA1	244827	0.414468
chr9	72324437	72374876	PTAR1	50439	0.360257
chr9	72434320	72435583	BC039385	1263	0.469517
chr9	72435730	72521148	C9orf135	85418	0.390421
chr9	72658496	72841888	MAMDC2	183392	0.402433
chr9	72768049	72790804	LOC100507244	22755	0.386596
chr9	72784558	72790804	LOC100507244	6246	0.402177
chr9	72808913	72873782	LOC100507299	64869	0.395736
chr9	72830974	72873790	LOC100507299	42816	0.394245
chr9	72873877	72969789	SMC5	95912	0.363698
chr9	72935052	72937759	AX748336	2707	0.391577
chr9	72999512	73029573	KLF9	30061	0.439140
chr9	73149965	73736514	TRPM3	586549	0.387548
chr9	73424890	73425000	MIR204	110	0.481818
chr9	74298281	74383800	TMEM2	85519	0.395538
chr9	74477367	74526148	ABHD17B	48781	0.381583
chr9	74526422	74588371	C9orf85	61949	0.384720
chr9	74666296	74675521	C9orf57	9225	0.408022
chr9	74764266	74867140	GDA	102874	0.402696
chr9	74920351	74958126	AK095210	37775	0.409610
chr9	74966340	74980163	ZFAND5	13823	0.398973
chr9	75136716	75451267	TMC1	314551	0.392172
chr9	75515577	75568233	ALDH1A1	52656	0.361307
chr9	75766780	75785307	ANXA1	18527	0.346845
chr9	77112251	77302117	RORB	189866	0.377040
chr9	77337410	77502263	TRPM6	164853	0.399234
chr9	77414810	77415138	7SK	328	0.493902
chr9	77561498	77567802	C9orf40	6304	0.427030
chr9	77567884	77612302	BC043649	44418	0.385699
chr9	77597872	77643310	C9orf41	45438	0.378890
chr9	77676115	77703133	NMRK1	27018	0.406063
chr9	77703397	77762114	OSTF1	58717	0.402984
chr9	78118511	78338744	MIR548H3	220233	0.386450
chr9	78505559	78977255	PCSK5	471696	0.401403
chr9	79000432	79009444	RFK	9012	0.404350
chr9	79013514	79014954	RPSAP9	1440	0.452778
chr9	79074067	79122332	GCNT1	48265	0.423226
chr9	79226291	79521003	PRUNE2	294712	0.410390
chr9	79379353	79402465	PCA3	23112	0.409095
chr9	79634570	79635869	FOXB2	1299	0.694380
chr9	79791671	79792833	VPS13A-AS1	1162	0.651463
chr9	79792360	80032399	VPS13A	240039	0.358792
chr9	80037994	80263232	GNA14	225238	0.422056
chr9	80335190	80646219	GNAQ	311029	0.391738
chr9	80850990	80881983	CEP78	30993	0.372310
chr9	80912058	80945009	PSAT1	32951	0.455889
chr9	82186877	82341656	TLE4	154779	0.392721
chr9	82478897	82478939	DQ575560	42	0.523810
chr9	82479022	82479053	DQ583878	31	0.516129
chr9	82479147	82479179	DQ589820	32	0.593750
chr9	82479196	82479300	DQ580124	104	0.442308
chr9	82479444	82479479	DQ595182	35	0.542857
chr9	82479496	82479529	DQ596925	33	0.393939
chr9	82479564	82479595	DQ597713	31	0.516129
chr9	82479638	82479675	DQ586158	37	0.432432
chr9	82479836	82479872	DQ588659	36	0.638889
chr9	82479911	82479966	DQ599976	55	0.490909
chr9	82480085	82480149	DQ574305	64	0.515625
chr9	82480265	82480311	DQ600106	46	0.478261
chr9	82480444	82480513	DQ574306	69	0.463768
chr9	82480639	82480689	DQ599155	50	0.520000
chr9	82480842	82480885	DQ574330	43	0.441860
chr9	82481004	82481059	DQ579956	55	0.509091
chr9	82481263	82481303	DQ594965	40	0.325000
chr9	82481394	82481432	DQ596802	38	0.447368
chr9	82481509	82481544	DQ574826	35	0.428571
chr9	82481703	82481771	DQ592136	68	0.500000
chr9	82482216	82482251	DQ577348	35	0.457143
chr9	82482361	82482391	DQ593172	30	0.433333
chr9	82482630	82482673	DQ592375	43	0.511628
chr9	82483105	82483135	DQ570523	30	0.500000
chr9	82483941	82483980	DQ573195	39	0.589744
chr9	82973117	82973151	DQ591664	34	0.617647
chr9	84198597	84303596	TLE1	104999	0.432690
chr9	84304627	84391814	BC036431	87187	0.441018
chr9	84528351	84534842	SPATA31D5P	6491	0.460484
chr9	84531745	84531773	DQ592725	28	0.535714
chr9	84532087	84532118	DQ577940	31	0.516129
chr9	84533136	84533203	DQ578305	67	0.477612
chr9	84534683	84534718	DQ582032	35	0.457143
chr9	84535666	84535704	DQ584769	38	0.447368
chr9	84543342	84549913	SPATA31D4	6571	0.465987
chr9	84545140	84592004	AK097447	46864	0.430202
chr9	84547133	84547164	DQ577940	31	0.516129
chr9	84548208	84548275	DQ578305	67	0.477612
chr9	84549755	84549790	DQ582032	35	0.457143
chr9	84550738	84550776	DQ584769	38	0.447368
chr9	84558414	84565009	SPATA31D3	6595	0.464139
chr9	84562225	84562256	DQ577940	31	0.516129
chr9	84563300	84563367	DQ578305	67	0.477612
chr9	84603686	84610171	SPATA31D1	6485	0.473400
chr9	85045810	85045838	DQ588544	28	0.678571
chr9	85594499	85678043	RASEF	83544	0.399813
chr9	85859538	86153348	FRMD3	293810	0.415251
chr9	86237963	86259045	IDNK	21082	0.427663
chr9	86274877	86323168	UBQLN1	48291	0.387629
chr9	86323235	86328293	AK300656	5058	0.421510
chr9	86354335	86432752	GKAP1	78417	0.383667
chr9	86451614	86536380	KIF27	84766	0.383751
chr9	86553226	86571663	C9orf64	18437	0.444432
chr9	86582997	86595184	HNRNPK	12187	0.385000
chr9	86584662	86584772	MIR7-1	110	0.418182
chr9	86595636	86618987	RMI1	23351	0.386450
chr9	86678357	86709494	BX537783	31137	0.396313
chr9	86890764	86955694	SLC28A3	64930	0.425920
chr9	87283465	87638505	NTRK2	355040	0.409830
chr9	88161453	88356944	AGTPBP1	195491	0.366580
chr9	88420916	88457794	LOC389765	36878	0.372526
chr9	88459099	88464635	AK124523	5536	0.356575
chr9	88556056	88637217	NAA35	81161	0.378790
chr9	88641057	88714510	GOLM1	73453	0.452670
chr9	88835179	88874572	C9orf153	39393	0.416241
chr9	88879462	88897490	ISCA1	18028	0.407810
chr9	88902647	88969402	ZCCHC6	66755	0.379987
chr9	89559276	89562104	GAS1	2828	0.577086
chr9	89563612	89616948	LOC100506834	53336	0.394143
chr9	89623365	89657041	LOC440173	33676	0.397316
chr9	89698800	89700140	LOC494127	1340	0.536567
chr9	89763558	89774641	C9orf170	11083	0.433006
chr9	89834787	89880410	BC093087	45623	0.412292
chr9	90112755	90323549	DAPK1	210794	0.450819
chr9	90340973	90346384	CTSL1	5411	0.447792
chr9	90387829	90401799	CTSL3P	13970	0.414531
chr9	90459106	90459614	L25629	508	0.454724
chr9	90459659	90462339	CTSL1P8	2680	0.402985
chr9	90472957	90473971	LOC392364	1014	0.577909
chr9	90497771	90503814	SPATA31E1	6043	0.593414
chr9	90532876	90538572	SPATA31C1	5696	0.545646
chr9	90536996	90537026	DQ578031	30	0.500000
chr9	90540257	90540285	DQ586768	28	0.500000
chr9	90541079	90541108	DQ596352	29	0.551724
chr9	90581358	90589695	CDK20	8337	0.532446
chr9	90741687	90741716	DQ590442	29	0.551724
chr9	90742510	90742538	DQ596206	28	0.500000
chr9	90744219	90749900	SPATA31C2	5681	0.546383
chr9	90745765	90745795	DQ587746	30	0.500000
chr9	91003296	91093622	SPIN1	90326	0.412683
chr9	91150015	91159462	NXNL2	9447	0.509897
chr9	91261835	91267075	LOC286238	5240	0.405344
chr9	91360750	91360820	MIR4289	70	0.571429
chr9	91605777	91611057	C9orf47	5280	0.497348
chr9	91606323	91620069	S1PR3	13746	0.485887
chr9	91620685	91793682	SHC3	172997	0.427192
chr9	91926112	91931618	CKS2	5506	0.384308
chr9	91927139	91927221	MIR3153	82	0.402439
chr9	91933411	91974561	SECISBP2	41150	0.423597
chr9	91992151	92094611	SEMA4D	102460	0.511556
chr9	92219926	92221469	GADD45G	1543	0.662994
chr9	92254697	92334674	UNQ6494	79977	0.489028
chr9	92782935	92803781	LOC286370	20846	0.449535
chr9	92785722	92785817	MIR4290	95	0.547368
chr9	93224713	93345028	LOC340515	120315	0.389793
chr9	93346309	93346356	DQ584857	47	0.617021
chr9	93346637	93346676	DQ597036	39	0.512821
chr9	93347021	93347055	DQ601751	34	0.441176
chr9	93347144	93347171	DQ579694	27	0.629630
chr9	93347222	93347251	DQ585001	29	0.448276
chr9	93347322	93347364	DQ593488	42	0.476190
chr9	93372113	93405108	DIRAS2	32995	0.403425
chr9	93564011	93660842	SYK	96831	0.441790
chr9	93825575	93837414	LOC100129316	11839	0.497677
chr9	93922050	93927858	AK095132	5808	0.566804
chr9	93976096	94124206	AUH	148110	0.389116
chr9	94171326	94186144	NFIL3	14818	0.419287
chr9	94484877	94712444	ROR2	227567	0.466860
chr9	94398532	94398643	MIR3910-1	111	0.351351
chr9	94398548	94398627	MIR3910-2	79	0.329114
chr9	94793426	94877690	SPTLC1	84264	0.414922
chr9	94895115	94900911	LOC100128076	5796	0.592823
chr9	94903748	94921890	LINC00475	18142	0.476574
chr9	94972489	95056038	IARS	83549	0.412285
chr9	95054739	95054875	SNORA84	136	0.551471
chr9	95059639	95087876	NOL8	28237	0.388533
chr9	95087740	95377437	CENPP	289697	0.398413
chr9	95146248	95166937	OGN	20689	0.369858
chr9	95176526	95186836	OMD	10310	0.360524
chr9	95218488	95244844	ASPN	26356	0.383366
chr9	95257593	95298374	ECM2	40781	0.389471
chr9	95290265	95290340	MIR4670	75	0.453333
chr9	95375465	95432547	IPPK	57082	0.479310
chr9	95380331	95382817	LOC100128361	2486	0.522124
chr9	95393148	95395650	AX746834	2502	0.470424
chr9	95473644	95527083	BICD2	53439	0.513352
chr9	95571892	95588920	ANKRD19P	17028	0.365457
chr9	95592365	95592884	BC016143	519	0.493256
chr9	95607312	95640320	ZNF484	33008	0.392784
chr9	95656886	95656916	DQ573684	30	0.466667
chr9	95736717	95798518	FGD3	61801	0.491141
chr9	95820988	95847415	SUSD3	26427	0.522685
chr9	95858449	95875565	C9orf89	17116	0.500117
chr9	95883770	95896570	NINJ1	12800	0.596797
chr9	95947211	96082854	WNK2	135643	0.523647
chr9	96080480	96108696	C9orf129	28216	0.481358
chr9	96198878	96201027	BC039686	2149	0.377850
chr9	96208781	96215874	FAM120AOS	7093	0.508248
chr9	96209649	96209677	DQ594798	28	0.392857
chr9	96214172	96328397	FAM120A	114225	0.423401
chr9	96338908	96441869	PHF2	102961	0.514467
chr9	96581638	96581703	MIR4291	65	0.676923
chr9	96713908	96717608	BARX1	3700	0.659189
chr9	96727241	96727262	JB148981	21	0.619048
chr9	96846710	96872138	PTPDC1	25428	0.400661
chr9	96938235	96938715	JB153432	480	0.358333
chr9	96938238	96938269	DM119500	31	0.387097
chr9	96938634	96938656	DM119504	22	0.318182
chr9	96938851	96966848	MIRLET7DHG	27997	0.411687
chr9	96941115	96941202	MIRLET7D	87	0.482759
chr9	97021577	97065291	ZNF169	43714	0.415885
chr9	97080477	97090926	NUTM2F	10449	0.580917
chr9	97094757	97123230	LOC100132077	28473	0.448600
chr9	97136832	97223202	HIATL1	86370	0.406704
chr9	97317422	97330409	BC080653	12987	0.444136
chr9	97321002	97356075	FBP2	35073	0.452827
chr9	97365420	97401923	FBP1	36503	0.484727
chr9	97521930	97849500	C9orf3	327570	0.430812
chr9	97572243	97572339	MIR2278	96	0.583333
chr9	97781172	97784562	AL137535	3390	0.433038
chr9	97847489	97848370	MIR23B	881	0.535755
chr9	97848295	97848376	MIR3074	81	0.543210
chr9	97861335	98079991	FANCC	218656	0.413846
chr9	97884155	97886342	BC041030	2187	0.489255
chr9	98205263	98270831	PTCH1	65568	0.466859
chr9	98225890	98232301	LOC100507346	6411	0.453595
chr9	98568369	98638259	LINC00476	69890	0.411160
chr9	98637899	98731122	ERCC6L2	93223	0.359386
chr9	98680445	98680471	DQ588075	26	0.500000
chr9	98782013	98784037	LINC00092	2024	0.612648
chr9	98828120	98864194	LOC158435	36074	0.467400
chr9	98868942	98878693	LOC158434	9751	0.462722
chr9	98997588	99064434	HSD17B3	66846	0.432487
chr9	99082987	99145992	SLC35D2	63005	0.439203
chr9	99148224	99180669	ZNF367	32445	0.429065
chr9	99212413	99253618	HABP4	41205	0.438539
chr9	99262394	99382112	CDC14B	119718	0.419360
chr9	99403532	99417599	AAED1	14067	0.435843
chr9	99488102	99489749	LOC441455	1647	0.478446
chr9	99518146	99540328	ZNF510	22182	0.389235
chr9	99579272	99616389	ZNF782	37117	0.374033
chr9	99631181	99634510	LOC100132781	3329	0.351157
chr9	99671356	99672737	LOC441454	1381	0.417089
chr9	99691285	99701700	NUTM2G	10415	0.578877
chr9	99708326	99775862	HIATL2	67536	0.413024
chr9	99791958	99801592	CTSL2	9634	0.442080
chr9	99837952	99844227	LOC340508	6275	0.502789
chr9	99883187	99893292	AX747261	10105	0.432657
chr9	99895161	99895190	DQ586768	29	0.482759
chr9	99895406	99895435	DQ578098	29	0.620690
chr9	99915144	99915174	DQ587539	30	0.566667
chr9	99915399	99915429	DQ590589	30	0.566667
chr9	99916159	99916186	DQ579969	27	0.555556
chr9	99957619	99958989	BC070371	1370	0.354745
chr9	99958373	100000982	AK309476	42609	0.413363
chr9	99960465	99961852	ZNF322	1387	0.413122
chr9	100069909	100139577	CCDC180	69668	0.468178
chr9	100041643	100054275	LOC100499484	12632	0.394791
chr9	100153118	100158973	LOC286359	5855	0.520068
chr9	100174301	100258405	TDRD7	84104	0.388864
chr9	100263461	100364025	TMOD1	100564	0.467573
chr9	100362361	100395962	TSTD2	33601	0.425166
chr9	100395704	100436029	NCBP1	40325	0.379343
chr9	100437190	100459691	XPA	22501	0.388694
chr9	100440044	100441883	AX746764	1839	0.389886
chr9	100615536	100618997	FOXE1	3461	0.609073
chr9	100666771	100684852	C9orf156	18081	0.416957
chr9	100689072	100700675	HEMGN	11603	0.382229
chr9	100745488	100778224	ANP32B	32736	0.436767
chr9	100818958	100845365	NANS	26407	0.462870
chr9	100831568	100881488	TRIM14	49920	0.466767
chr9	100883256	100954956	CORO2A	71700	0.491715
chr9	100961279	101018003	TBC1D2	56724	0.489934
chr9	101050363	101471479	GABBR2	421116	0.456900
chr9	101494290	101558794	ANKS6	64504	0.467118
chr9	101569980	101612363	GALNT12	42383	0.454970
chr9	101705994	101833074	COL15A1	127080	0.469594
chr9	101867411	101916473	TGFBR1	49062	0.384941
chr9	101978706	101984246	ALG2	5540	0.427076
chr9	101984569	101992901	SEC61B	8332	0.419107
chr9	102117621	102137539	NAMA	19918	0.481374
chr9	102348067	102582171	AK057451	234104	0.381723
chr9	102584136	102629173	NR4A3	45037	0.429935
chr9	102648599	102668883	LOC441461	20284	0.401400
chr9	102668914	102736818	STX17	67904	0.363984
chr9	102741462	102861330	ERP44	119868	0.378583
chr9	102861501	103063426	INVS	201925	0.389273
chr9	103064356	103115259	TEX10	50903	0.379762
chr9	103115342	103156151	AK056351	40809	0.405989
chr9	103204187	103339918	MSANTD3-TMEFF1	135731	0.398973
chr9	103340335	103350173	MURC	9838	0.408010
chr9	103493782	103494070	DQ580140	288	0.590278
chr9	103791030	104087417	LPPR1	296387	0.385844
chr9	104122698	104145801	BAAT	23103	0.380557
chr9	104152248	104160919	MRPL50	8671	0.362703
chr9	104161135	104172942	ZNF189	11807	0.399255
chr9	104182841	104198062	ALDOB	15221	0.416595
chr9	104235441	104237132	AK094413	1691	0.408634
chr9	104237607	104249475	TMEM246	11868	0.450539
chr9	104296132	104325626	RNF20	29494	0.381739
chr9	104331633	104500862	GRIN3A	169229	0.385324
chr9	104353896	104357283	PPP3R2	3387	0.438736
chr9	105757592	105780770	CYLC2	23178	0.303693
chr9	105902805	106087312	BC035187	184507	0.357889
chr9	106856540	106903700	SMC2	47160	0.359775
chr9	107266543	107267503	OR13F1	960	0.463542
chr9	107288533	107289490	OR13C4	957	0.413793
chr9	107298050	107299094	OR13C3	1044	0.405172
chr9	107331448	107332411	OR13C8	963	0.440291
chr9	107360737	107361694	OR13C5	957	0.438871
chr9	107366951	107367908	OR13C2	957	0.442006
chr9	107379528	107380485	OR13C9	957	0.438871
chr9	107456702	107457743	OR13D1	1041	0.418828
chr9	107526450	107536291	NIPSNAP3B	9841	0.356265
chr9	107536632	107540045	LOC286367	3413	0.410782
chr9	107543283	107690527	ABCA1	147244	0.434225
chr9	107606050	107606603	ABCA1	553	0.448463
chr9	107689910	107692150	AK311445	2240	0.547768
chr9	107859036	107859342	7SK	306	0.503268
chr9	108006928	108153682	SLC44A1	146754	0.383969
chr9	108210314	108311385	FSD1L	101071	0.375083
chr9	108320410	108403399	FKTN	82989	0.374411
chr9	108424737	108425385	TAL2	648	0.521605
chr9	108456805	108538892	TMEM38B	82087	0.375346
chr9	108870331	109173664	BC039487	303333	0.375660
chr9	109213096	109367076	BC017988	153980	0.390590
chr9	109378338	109442079	AK093363	63741	0.395428
chr9	109625377	109773796	ZNF462	148419	0.401822
chr9	109653504	109848716	MIR548Q	195212	0.403315
chr9	109737113	109865269	AK097706	128156	0.405014
chr9	110045516	110094475	RAD23B	48959	0.379113
chr9	110247132	110252047	KLF4	4915	0.549339
chr9	111616868	111618275	ACTL7B	1407	0.634684
chr9	111624602	111626035	ACTL7A	1433	0.574320
chr9	111629799	111696608	IKBKAP	66809	0.399856
chr9	111696672	111703237	FAM206A	6565	0.401676
chr9	111704850	111775764	CTNNAL1	70914	0.390854
chr9	111777414	111882225	TMEM245	104811	0.395159
chr9	111808508	111808578	MIR32	70	0.385714
chr9	111892572	111894258	AL390170	1686	0.336299
chr9	111899580	111929571	FRRS1L	29991	0.432563
chr9	111921537	111922745	AX747119	1208	0.440397
chr9	111922745	111923757	AX747119	1012	0.475296
chr9	111934253	112083021	EPB41L4B	148768	0.451434
chr9	112137973	112260593	PTPN3	122620	0.453474
chr9	112542576	112934791	PALM2-AKAP2	392215	0.427980
chr9	112961845	112970413	C9orf152	8568	0.473740
chr9	113006091	113018920	TXN	12829	0.422792
chr9	113065866	113100125	TXNDC8	34259	0.399370
chr9	113127528	113342160	SVEP1	214632	0.378834
chr9	113131871	113131978	U6	107	0.411215
chr9	113301969	113302078	U6	109	0.394495
chr9	113431050	113563278	MUSK	132228	0.364393
chr9	113636053	113800365	LPAR1	164312	0.381475
chr9	114089762	114090713	OR2K2	951	0.450053
chr9	114122972	114247025	KIAA0368	124053	0.393332
chr9	114287446	114306712	ZNF483	19266	0.428527
chr9	114325246	114361711	PTGR1	36465	0.432086
chr9	114365110	114375833	LRRC37A5P	10723	0.452579
chr9	114393631	114416631	DNAJC25	23000	0.427391
chr9	114448900	114545779	C9orf84	96879	0.355392
chr9	114659205	114695433	UGCG	36228	0.404604
chr9	114694379	114694449	MIR4668	70	0.300000
chr9	114758831	115112545	MIR3134	353714	0.410450
chr9	114803060	114937556	SUSD1	134496	0.427492
chr9	114979994	115095944	PTBP3	115950	0.376956
chr9	115142188	115234685	HSDL2	92497	0.408197
chr9	115232002	115248956	AK131020	16954	0.420019
chr9	115249247	115422706	KIAA1958	173459	0.389049
chr9	115448790	115480387	INIP	31597	0.399690
chr9	115513133	115637267	SNX30	124134	0.441563
chr9	115641199	115653193	SLC46A2	11994	0.480740
chr9	115759399	115774472	ZNF883	15073	0.383401
chr9	115804173	115818996	ZFP37	14823	0.397625
chr9	115867002	115873957	FAM225B	6955	0.547088
chr9	115875175	115882126	FAM225A	6951	0.547691
chr9	115913237	115926422	SLC31A2	13185	0.480546
chr9	115927799	115983676	FKBP15	55877	0.408236
chr9	115983807	116026772	SLC31A1	42965	0.413057
chr9	116029289	116037869	CDC26	8580	0.428555
chr9	116037913	116055185	PRPF4	17272	0.424155
chr9	116059372	116061320	RNF183	1948	0.550821
chr9	116075501	116077893	WDR31	2392	0.487876
chr9	116077930	116102620	WDR31	24690	0.429040
chr9	116111811	116133513	BSPRY	21702	0.467791
chr9	116135697	116138341	HDHD3	2644	0.534039
chr9	116148591	116163618	ALAD	15027	0.514474
chr9	116169517	116173029	POLE3	3512	0.499431
chr9	116173021	116191879	C9orf43	18858	0.425549
chr9	116207008	116360023	RGS3	153015	0.487900
chr9	116638561	116818875	ZNF618	180314	0.456054
chr9	116822407	116840752	AMBP	18345	0.494413
chr9	116853917	116861337	KIF12	7420	0.589353
chr9	116918230	117072975	COL27A1	154745	0.522524
chr9	116971713	116971809	MIR455	96	0.541667
chr9	117085302	117088759	ORM1	3457	0.549899
chr9	117096432	117156685	AKNA	60253	0.506431
chr9	117164359	117267736	DFNB31	103377	0.483589
chr9	117349993	117361152	ATP6V1G1	11159	0.441437
chr9	117373705	117408703	C9orf91	34998	0.474656
chr9	117428713	117444369	LOC100505478	15656	0.432167
chr9	117546914	117568408	TNFSF15	21494	0.425607
chr9	117663424	117692875	TNFSF8	29451	0.423347
chr9	117781853	117880536	TNC	98683	0.418492
chr9	117904096	118164923	DEC1	260827	0.400039
chr9	118496670	118496770	U2	100	0.370000
chr9	118650543	118687377	LINC00474	36834	0.365369
chr9	118916070	119164600	PAPPA	248530	0.423506
chr9	119187503	120177317	ASTN2	989814	0.418388
chr9	119266561	119324572	LOC100128505	58011	0.408940
chr9	119449580	119463579	TRIM32	13999	0.433031
chr9	119943344	119943480	SNORA70C	136	0.500000
chr9	120039263	120039565	7SK	302	0.503311
chr9	120466452	120479769	TLR4	13317	0.384396
chr9	121928907	122131739	DBC1	202832	0.408550
chr9	123007256	123007328	MIR147A	72	0.416667
chr9	123117352	123117435	TRNA	83	0.626506
chr9	123151146	123342448	CDK5RAP2	191302	0.432097
chr9	123363195	123476765	MEGF9	113570	0.381888
chr9	123519253	123555740	FBXW2	36487	0.411818
chr9	123555774	123561009	LOC100288842	5235	0.421394
chr9	123578331	123605299	PSMD5	26968	0.406890
chr9	123605319	123616651	LOC253039	11332	0.445288
chr9	123617930	123639606	PHF19	21676	0.536354
chr9	123664670	123691451	TRAF1	26781	0.499459
chr9	123714613	123812554	C5	97941	0.380852
chr9	123850573	123939886	CNTRL	89313	0.384412
chr9	123940414	123964365	RAB14	23951	0.365162
chr9	124062078	124095120	GSN	33042	0.497912
chr9	124101265	124132582	STOM	31317	0.395664
chr9	124217318	124262306	GGTA1P	44988	0.472659
chr9	124329398	124547809	DAB2IP	218411	0.531402
chr9	124584203	124855885	TTLL11	271682	0.442341
chr9	124646914	124725998	BC039180	79084	0.445375
chr9	124882360	124882446	MIR4478	86	0.651163
chr9	124906337	124922098	NDUFA8	15761	0.415075
chr9	124922189	124962367	MORN5	40178	0.475708
chr9	124964855	124991091	LHX6	26236	0.540136
chr9	125001833	125027143	RBM18	25310	0.407783
chr9	125026881	125085742	MRRF	58861	0.409218
chr9	125133283	125157982	PTGS1	24699	0.499777
chr9	125273080	125274022	OR1J2	942	0.497877
chr9	125239236	125240205	OR1J1	969	0.494324
chr9	125281419	125282361	OR1J4	942	0.486200
chr9	125288636	125289572	OR1N1	936	0.503205
chr9	125315448	125316441	OR1N2	993	0.490433
chr9	125329826	125330756	OR1L8	930	0.478495
chr9	125377016	125377961	OR1Q1	945	0.492063
chr9	125390857	125391814	OR1B1	957	0.517241
chr9	125423994	125424927	OR1L1	933	0.437299
chr9	125437408	125438383	OR1L3	975	0.426667
chr9	125486268	125487204	OR1L4	936	0.487179
chr9	125512126	125513062	OR1L6	936	0.498932
chr9	125551211	125552174	OR5C1	963	0.586708
chr9	125562401	125563352	OR1K1	951	0.590957
chr9	125578330	125579531	BC010186	1201	0.485429
chr9	125580375	125590935	PDCL	10560	0.425000
chr9	125606834	125610773	AL833455	3939	0.347550
chr9	125611731	125667562	RC3H2	55831	0.410471
chr9	125642491	125642598	SNORD90	107	0.345794
chr9	125670334	125675607	ZBTB6	5273	0.367533
chr9	125680377	125693779	ZBTB26	13402	0.408372
chr9	125703287	125867147	RABGAP1	163860	0.384621
chr9	125795921	125797944	GPR21	2023	0.456253
chr9	125871772	125877756	MIR600HG	5984	0.539773
chr9	125878015	125878048	DQ582309	33	0.515152
chr9	125883907	126030855	STRBP	146948	0.382782
chr9	126118447	126141032	CRB2	22585	0.596369
chr9	126141932	126692417	DENND1A	550485	0.425143
chr9	126164803	126164882	MIR601	79	0.493671
chr9	126769855	126771627	AK131516	1772	0.589165
chr9	126773888	126795442	LHX2	21554	0.535724
chr9	127020195	127114719	NEK6	94524	0.549913
chr9	127115743	127177752	PSMB7	62009	0.428051
chr9	127115751	127121463	LOC100129034	5712	0.519783
chr9	127213422	127239379	GPR144	25957	0.546750
chr9	127243514	127269699	NR5A1	26185	0.603819
chr9	127284702	127533576	NR6A1	248874	0.405237
chr9	127420690	127422929	AB074162	2239	0.407771
chr9	127454720	127454830	MIR181A2	110	0.500000
chr9	127455988	127456077	MIR181B2	89	0.460674
chr9	127539436	127577159	OLFML2A	37723	0.521936
chr9	127615695	127620170	WDR38	4475	0.578547
chr9	127620157	127624240	RPL35	4083	0.561352
chr9	127631483	127639696	ARPC5L	8213	0.538658
chr9	127640572	127703386	GOLGA1	62814	0.447989
chr9	127704887	127905838	SCAI	200951	0.409488
chr9	127805167	127807307	AX748313	2140	0.540654
chr9	127908851	127952218	PPP6C	43367	0.423525
chr9	127962820	127996438	RABEPK	33618	0.464929
chr9	127997126	128003666	HSPA5	6540	0.441743
chr9	128061168	128127290	GAPVD1	66122	0.416170
chr9	128199672	128469513	MAPKAP1	269841	0.418191
chr9	128509616	128729655	PBX3	220039	0.372961
chr9	129032402	129038194	BC031239	5792	0.450967
chr9	129089122	129269320	MVB12B	180198	0.472286
chr9	129170053	129172783	NRON	2730	0.462271
chr9	129189171	129189249	SNORD116	78	0.435897
chr9	129376721	129463311	LMX1B	86590	0.561185
chr9	129565473	129567952	AX747444	2479	0.535700
chr9	129567284	129600487	ZBTB43	33203	0.418245
chr9	129622943	129648156	ZBTB34	25213	0.432356
chr9	129677052	129985445	RALGPS1	308393	0.464861
chr9	129849627	129885044	ANGPTL2	35417	0.498376
chr9	130026755	130155828	GARNL3	129073	0.429021
chr9	130159416	130170170	SLC2A8	10754	0.587967
chr9	130186652	130207651	ZNF79	20999	0.471499
chr9	130209952	130213711	RPL12	3759	0.513168
chr9	130210780	130210916	SNORA65	136	0.544118
chr9	130214533	130265780	LRSAM1	51247	0.512771
chr9	130254830	130256970	AX747547	2140	0.544393
chr9	130267617	130331355	FAM129B	63738	0.547272
chr9	130374485	130454995	STXBP1	80510	0.464750
chr9	130452965	130453074	MIR3911	109	0.550459
chr9	130476226	130479238	PTRH1	3012	0.636122
chr9	130469270	130476303	C9orf117	7033	0.557657
chr9	130478357	130493879	TTC16	15522	0.565005
chr9	130493802	130497628	TOR2A	3826	0.599582
chr9	130500595	130541048	SH2D3C	40453	0.539787
chr9	130548111	130548286	MIR3960	175	0.817143
chr9	130548304	130553052	CDK9	4748	0.557709
chr9	130565153	130576556	FPGS	11403	0.563711
chr9	130577290	130579336	ENG	2046	0.633431
chr9	130577290	130617052	ENG	39762	0.531865
chr9	130578344	130584799	AK057719	6455	0.551510
chr9	130628758	130640022	AK1	11264	0.601740
chr9	130631693	130631774	MIR4672	81	0.592593
chr9	130647600	130661871	ST6GALNAC6	14271	0.540747
chr9	130670164	130679305	ST6GALNAC4	9141	0.566021
chr9	130683807	130693076	PIP5KL1	9269	0.570504
chr9	130697373	130700763	DPM2	3390	0.567847
chr9	130702860	130742812	FAM102A	39952	0.556117
chr9	130823511	130829599	NAIF1	6088	0.542871
chr9	130830478	130871537	SLC25A25	41059	0.498965
chr9	130873449	130881013	LOC100289019	7564	0.549577
chr9	130882971	130890741	PTGES2	7770	0.595496
chr9	130890807	130892913	LOC389791	2106	0.537512
chr9	130911731	130915734	LCN2	4003	0.612790
chr9	130922538	130926207	C9orf16	3669	0.568820
chr9	130928343	130954383	CIZ1	26040	0.525038
chr9	130965662	131017527	DNM1	51865	0.551316
chr9	131006999	131007109	MIR199B	110	0.527273
chr9	131007225	131007309	MIR3154	84	0.678571
chr9	131012389	131012416	DQ575742	27	0.518519
chr9	131018107	131038268	GOLGA2	20161	0.523337
chr9	131019172	131019214	DQ571464	42	0.452381
chr9	131019986	131020006	JB175342	20	0.700000
chr9	131020148	131020176	DQ583972	28	0.535714
chr9	131022501	131022521	DQ583692	20	0.600000
chr9	131025453	131025482	DQ594309	29	0.448276
chr9	131038424	131051268	SWI5	12844	0.516428
chr9	131071395	131084697	TRUB2	13302	0.512705
chr9	131084790	131096351	COQ4	11561	0.516997
chr9	131102838	131123749	SLC27A4	20911	0.547415
chr9	131133597	131154295	URM1	20698	0.521161
chr9	131154896	131154993	MIR219-2	97	0.567010
chr9	131154899	131154987	MIR2964A	88	0.556818
chr9	131182758	131199630	CERCAM	16872	0.557136
chr9	131218284	131263571	ODF2	45287	0.489589
chr9	131247779	131250066	BC094874	2287	0.532138
chr9	131266970	131304580	GLE1	37610	0.452752
chr9	131306194	131306256	U7	62	0.354839
chr9	131314836	131395944	SPTAN1	81108	0.468191
chr9	131395939	131419129	WDR34	23190	0.538379
chr9	131447364	131458675	SET	11311	0.484042
chr9	131457267	131457421	Y16709	154	0.422078
chr9	131464801	131483199	PKN3	18398	0.576639
chr9	131483148	131486408	ZDHHC12	3260	0.614417
chr9	131486740	131495522	LOC100506100	8782	0.538374
chr9	131492066	131534213	ZER1	42147	0.512326
chr9	131549509	131572711	TBC1D13	23202	0.520516
chr9	131580778	131584955	ENDOG	4177	0.615514
chr9	131581929	131592100	C9orf114	10171	0.576148
chr9	131595391	131644354	CCBL1	48963	0.488267
chr9	131644390	131680317	LRRC8A	35927	0.538314
chr9	131684561	131704320	PHYHD1	19759	0.512728
chr9	131707808	131710012	DOLK	2204	0.578947
chr9	131709971	131769375	NUP188	59404	0.460710
chr9	131770312	131790579	SH3GLB2	20267	0.557655
chr9	131799252	131834351	FAM73B	35099	0.534859
chr9	131843382	131852717	DOLPP1	9335	0.577504
chr9	131857072	131873070	CRAT	15998	0.583448
chr9	131873592	131911225	PPP2R4	37633	0.525416
chr9	131937830	131940540	IER5L	2710	0.649815
chr9	131963593	131972862	AK308944	9269	0.548063
chr9	132083294	132084882	C9orf106	1588	0.610831
chr9	132098802	132100574	AX747401	1772	0.584086
chr9	132105694	132106909	BC094873	1215	0.585185
chr9	132250938	132275965	LOC100506190	25027	0.541735
chr9	132337687	132346835	BC037833	9148	0.539899
chr9	132374503	132383055	C9orf50	8552	0.556595
chr9	132388434	132397879	NTMT1	9445	0.545262
chr9	132396882	132404448	ASB6	7566	0.588422
chr9	132427919	132484951	PRRX2	57032	0.546921
chr9	132500614	132515344	PTGES	14730	0.522675
chr9	132565431	132573560	TOR1B	8129	0.504613
chr9	132575220	132586441	TOR1A	11221	0.521077
chr9	132589563	132597572	C9orf78	8009	0.461980
chr9	132597695	132644117	USP20	46422	0.519861
chr9	132649465	132805473	FNBP1	156008	0.437606
chr9	132815984	132902448	GPR107	86464	0.467004
chr9	132869966	132870598	AK026244	632	0.412975
chr9	132891931	132899179	GPR107	7248	0.511313
chr9	132902888	132906498	AK128673	3610	0.544321
chr9	132934856	132999583	NCS1	64727	0.547021
chr9	133261127	133294969	DKFZp434P0216	33842	0.545003
chr9	133305668	133309510	AK074396	3842	0.642894
chr9	133320093	133376661	ASS1	56568	0.557524
chr9	133452736	133454881	LOC100272217	2145	0.471329
chr9	133454959	133513739	FUBP3	58780	0.469564
chr9	133539980	133558384	PRDM12	18404	0.551837
chr9	133569157	133580452	EXOSC2	11295	0.476583
chr9	133589267	133763062	ABL1	173795	0.444754
chr9	133738695	133741134	AX748265	2439	0.470275
chr9	133768814	133769225	QRFP	411	0.644769
chr9	133777824	133814239	FIBCD1	36415	0.590416
chr9	133884503	133968446	LAMC3	83943	0.536340
chr9	133971862	133998539	AIF1L	26677	0.538141
chr9	134000980	134109091	NUP214	108111	0.420355
chr9	134133464	134151906	FAM78A	18442	0.538824
chr9	134165080	134184649	PPAPDC3	19569	0.545608
chr9	134305476	134375575	PRRC2B	70099	0.494643
chr9	134361051	134361137	SNORD62A	86	0.465116
chr9	134365872	134365958	SNORD62A	86	0.465116
chr9	134372865	134375578	LQFBS-1	2713	0.498710
chr9	134378288	134399193	POMT1	20905	0.533078
chr9	134399182	134406662	UCK1	7480	0.572727
chr9	134452156	134585229	RAPGEF1	133073	0.484997
chr9	134658034	134658055	DD413682	21	0.428571
chr9	134735496	134955274	MED27	219778	0.439980
chr9	135037333	135118220	NTNG2	80887	0.550360
chr9	135136826	135230372	SETX	93546	0.410066
chr9	135250936	135282238	TTF1	31302	0.448310
chr9	135285610	135448675	C9orf171	163065	0.491350
chr9	135457992	135465640	BARHL1	7648	0.583290
chr9	135469675	135545788	DDX31	76113	0.446849
chr9	135545727	135565470	GTF3C4	19743	0.427898
chr9	135600964	135754198	AK8	153234	0.479424
chr9	135754289	135765418	C9orf9	11129	0.523677
chr9	135766734	135820020	TSC1	53286	0.427767
chr9	135822455	135826942	AJ011378	4487	0.495654
chr9	135853893	135867084	GFI1B	13191	0.537639
chr9	135906061	135933890	GTF3C5	27829	0.518129
chr9	135937364	135947250	CEL	9886	0.592555
chr9	135957925	135962478	CELP	4553	0.564902
chr9	135973106	136004788	RALGDS	31682	0.590493
chr9	136080665	136084628	OBP2B	3963	0.639162
chr9	136130562	136150630	ABO	20068	0.488639
chr9	136197551	136203047	SURF6	5496	0.557132
chr9	136207754	136214972	MED22	7218	0.591854
chr9	136215068	136218280	RPL7A	3212	0.504359
chr9	136216250	136216325	SNORD24	75	0.373333
chr9	136216948	136217019	SNORD36B	71	0.366197
chr9	136217310	136217382	SNORD36A	72	0.402778
chr9	136217700	136217767	SNORD36C	67	0.402985
chr9	136218665	136223361	SURF1	4696	0.534284
chr9	136223420	136228040	SURF2	4620	0.595238
chr9	136228339	136242970	SURF4	14631	0.523136
chr9	136243283	136271220	C9orf96	27937	0.547088
chr9	136271185	136283164	REXO4	11979	0.516320
chr9	136287119	136324508	ADAMTS13	37389	0.558667
chr9	136325086	136335909	CACFD1	10823	0.580338
chr9	136336215	136344276	SLC2A6	8061	0.613075
chr9	136379707	136390068	TMEM8C	10361	0.575813
chr9	136399974	136440641	ADAMTSL2	40667	0.592643
chr9	136443536	136445368	FAM163B	1832	0.638646
chr9	136501484	136524466	DBH	22982	0.564659
chr9	136519708	136522530	DBH-AS1	2822	0.612332
chr9	136528683	136603479	SARDH	74796	0.562757
chr9	136627015	136857446	VAV2	230431	0.562784
chr9	136890560	136896719	LINC00094	6159	0.540347
chr9	136895445	136933141	BRD3	37696	0.573270
chr9	137001209	137025094	WDR5	23885	0.549257
chr9	137029561	137029686	RNU6ATAC	125	0.504000
chr9	137208943	137298240	RXRA	89297	0.621241
chr9	137218315	137332431	RXRA	114116	0.623252
chr9	137271256	137271318	MIR4669	62	0.629032
chr9	137533650	137736688	COL5A1	203038	0.559969
chr9	137711260	137764464	LOC101448202	53204	0.546557
chr9	137741020	137742490	MIR3689A	1470	0.580952
chr9	137741143	137741215	MIR3689C	72	0.527778
chr9	137741454	137741528	MIR3689D1	74	0.581081
chr9	137741970	137742118	MIR3689B	148	0.587838
chr9	137742122	137742202	MIR3689D2	80	0.575000
chr9	137742587	137742653	MIR3689F	66	0.560606
chr9	137772657	137779366	FCN2	6709	0.568192
chr9	137801430	137809806	FCN1	8376	0.563992
chr9	137967088	138013030	OLFM1	45942	0.553176
chr9	138073454	138079152	LOC401557	5698	0.548438
chr9	138235094	138238404	C9orf62	3310	0.578852
chr9	138354564	138364095	LOC100506599	9531	0.506662
chr9	138363010	138372564	AK096249	9554	0.558091
chr9	138371647	138380739	PPP1R26	9092	0.583700
chr9	138387025	138391761	C9orf116	4736	0.524916
chr9	138392476	138396519	MRPS2	4043	0.625031
chr9	138395118	138398293	BC015688	3175	0.611339
chr9	138413283	138418386	LCN1	5103	0.631981
chr9	138437984	138441815	OBP2A	3831	0.642913
chr9	138453603	138458622	PAEP	5019	0.579398
chr9	138466770	138478958	LOC100130954	12188	0.548080
chr9	138515501	138531386	GLT6D1	15885	0.416242
chr9	138555167	138557754	LCN9	2587	0.624275
chr9	138585254	138591374	SOHLH1	6120	0.620098
chr9	138585382	138585490	BC101937	108	0.638889
chr9	138594030	138684993	KCNT1	90963	0.617009
chr9	138700332	138799005	CAMSAP1	98673	0.468821
chr9	138824814	138853226	UBAC1	28412	0.518232
chr9	138898382	138987131	NACC2	88749	0.550046
chr9	139006426	139010731	C9orf69	4305	0.654123
chr9	139084422	139085482	RBSG2	1060	0.710377
chr9	139088095	139095004	LHX3	6909	0.648574
chr9	139098181	139137687	QSOX2	39506	0.545563
chr9	139216997	139221779	DKFZP434A062	4782	0.614806
chr9	139221931	139254057	GPSM1	32126	0.660431
chr9	139256351	139258263	DNLZ	1912	0.662657
chr9	139257440	139268133	CARD9	10693	0.647339
chr9	139270028	139292889	SNAPC4	22861	0.586195
chr9	139296373	139305054	SDCCAG3	8681	0.564912
chr9	139305115	139318213	PMPCA	13098	0.538021
chr9	139323066	139334256	INPP5E	11190	0.630295
chr9	139334547	139377507	SEC16A	42960	0.524651
chr9	139377946	139380519	C9orf163	2573	0.636222
chr9	139388895	139440238	NOTCH1	51343	0.633601
chr9	139414019	139414078	MIR4673	59	0.711864
chr9	139440624	139440711	MIR4674	87	0.827586
chr9	139442078	139444195	AX747706	2117	0.631082
chr9	139543061	139554873	AF161442	11812	0.582797
chr9	139560223	139567130	EGFL7	6907	0.677863
chr9	139565053	139565138	MIR126	85	0.529412
chr9	139567594	139581911	AGPAT2	14317	0.627157
chr9	139607023	139619170	FAM69B	12147	0.632090
chr9	139615817	139622636	SNHG7	6819	0.589383
chr9	139619683	139622636	SNHG7	2953	0.565865
chr9	139632618	139637414	LCN10	4796	0.628857
chr9	139638468	139642980	LCN6	4512	0.648493
chr9	139640612	139644363	LOC100128593	3751	0.634497
chr9	139648839	139652731	LCN8	3892	0.621274
chr9	139654085	139658965	LCN15	4880	0.622746
chr9	139685776	139687769	TMEM141	1993	0.623181
chr9	139690789	139702193	KIAA1984	11404	0.591722
chr9	139698378	139703300	KIAA1984-AS1	4922	0.646688
chr9	139702191	139735639	RABL6	33448	0.571962
chr9	139725408	139725475	MIR4292	67	0.701493
chr9	139738866	139741797	C9orf172	2931	0.740020
chr9	139743255	139745490	PHPT1	2235	0.667114
chr9	139746818	139755251	MAMDC4	8433	0.665955
chr9	139756570	139760738	EDF1	4168	0.577735
chr9	139780964	139821067	TRAF2	40103	0.548338
chr9	139781184	139781255	MIR4479	71	0.704225
chr9	139831621	139832440	BC034456	819	0.545788
chr9	139834884	139839206	FBXW5	4322	0.690421
chr9	139839697	139841426	C8G	1729	0.652979
chr9	139846771	139849949	LCN12	3178	0.650409
chr9	139871000	139876194	PTGDS	5194	0.668849
chr9	139877444	139880210	LCNL1	2766	0.640275
chr9	139886869	139888428	C9orf142	1559	0.648493
chr9	139889059	139891024	CLIC3	1965	0.684478
chr9	139901685	139922740	ABCA2	21055	0.664308
chr9	139921915	139931234	C9orf139	9319	0.649533
chr9	139924625	139927292	FUT7	2667	0.654668
chr9	139933908	139940676	NPDC1	6768	0.658983
chr9	139942550	139948503	ENTPD2	5953	0.657652
chr9	139956578	139965028	SAPCD2	8450	0.635976
chr9	139971952	139978990	UAP1L1	7038	0.615232
chr9	139979397	139981269	LOC100289341	1872	0.605769
chr9	139981378	140003639	MAN1B1	22261	0.548673
chr9	140004991	140009195	DPP7	4204	0.680542
chr9	140033608	140063214	GRIN1	29606	0.619976
chr9	140063211	140064491	LRRC26	1280	0.751562
chr9	140063637	140063722	MIR3621	85	0.729412
chr9	140069235	140083057	ANAPC2	13822	0.616915
chr9	140083053	140084822	SSNA1	1769	0.659129
chr9	140086068	140095163	TPRN	9095	0.655525
chr9	140098534	140100090	TMEM203	1556	0.567481
chr9	140100118	140113813	NDOR1	13695	0.605403
chr9	140114698	140115775	RNF208	1077	0.668524
chr9	140118566	140122265	AK128153	3699	0.627737
chr9	140119643	140120763	C9orf169	1120	0.651786
chr9	140122017	140124090	RNF224	2073	0.660878
chr9	140125384	140131006	SLC34A3	5622	0.669335
chr9	140135710	140138159	TUBB4B	2449	0.631686
chr9	140137295	140138007	TUBB2C	712	0.592697
chr9	140138036	140142222	FAM166A	4186	0.603679
chr9	140144670	140147949	LOC100129722	3279	0.653858
chr9	140145712	140147935	C9orf173	2223	0.659469
chr9	140149758	140168000	NELFB	18242	0.564631
chr9	140172279	140177093	TOR4A	4814	0.675322
chr9	140194082	140196703	NRARP	2621	0.590996
chr9	140201347	140317714	EXD3	116367	0.570110
chr9	140317846	140328858	NOXA1	11012	0.622594
chr9	140328815	140335901	ENTPD8	7086	0.669348
chr9	140342022	140353786	NSMF	11764	0.652244
chr9	140354404	140444986	PNPLA7	90582	0.548133
chr9	140446308	140447007	MRPL41	699	0.688126
chr9	140449360	140473387	WDR85	24027	0.529779
chr9	140458938	140473387	WDR85	14449	0.543913
chr9	140476530	140484937	ZMYND19	8407	0.579517
chr9	140500095	140509812	ARRDC1	9717	0.608727
chr9	140509783	140513308	C9orf37	3525	0.565390
chr9	140513443	140730578	EHMT1	217135	0.492892
chr9	140657473	140659224	FLJ40292	1751	0.525414
chr9	140732870	140732968	MIR602	98	0.693878
chr9	140762376	140787022	AK128414	24646	0.581636
chr9	140772240	141019076	CACNA1B	246836	0.499356
chr9	141044564	141071885	TUBBP5	27321	0.435196
chr9	141106636	141134172	FAM157B	27536	0.430890
chr9	141139789	141139819	DQ577244	30	0.333333
chrM	235	368	DQ582201	133	0.466165
chrM	650	674	JB137816	24	0.416667
chrM	1603	1634	DQ582265	31	0.451613
chrM	1843	4264	TVAS5	2421	0.448575
chrM	5543	5566	JA429830	23	0.434783
chrM	5585	5606	JA429831	21	0.523810
chrM	5690	5714	JB137814	24	0.416667
chrM	5904	7439	BC018860	1535	0.462541
chrM	7586	15888	JA760602	8302	0.442303
chrM	7586	9208	OK/SW-cl.16	1622	0.444513
chrM	8366	14149	JA760600	5783	0.438354
chrM	10059	10404	AD 1	345	0.405797
chrM	10470	12138	STRF6	1668	0.443046
chrM	12207	12264	DQ584698	57	0.456140
chrM	12907	14149	MTND5	1242	0.463768
chrM	14674	14698	DQ590013	24	0.500000
chrM	14856	15888	cytochrome b	1032	0.462209
chrM	15959	16024	tRNA Pro	65	0.338462
chrM	15998	16571	AF079515	573	0.462478
chrX	198060	220022	PLCXD1	21962	0.516255
chrX	221425	230887	GTPBP6	9462	0.559924
chrX	281384	282054	LINC00685	670	0.505970
chrX	294667	347690	PPP2R3B	53023	0.582841
chrX	585078	607558	SHOX	22480	0.533185
chrX	800013	800044	DQ576039	31	0.548387
chrX	1314886	1331529	CRLF2	16643	0.471249
chrX	1401570	1428828	CSF2RA	27258	0.518160
chrX	1412810	1412885	MIR3690	75	0.533333
chrX	1455508	1501582	IL3RA	46074	0.545427
chrX	1505044	1511039	SLC25A6	5995	0.573645
chrX	1519423	1534314	ASMTL-AS1	14891	0.529649
chrX	1522031	1571870	ASMTL	49839	0.519192
chrX	1581465	1656037	P2RY8	74572	0.482232
chrX	1710485	1721411	AKAP17A	10926	0.609098
chrX	1733940	1761974	ASMT	28034	0.520760
chrX	2137554	2419015	DHRSX	281461	0.469887
chrX	2404454	2418580	ZBED1	14126	0.486337
chrX	2527305	2575270	CD99P1	47965	0.433003
chrX	2531031	2533388	LINC00102	2357	0.396266
chrX	2609227	2659350	CD99	50123	0.473794
chrX	2670092	2734541	XG	64449	0.459821
chrX	2746862	2800861	GYG2	53999	0.436453
chrX	2822010	2847416	ARSD	25406	0.489018
chrX	2852672	2882494	ARSE	29822	0.463852
chrX	2924653	2951426	ARSH	26773	0.410787
chrX	2958274	3030770	ARSF	72496	0.408285
chrX	3189860	3202694	CXorf28	12834	0.399875
chrX	3226608	3264684	MXRA5	38076	0.431821
chrX	3522383	3631675	PRKX	109292	0.457490
chrX	3735575	3761935	LOC389906	26360	0.494347
chrX	3771064	3781615	AK000470	10551	0.442423
chrX	3782438	3799884	AK097803	17446	0.509630
chrX	3809488	3820041	AK000470	10553	0.442718
chrX	5808082	6146706	NLGN4X	338624	0.391109
chrX	6301946	6302004	MIR4770	58	0.448276
chrX	6451658	6453159	VCX3A	1501	0.574950
chrX	6966960	7066231	HDHD1	99271	0.437560
chrX	7065900	7065978	MIR4767	78	0.820513
chrX	7137471	7272682	STS	135211	0.407999
chrX	7810302	7812184	VCX	1882	0.565356
chrX	7866803	7895780	PNPLA4	28977	0.404286
chrX	8095005	8095102	MIR651	97	0.298969
chrX	8137984	8139308	VCX2	1324	0.571752
chrX	8432870	8434551	VCX3B	1681	0.572278
chrX	8496914	8700227	KAL1	203313	0.395941
chrX	8758836	8769424	FAM9A	10588	0.432282
chrX	8993036	9001116	FAM9B	8080	0.363490
chrX	9373384	9373450	DQ595787	66	0.484848
chrX	9374425	9374460	DQ597811	35	0.485714
chrX	9374468	9374497	DQ595787	29	0.379310
chrX	9375360	9375426	DQ595787	66	0.484848
chrX	9375782	9375838	DQ580770	56	0.500000
chrX	9376291	9376357	DQ595787	66	0.484848
chrX	9376739	9376777	DQ580770	38	0.473684
chrX	9377218	9377253	DQ597811	35	0.485714
chrX	9377261	9377290	DQ595787	29	0.379310
chrX	9377644	9377700	DQ580770	56	0.500000
chrX	9378153	9378219	DQ595787	66	0.484848
chrX	9379198	9379264	DQ595787	66	0.484848
chrX	9379647	9379684	DQ580770	37	0.486486
chrX	9380130	9380196	DQ595787	66	0.484848
chrX	9380565	9380608	DQ580770	43	0.488372
chrX	9381175	9381241	DQ595787	66	0.484848
chrX	9382216	9382251	DQ597811	35	0.485714
chrX	9382259	9382288	DQ595787	29	0.379310
chrX	9433200	9687780	TBL1X	254580	0.451194
chrX	9693452	9734005	GPR143	40553	0.467610
chrX	9754495	9917481	SHROOM2	162986	0.474268
chrX	9935397	9936042	LOC100288814	645	0.483721
chrX	9983794	10112518	WWC3	128724	0.461499
chrX	10124984	10205699	CLCN4	80715	0.452394
chrX	10413349	10851809	MID1	438460	0.348045
chrX	10466857	10468872	MID1	2015	0.337469
chrX	10550856	10550959	U6	103	0.368932
chrX	10988010	11129258	AY660578	141248	0.383213
chrX	11129405	11141204	HCCS	11799	0.429697
chrX	11155662	11683821	ARHGAP6	528159	0.391075
chrX	11311532	11318881	AMELX	7349	0.383726
chrX	11776277	11793872	MSL3	17595	0.428474
chrX	12156584	12742642	FRMPD4	586058	0.391925
chrX	12809473	12842346	PRPS2	32873	0.427555
chrX	12885201	12908480	TLR7	23279	0.402552
chrX	12920935	12961419	TLR8-AS1	40484	0.412978
chrX	12924738	12941288	TLR8	16550	0.413172
chrX	12993225	12995346	TMSB4X	2121	0.504951
chrX	13053735	13062917	FAM9C	9182	0.398279
chrX	13328770	13338052	LOC100093698	9282	0.433312
chrX	13336767	13338518	ATXN3L	1751	0.390063
chrX	13353359	13359944	LOC100133123	6585	0.413819
chrX	13587693	13651694	EGFL6	64001	0.409525
chrX	13614354	13614667	7SK	313	0.482428
chrX	13671306	13682247	TCEANC	10941	0.401974
chrX	13707239	13727944	RAB9A	20705	0.418208
chrX	13730360	13752754	TRAPPC2	22394	0.421765
chrX	13752831	13787480	OFD1	34649	0.398049
chrX	13789061	13835314	GPM6B	46253	0.416535
chrX	14024844	14048035	GEMIN8	23191	0.411022
chrX	14547419	14749933	GLRA2	202514	0.376794
chrX	14861528	14891184	FANCB	29656	0.345630
chrX	14891526	14939459	MOSPD2	47933	0.362256
chrX	15262108	15288293	ASB9	26185	0.427649
chrX	15299830	15333746	ASB11	33916	0.415704
chrX	15337572	15353676	PIGA	16104	0.395243
chrX	15363712	15402535	FIGF	38823	0.393040
chrX	15402923	15511711	PIR	108788	0.389859
chrX	15518899	15574652	BMX	55753	0.385916
chrX	15579155	15620192	ACE2	41037	0.383922
chrX	15645440	15683154	TMEM27	37714	0.399613
chrX	15693038	15721474	CA5BP1	28436	0.427486
chrX	15756411	15805748	CA5B	49337	0.424104
chrX	15803838	15805712	INE2	1874	0.441302
chrX	15808573	15841382	ZRSR2	32809	0.415160
chrX	15843928	15873137	AP1S2	29209	0.367729
chrX	16141423	16171641	GRPR	30218	0.388444
chrX	16185603	16189516	MAGEB17	3913	0.577051
chrX	16606121	16731059	CTPS2	124938	0.435112
chrX	16668280	16672791	S100G	4511	0.423188
chrX	16737706	16780807	SYAP1	43101	0.436974
chrX	16804554	16862642	TXLNG	58088	0.429314
chrX	16862774	16887978	RBBP7	25204	0.414260
chrX	16893268	16893390	U4	122	0.442623
chrX	16964813	17171403	REPS2	206590	0.409400
chrX	17393542	17754113	NHS	360571	0.423356
chrX	17444003	17444077	MIR4768	74	0.432432
chrX	17755591	17773105	SCML1	17514	0.388603
chrX	17818168	17879457	RAI2	61289	0.456101
chrX	18181050	18239024	BEND2	57974	0.401214
chrX	18257432	18372844	SCML2	115412	0.395695
chrX	18443724	18671749	CDKL5	228025	0.402083
chrX	18657807	18690223	RS1	32416	0.478961
chrX	18709044	18846034	PPEF1	136990	0.411921
chrX	18908413	18913093	PHKA2-AS1	4680	0.527564
chrX	18910415	19002480	PHKA2	92065	0.456808
chrX	19007424	19140755	GPR64	133331	0.429615
chrX	19362010	19379825	PDHA1	17815	0.444457
chrX	19378175	19533379	MAP3K15	155204	0.442128
chrX	19552082	19905744	SH3KBP1	353662	0.430541
chrX	19930979	19988382	CXorf23	57403	0.395537
chrX	20004934	20007897	LOC729609	2963	0.423895
chrX	20024830	20135114	MAP7D2	110284	0.444589
chrX	20035205	20035305	MIR23C	100	0.450000
chrX	20142635	20159966	EIF1AX	17331	0.385840
chrX	20154183	20154531	SCARNA9L	348	0.422414
chrX	20168028	20284750	RPS6KA3	116722	0.374060
chrX	20470225	20470549	7SK	324	0.432099
chrX	21392535	21672813	CNKSR2	280278	0.349649
chrX	21671685	21671755	JA611288	70	0.357143
chrX	21673608	21676448	KLHL34	2840	0.647887
chrX	21724089	21776278	SMPX	52189	0.401502
chrX	21857655	21903541	MBTPS2	45886	0.385368
chrX	21874104	21876845	YY2	2741	0.460416
chrX	21958690	22012955	SMS	54265	0.434755
chrX	22050920	22266478	PHEX	215558	0.402142
chrX	22180848	22191100	PHEX-AS1	10252	0.390851
chrX	22277913	23311263	LOC100873065	1033350	0.376637
chrX	22291029	22292576	ZNF645	1547	0.420168
chrX	23018077	23020206	DDX53	2129	0.412400
chrX	23352984	23414918	PTCHD1	61934	0.412681
chrX	23685644	23704514	PRDX4	18870	0.393853
chrX	23721776	23761407	ACOT9	39631	0.441220
chrX	23801274	23804327	SAT1	3053	0.437602
chrX	23851464	23926057	APOO	74593	0.432681
chrX	23854760	23855459	RPL9	699	0.426323
chrX	23926122	23957624	CXorf58	31502	0.417497
chrX	24001832	24045303	KLHL15	43471	0.418463
chrX	24073064	24096927	EIF2S3	23863	0.413527
chrX	24164341	24167771	ZFX-AS1	3430	0.432070
chrX	24167761	24234372	ZFX	66611	0.405098
chrX	24328978	24331432	SUPT20HL2	2454	0.547677
chrX	24380877	24383541	SUPT20HL1	2664	0.548799
chrX	24483343	24568583	PDK3	85240	0.408001
chrX	24576203	24665455	PCYT1B	89252	0.424629
chrX	24712063	25015102	POLA1	303039	0.387963
chrX	24762557	24762687	SCARNA23	130	0.346154
chrX	25021812	25034065	ARX	12253	0.544275
chrX	26156459	26158853	MAGEB18	2394	0.439014
chrX	26210556	26213763	MAGEB6	3207	0.484565
chrX	26234285	26236387	MAGEB5	2102	0.460990
chrX	26576453	26579169	VENTXP1	2716	0.395066
chrX	27193032	27417114	BC024027	224082	0.356753
chrX	27478327	27481458	SMEK3P	3131	0.377196
chrX	27608529	27651912	AK057304	43383	0.357629
chrX	27764925	27766938	DCAF8L2	2013	0.507700
chrX	27826106	27841131	MAGEB10	15025	0.473544
chrX	27996109	27999566	DCAF8L1	3457	0.417703
chrX	28605680	29974017	IL1RAPL1	1368337	0.361562
chrX	29769566	29769659	U2	93	0.344086
chrX	30233674	30238206	MAGEB2	4532	0.491174
chrX	30248552	30255610	MAGEB3	7058	0.498583
chrX	30260056	30262308	MAGEB4	2252	0.430728
chrX	30265270	30270155	MAGEB1	4885	0.503378
chrX	30322538	30327495	NR0B1	4957	0.463183
chrX	30576940	30596033	CXorf21	19093	0.393705
chrX	30671475	30749577	GK	78102	0.386328
chrX	30845558	30907511	TAB3	61953	0.374768
chrX	31089357	31090170	FTHL17	813	0.591636
chrX	31137344	33229673	DMD	2092329	0.364854
chrX	31190482	31190525	JA783858	43	0.325581
chrX	31191693	31191729	JA783854	36	0.583333
chrX	31196048	31196090	JA783850	42	0.500000
chrX	31196874	31196929	JA783844	55	0.381818
chrX	31200973	31201000	JA783836	27	0.592593
chrX	31224756	31224792	JA783436	36	0.555556
chrX	31241164	31241196	JA783435	32	0.531250
chrX	31279071	31279123	JA783822	52	0.461538
chrX	31341723	31341780	JA783813	57	0.578947
chrX	31366308	31366414	U6	106	0.349057
chrX	31366706	31366747	JA783807	41	0.658537
chrX	31462639	31462708	JA783798	69	0.536232
chrX	31496286	31496341	JA783787	55	0.600000
chrX	31496366	31496396	JA783430	30	0.466667
chrX	31496475	31496497	JA783782	22	0.500000
chrX	31515037	31515073	JA783775	36	0.444444
chrX	31525427	31525469	JA783425	42	0.404762
chrX	31645808	31645848	JA783760	40	0.450000
chrX	31676164	31676195	JA783753	31	0.451613
chrX	31697634	31697671	JA783474	37	0.486486
chrX	31697688	31697750	JA783728	62	0.258065
chrX	31747824	31747859	JA783720	35	0.542857
chrX	31792209	31792253	JA783708	44	0.431818
chrX	31792299	31792331	JA783704	32	0.343750
chrX	31838122	31838191	JA783690	69	0.521739
chrX	31893462	31893498	JA783679	36	0.444444
chrX	31947759	31947795	JA783673	36	0.500000
chrX	31947833	31947869	JA783672	36	0.555556
chrX	31950208	31950289	JA783658	81	0.395062
chrX	31986436	31986471	JA783654	35	0.428571
chrX	31986606	31986640	JA783645	34	0.529412
chrX	32235088	32235122	JA783622	34	0.411765
chrX	32235160	32235189	JA783620	29	0.482759
chrX	32305698	32305730	JA783612	32	0.531250
chrX	32364106	32364140	JA783603	34	0.411765
chrX	32364174	32364203	JA783602	29	0.413793
chrX	32382749	32382818	JA783589	69	0.420290
chrX	32383263	32383303	JA783587	40	0.425000
chrX	32398676	32398705	JA202330	29	0.344828
chrX	32398725	32398757	JA783579	32	0.437500
chrX	32408163	32408193	JA783574	30	0.333333
chrX	32472915	32472956	JA783566	41	0.536585
chrX	32482743	32482766	JA783415	23	0.608696
chrX	32486729	32486759	JA783560	30	0.533333
chrX	32490280	32490302	JA783414	22	0.590909
chrX	32503097	32503131	JA202295	34	0.529412
chrX	32563365	32563401	JA783548	36	0.444444
chrX	32563416	32563458	JA783867	42	0.523810
chrX	32583973	32584010	JA202335	37	0.297297
chrX	32632483	32632519	JA783409	36	0.361111
chrX	32662291	32662321	JA783536	30	0.333333
chrX	32662333	32662381	JA783533	48	0.354167
chrX	32717390	32717417	JA783516	27	0.407407
chrX	32827657	32827688	JA783513	31	0.483871
chrX	32834568	32834591	JA783507	23	0.347826
chrX	32834661	32834692	JA202257	31	0.451613
chrX	32862888	32862913	JA783500	25	0.320000
chrX	32862937	32862967	JA783498	30	0.466667
chrX	32867872	32867918	JA783489	46	0.565217
chrX	33038257	33038311	JA783482	54	0.296296
chrX	34147868	34150447	FAM47A	2579	0.540907
chrX	34645180	34675405	TMEM47	30225	0.369892
chrX	34960912	34963034	FAM47B	2122	0.535344
chrX	35816458	35821852	MAGEB16	5394	0.483129
chrX	35937850	36008269	CXorf22	70419	0.357986
chrX	36065052	36163187	CHDC2	98135	0.351913
chrX	36246895	36403434	CXorf30	156539	0.349958
chrX	37026431	37029739	FAM47C	3308	0.571644
chrX	37060954	37061867	FTH1P18	913	0.623220
chrX	37208527	37316548	PRRG1	108021	0.379204
chrX	37430821	37536750	LANCL3	105929	0.390979
chrX	37478968	37480588	BC132858	1620	0.433333
chrX	37545132	37591383	XK	46251	0.394370
chrX	37639269	37672714	CYBB	33445	0.373270
chrX	37698088	37706889	DYNLT3	8801	0.370185
chrX	37850069	37850570	CXorf27	501	0.481038
chrX	37892786	37988073	SYTL5	95287	0.377250
chrX	38008587	38080177	SRPX	71590	0.414820
chrX	38143701	38186788	RPGR	43087	0.377794
chrX	38211735	38280703	OTC	68968	0.393095
chrX	38420730	38548172	TSPAN7	127442	0.395639
chrX	38660684	38665783	MID1IP1	5099	0.538537
chrX	39164209	39186616	LOC286442	22407	0.434507
chrX	39868528	39871435	AK123758	2907	0.564499
chrX	39910498	39956719	BCOR	46221	0.516324
chrX	40217979	40218014	DQ596633	35	0.600000
chrX	40218597	40218633	DQ594696	36	0.472222
chrX	40219039	40219066	DQ574810	27	0.592593
chrX	40219847	40219877	DQ579129	30	0.433333
chrX	40440215	40465888	ATP6AP2	25673	0.414872
chrX	40482817	40483388	MPC1L	571	0.555166
chrX	40486172	40506819	CXorf38	20647	0.452124
chrX	40508794	40594804	MED14	86010	0.388187
chrX	40594651	40597946	BC039399	3295	0.456449
chrX	40671202	40704710	AK056524	33508	0.439029
chrX	40690469	40692449	LOC100132831	1980	0.592424
chrX	40944887	41095832	USP9X	150945	0.384961
chrX	41192650	41209524	DDX3X	16874	0.410098
chrX	41306712	41334905	NYX	28193	0.469514
chrX	41374188	41782287	CASK	408099	0.386855
chrX	41548225	41556530	GPR34	8305	0.383504
chrX	41583407	41589388	GPR82	5981	0.351948
chrX	41778506	41778602	U6	96	0.447917
chrX	42636616	42637486	PPP1R2P9	870	0.505747
chrX	42729652	42729672	DD413549	20	0.300000
chrX	43036242	43085847	AK056105	49605	0.383127
chrX	43137548	43137585	DQ570500	37	0.540541
chrX	43514154	43606071	MAOA	91917	0.402700
chrX	43625856	43741721	MAOB	115865	0.393225
chrX	43808023	43832921	NDP	24898	0.423247
chrX	44007127	44202923	EFHC2	195796	0.399232
chrX	44382884	44402221	FUNDC1	19337	0.411491
chrX	44703248	44704134	DUSP21	886	0.510158
chrX	44732422	44971845	KDM6A	239423	0.385435
chrX	45007617	45060146	CXorf36	52529	0.442270
chrX	45364632	45386484	AK127697	21852	0.401474
chrX	45589987	45592021	LOC392452	2034	0.377581
chrX	45605584	45605694	MIR221	110	0.472727
chrX	45606420	45606530	MIR222	110	0.509091
chrX	45707326	45710447	AK098783	3121	0.444409
chrX	46185713	46187080	BC015977	1367	0.452085
chrX	46306623	46334074	KRBOX4	27451	0.408838
chrX	46319732	46321944	AX747333	2212	0.504069
chrX	46357159	46404892	ZNF674	47733	0.418683
chrX	46404924	46407910	ZNF674-AS1	2986	0.465841
chrX	46433191	46457838	CHST7	24647	0.448087
chrX	46458685	46618607	SLC9A7	159922	0.410738
chrX	46696346	46741791	RP2	45445	0.393509
chrX	46746853	46759139	CXorf31	12286	0.420153
chrX	46771735	46920641	PHF16	148906	0.403610
chrX	46937774	46952712	RGN	14938	0.433726
chrX	47001614	47004609	NDUFB11	2995	0.509182
chrX	47004616	47046214	RBM10	41598	0.502644
chrX	47050198	47074527	UBA1	24329	0.513502
chrX	47064246	47065254	INE1	1008	0.510913
chrX	47082416	47089394	CDK16	6978	0.532817
chrX	47092313	47107727	USP11	15414	0.482548
chrX	47229998	47273098	ZNF157	43100	0.450209
chrX	47248048	47248175	SNORA11C	127	0.511811
chrX	47305560	47342345	ZNF41	36785	0.433628
chrX	47420498	47431320	ARAF	10822	0.512197
chrX	47431299	47479256	SYN1	47957	0.477595
chrX	47441689	47446190	TIMP1	4501	0.537658
chrX	47446827	47446904	MIR4769	77	0.558442
chrX	47483611	47489704	CFP	6093	0.554735
chrX	47494918	47510003	ELK1	15085	0.492211
chrX	47511190	47518579	UXT	7389	0.450264
chrX	47518251	47519776	LOC100133957	1525	0.498361
chrX	47566589	47596027	CXXC1P1	29438	0.443610
chrX	47693820	47696192	LOC441493	2372	0.448988
chrX	47696300	47781655	ZNF81	85355	0.395384
chrX	47834249	47863394	ZNF182	29145	0.404083
chrX	47863733	47869128	SPACA5	5395	0.488230
chrX	47917566	47930508	ZNF630	12942	0.420491
chrX	47967366	47973694	SSX6	6328	0.464602
chrX	47986602	47991997	SPACA5	5395	0.488045
chrX	48045655	48056199	SSX5	10544	0.446225
chrX	48114796	48126879	SSX1	12083	0.437143
chrX	48160984	48165614	SSX9	4630	0.450324
chrX	48205862	48216142	SSX3	10280	0.442218
chrX	48242956	48252785	SSX4B	9829	0.449283
chrX	48261523	48271355	SSX4B	9832	0.449146
chrX	48316926	48328644	SLC38A5	11718	0.548899
chrX	48334548	48344752	FTSJ1	10204	0.504704
chrX	48368171	48379202	PORCN	11031	0.507751
chrX	48380163	48387104	EBP	6941	0.494741
chrX	48398074	48420997	TBC1D25	22923	0.480085
chrX	48432740	48439553	RBM3	6813	0.478350
chrX	48455879	48463582	WDR13	7703	0.561210
chrX	48542185	48549817	WAS	7632	0.514020
chrX	48555130	48567406	SUV39H1	12276	0.538449
chrX	48620153	48632064	GLOD5	11911	0.453446
chrX	48644981	48652717	GATA1	7736	0.544209
chrX	48660486	48683380	HDAC6	22894	0.500480
chrX	48684922	48688279	ERAS	3357	0.587727
chrX	48689503	48694036	PCSK1N	4533	0.556144
chrX	48750729	48755426	TIMM17B	4697	0.529274
chrX	48755194	48760422	PQBP1	5228	0.527161
chrX	48760458	48769235	SLC35A2	8777	0.520337
chrX	48770458	48776413	PIM2	5955	0.537364
chrX	48779302	48814893	OTUD5	35591	0.497008
chrX	48818638	48828251	KCND1	9613	0.540206
chrX	48830133	48858675	GRIPAP1	28542	0.502312
chrX	48886241	48900990	TFE3	14749	0.524985
chrX	48916496	48927510	CCDC120	11014	0.572998
chrX	48919408	48920724	CCDC120	1316	0.579787
chrX	48932091	48937564	WDR45	5473	0.554175
chrX	48969021	48980079	GPKOW	11058	0.507415
chrX	49019180	49023836	MAGIX	4656	0.610180
chrX	49028183	49031468	PLP2	3285	0.550076
chrX	49031905	49042776	PRICKLE3	10871	0.556159
chrX	49044264	49056661	SYP	12397	0.524966
chrX	49061522	49089833	CACNA1F	28311	0.528664
chrX	49091926	49106987	CCDC22	15061	0.535688
chrX	49106896	49121288	FOXP3	14392	0.534811
chrX	49126305	49144555	PPP1R3F	18250	0.494685
chrX	49160124	49176311	GAGE10	16187	0.444492
chrX	49197562	49214430	GAGE2C	16868	0.447237
chrX	49325433	49332821	GAGE12D	7388	0.442880
chrX	49334991	49342370	GAGE12D	7379	0.443149
chrX	49344540	49351917	GAGE12D	7377	0.442863
chrX	49363615	49373139	GAGE1	9524	0.429861
chrX	49452053	49460596	PAGE1	8543	0.404425
chrX	49593905	49598570	PAGE4	4665	0.381779
chrX	49641326	49643959	USP27X-AS1	2633	0.536650
chrX	49644469	49647168	USP27X	2699	0.480548
chrX	49687224	49863892	CLCN5	176668	0.395482
chrX	49767753	49767844	MIR532	91	0.516484
chrX	49768108	49768194	MIR188	86	0.581395
chrX	49773038	49773122	MIR500A	84	0.559524
chrX	49773571	49773635	MIR362	64	0.421875
chrX	49774329	49774413	MIR501	84	0.535714
chrX	49775279	49775358	MIR500B	79	0.556962
chrX	49777848	49777945	MIR660	97	0.494845
chrX	49779205	49779291	MIR502	86	0.558140
chrX	49955410	49965664	AKAP4	10254	0.415058
chrX	50027541	50094911	CCNB3	67370	0.407748
chrX	50111878	50213721	DGKK	101843	0.409277
chrX	50331931	50333932	AX748273	2001	0.397301
chrX	50334642	50557044	SHROOM4	222402	0.401408
chrX	50653734	50659641	BMP15	5907	0.447266
chrX	51075082	51080377	NUDT10	5295	0.468933
chrX	51232862	51239459	NUDT11	6597	0.391390
chrX	51424145	51425447	CENPVP1	1302	0.545315
chrX	51453924	51455226	CENPVP1	1302	0.545315
chrX	51486480	51489326	GSPT2	2846	0.450808
chrX	51636697	51645450	MAGED1	8753	0.497544
chrX	51793955	51797392	BC137157	3437	0.512947
chrX	51804922	51812368	MAGED4	7446	0.600188
chrX	51806442	51806569	SNORA11D	127	0.551181
chrX	51927918	51935366	MAGED4	7448	0.600161
chrX	51933717	51933844	SNORA11D	127	0.551181
chrX	51942921	51946358	AK096379	3437	0.512947
chrX	52108069	52111918	BC094793	3849	0.436997
chrX	52112077	52118822	XAGE2	6745	0.382506
chrX	52238809	52243953	XAGE1D	5144	0.419907
chrX	52255219	52260363	XAGE1B	5144	0.419518
chrX	52380351	52387096	XAGE2	6745	0.382506
chrX	52387255	52391104	BC094793	3849	0.436997
chrX	52511760	52516904	XAGE1D	5144	0.419712
chrX	52528159	52533303	XAGE1D	5144	0.419712
chrX	52541053	52546197	XAGE1C	5144	0.419712
chrX	52651984	52662998	SSX8	11014	0.443526
chrX	52673110	52683950	SSX7	10840	0.446956
chrX	52725945	52736249	SSX2	10304	0.450505
chrX	52780307	52790617	SSX2	10310	0.450436
chrX	52825185	52826388	SPANXN5	1203	0.461347
chrX	52841227	52847322	XAGE5	6095	0.385890
chrX	52891557	52896332	XAGE3	4775	0.349738
chrX	52928084	52937585	FAM156A	9501	0.475950
chrX	52976463	53024651	FAM156A	48188	0.465137
chrX	53078505	53109796	GPR173	31291	0.457448
chrX	53111541	53117728	TSPYL2	6187	0.524972
chrX	53172141	53172180	DQ590295	39	0.538462
chrX	53220502	53254604	KDM5C	34102	0.481115
chrX	53221897	53223882	AY927613	1985	0.617632
chrX	53262057	53350522	IQSEC2	88465	0.499565
chrX	53401069	53449618	SMC1A	48549	0.454942
chrX	53449804	53458063	RIBC1	8259	0.486378
chrX	53458205	53461323	HSD17B10	3118	0.520205
chrX	53489158	53489180	svRNAa	22	0.500000
chrX	53559056	53713697	HUWE1	154641	0.411922
chrX	53583183	53583302	MIR98	119	0.428571
chrX	53584152	53584235	MIRLET7F2	83	0.421687
chrX	53584206	53584228	DM119504	22	0.318182
chrX	53963112	54071569	PHF8	108457	0.429700
chrX	54094756	54209714	FAM120C	114958	0.426860
chrX	54219255	54384438	WNK3	165183	0.399381
chrX	54466852	54471731	TSR2	4879	0.474892
chrX	54471886	54522599	FGD1	50713	0.500148
chrX	54556643	54593720	GNL3L	37077	0.470561
chrX	54775331	54824673	ITIH6	49342	0.440963
chrX	54834170	54842445	MAGED2	8275	0.521088
chrX	54840802	54840933	SNORA11	131	0.541985
chrX	54946995	54957866	TRO	10871	0.514580
chrX	54953737	54953866	SNORA11	129	0.519380
chrX	54959566	55020511	PFKFB1	60945	0.400673
chrX	55026755	55034306	APEX2	7551	0.491458
chrX	55035487	55057497	ALAS2	22010	0.431985
chrX	55101488	55105336	PAGE2B	3848	0.393451
chrX	55169534	55187628	FAM104B	18094	0.366696
chrX	55207823	55208944	MTRNR2L10	1121	0.389830
chrX	55246791	55250541	PAGE5	3750	0.388000
chrX	55284848	55291165	PAGE3	6317	0.337977
chrX	55477892	55477953	MIR4536-1	61	0.311475
chrX	55478537	55479999	MAGEH1	1462	0.480164
chrX	55511048	55515631	USP51	4583	0.425704
chrX	55649832	55652621	FOXR2	2789	0.409824
chrX	55744109	55785207	RRAGB	41098	0.408974
chrX	56258821	56314322	KLF8	55501	0.388299
chrX	56590025	56593443	UBQLN2	3418	0.481861
chrX	56755717	56844004	LOC550643	88287	0.453770
chrX	56763220	56764017	UQCRBP1	797	0.370138
chrX	57017263	57021988	SPIN3	4725	0.435132
chrX	57146114	57147979	SPIN2B	1865	0.532976
chrX	57146286	57147065	SPIN2B	779	0.463415
chrX	57162082	57164058	SPIN2A	1976	0.518725
chrX	57162254	57163033	SPIN2B	779	0.463415
chrX	57313109	57515629	FAAH2	202520	0.376610
chrX	57618268	57623910	ZXDB	5642	0.465615
chrX	57931863	57937067	ZXDA	5204	0.468678
chrX	62567106	62571218	SPIN4	4112	0.373784
chrX	62646437	62651523	AK130294	5086	0.474440
chrX	62854847	63005426	ARHGEF9	150579	0.407301
chrX	63005881	63005967	MIR1468	86	0.441860
chrX	63404996	63425624	AMER1	20628	0.509453
chrX	63487960	63615333	MTMR8	127373	0.389572
chrX	64135681	64196413	ZC4H2	60732	0.387901
chrX	64708614	64727767	ZC3H12B	19153	0.407560
chrX	64732461	64754686	LAS1L	22225	0.504747
chrX	64770501	64772301	FRMD8P1	1800	0.655000
chrX	64808260	64845760	BC067907	37500	0.434560
chrX	64887510	64961793	MSN	74283	0.448838
chrX	64905377	64905400	JA611242	23	0.608696
chrX	65235302	65240264	mir-223	4962	0.434704
chrX	65241579	65259967	VSIG4	18388	0.401512
chrX	65382432	65487230	HEPH	104798	0.384950
chrX	65815481	65835872	EDA2R	20391	0.388652
chrX	65896099	65896206	U6	107	0.289720
chrX	66763873	66950461	AR	186588	0.396799
chrX	67262185	67653299	OPHN1	391114	0.397224
chrX	67718623	67757127	YIPF6	38504	0.410659
chrX	67867510	67945684	STARD8	78174	0.502750
chrX	68048839	68062006	EFNB1	13167	0.564062
chrX	68380580	68385365	PJA1	4785	0.517241
chrX	68399399	68429767	LINC00269	30368	0.493743
chrX	68725077	68752351	FAM155B	27274	0.491457
chrX	68835910	69259321	EDA	423411	0.387484
chrX	69242706	69242773	MIR676	67	0.447761
chrX	69260391	69269788	AWAT2	9397	0.476748
chrX	69282340	69284029	OTUD6A	1689	0.576081
chrX	69353317	69386173	IGBP1	32856	0.428780
chrX	69397335	69425553	DGAT2L6	28218	0.419307
chrX	69454504	69460511	AWAT1	6007	0.485267
chrX	69478015	69479654	P2RY4	1639	0.568639
chrX	69488184	69501690	ARR3	13506	0.436695
chrX	69502021	69504852	RAB41	2831	0.454256
chrX	69506210	69509798	PDZD11	3588	0.471014
chrX	69509878	69640774	KIF4A	130896	0.404940
chrX	69642880	69653241	GDPD2	10361	0.514333
chrX	69664704	69725339	DLG3	60635	0.468937
chrX	69670728	69670872	U4	144	0.430556
chrX	69748789	70128567	TEX11	379778	0.387339
chrX	70145429	70150975	SLC7A3	5546	0.504868
chrX	70279096	70288298	SNX12	9202	0.464356
chrX	70315998	70323384	FOXO4	7386	0.523152
chrX	70323738	70326638	CXorf65	2900	0.489655
chrX	70327253	70331481	IL2RG	4228	0.499763
chrX	70338405	70362304	MED12	23899	0.510774
chrX	70364680	70391051	NLGN3	26371	0.520989
chrX	70430034	70948962	BCYRN1	518928	0.454907
chrX	70435061	70445065	GJB1	10004	0.514194
chrX	70459473	70474038	ZMYM3	14565	0.532372
chrX	70503041	70521018	NONO	17977	0.441119
chrX	70521627	70525204	ITGB1BP2	3577	0.464076
chrX	70586113	70685855	TAF1	99742	0.429167
chrX	70711376	70712604	INGX	1228	0.558632
chrX	70752911	70795747	OGT	42836	0.406060
chrX	70797873	70833433	ACRC	35560	0.447525
chrX	70835765	70838367	CXCR3	2602	0.612606
chrX	70917045	70923256	LINC00891	6211	0.449847
chrX	70934223	70938135	CXorf49B	3912	0.608896
chrX	70983139	70987051	CXorf49B	3912	0.608896
chrX	71130937	71363424	NHSL2	232487	0.453772
chrX	71264258	71264811	RPS26P11	553	0.497288
chrX	71346960	71351751	RGAG4	4791	0.549990
chrX	71364033	71381600	FLJ44635	17567	0.441851
chrX	71401525	71418194	PIN4	16669	0.437999
chrX	71424506	71458858	ERCC6L	34352	0.439392
chrX	71492452	71497141	RPS4X	4689	0.447004
chrX	71521487	71525764	CITED1	4277	0.530746
chrX	71549365	71792953	HDAC8	243588	0.400467
chrX	71798663	71934029	PHKA1	135366	0.378330
chrX	72001688	72002484	LINC00684	796	0.594221
chrX	72064875	72068636	DMRTC1	3761	0.532305
chrX	72091858	72095622	DMRTC1	3764	0.532678
chrX	72158002	72158798	LINC00684	796	0.594221
chrX	72161567	72163589	FAM226B	2022	0.521266
chrX	72223351	72225551	PABPC1L2B	2200	0.497727
chrX	72297176	72299351	PABPC1L2A	2175	0.504368
chrX	72345875	72347919	NAP1L6	2044	0.481898
chrX	72432136	72434710	NAP1L2	2574	0.403263
chrX	72667089	72674421	CDX4	7332	0.400709
chrX	72744110	72782921	MAP2K4P1	38811	0.393265
chrX	72782983	72906937	CHIC1	123954	0.376406
chrX	73012039	73049066	TSIX	37027	0.406379
chrX	73040485	73072588	XIST	32103	0.397907
chrX	73164158	73220326	JPX	56168	0.388015
chrX	73247970	73513409	FTX	265439	0.400043
chrX	73421436	73461983	AK125301	40547	0.386983
chrX	73438211	73438296	MIR421	85	0.388235
chrX	73438381	73438453	MIR374B	72	0.416667
chrX	73438383	73438453	MIR374C	70	0.414286
chrX	73506938	73507044	MIR545	106	0.415094
chrX	73507120	73507192	MIR374A	72	0.319444
chrX	73524024	73524869	ZCCHC13	845	0.515976
chrX	73641327	73753764	SLC16A2	112437	0.435933
chrX	73802810	73834461	RLIM	31651	0.386939
chrX	73952690	74145287	KIAA2022	192597	0.394876
chrX	74273006	74376175	ABCB7	103169	0.359546
chrX	74493893	74524732	UPRT	30839	0.375336
chrX	74544123	74546232	AX748371	2109	0.380275
chrX	74588261	74743337	ZDHHC15	155076	0.383199
chrX	74960372	74962914	TTC3P1	2542	0.444138
chrX	75002822	75005079	MAGEE2	2257	0.468764
chrX	75392770	75398033	PBDC1	5263	0.428463
chrX	75648045	75651746	MAGEE1	3701	0.541745
chrX	75878197	76234957	AK311342	356760	0.385713
chrX	76139697	76139785	MIR384	88	0.272727
chrX	76709646	76712013	FGF16	2367	0.465991
chrX	76760355	77041719	ATRX	281364	0.377205
chrX	77081861	77151065	MAGT1	69204	0.409341
chrX	77154960	77160881	COX7B	5921	0.405844
chrX	77166193	77305892	ATP7A	139699	0.386037
chrX	77223457	77225135	PGAM4	1678	0.505959
chrX	77359665	77382324	PGK1	22659	0.414493
chrX	77385244	77395179	TAF9B	9935	0.384399
chrX	77528129	77583087	CYSLTR1	54958	0.382892
chrX	77911565	77914825	ZCCHC5	3260	0.457975
chrX	78003205	78012578	LPAR4	9373	0.362424
chrX	78156690	78156746	MIR4328	56	0.446429
chrX	78200828	78217438	P2RY10	16610	0.384527
chrX	78426468	78427726	GPR174	1258	0.414944
chrX	78615880	78623049	ITM2A	7169	0.366997
chrX	79277741	79287268	TBX22	9527	0.423113
chrX	79483989	79565732	CR627394	81743	0.382589
chrX	79591002	79700810	FAM46D	109808	0.372550
chrX	79924986	80065233	BRWD3	140247	0.361227
chrX	80369199	80457441	HMGN5	88242	0.364192
chrX	80457302	80554046	SH3BGRL	96744	0.375000
chrX	81850262	81850481	7SK	219	0.461187
chrX	82763268	82764775	POU3F4	1507	0.552754
chrX	83116133	83141708	CYLC1	25575	0.326725
chrX	83313353	83442943	RPS6KA6	129590	0.351732
chrX	83572881	83757487	HDX	184606	0.349322
chrX	84189156	84189896	UBE2DNL	740	0.594595
chrX	84258897	84348323	APOOL	89426	0.371368
chrX	84347291	84363974	SATL1	16683	0.375412
chrX	84498996	84528368	ZNF711	29372	0.343729
chrX	84532394	84634748	POF1B	102354	0.357309
chrX	85116184	85302566	CHM	186382	0.369639
chrX	85403454	86087605	DACH2	684151	0.358797
chrX	86772714	86924596	KLHL4	151882	0.355243
chrX	88002225	88009785	CPXCR1	7560	0.356217
chrX	89176939	89177882	TGIF2LX	943	0.518558
chrX	89852233	89852339	U6	106	0.349057
chrX	90689596	90693583	PABPC5	3987	0.412591
chrX	91090459	91878228	PCDH11X	787769	0.358152
chrX	91064464	91064633	PCDHX	169	0.349112
chrX	91354535	91360178	AK125288	5643	0.449052
chrX	91368316	91368338	DD413682	22	0.409091
chrX	91651900	91651987	CS706497	87	0.367816
chrX	92925924	92928682	NAP1L3	2758	0.427484
chrX	92929011	92967273	FAM133A	38262	0.340285
chrX	93258813	93258921	U6	108	0.314815
chrX	95306294	95306323	DQ580189	29	0.586207
chrX	95592084	95592901	LOC643486	817	0.363525
chrX	95665430	95665781	7SK	351	0.458689
chrX	95939661	96855597	DIAPH2	915936	0.369920
chrX	96138906	96140450	RPA4	1544	0.465026
chrX	96692825	96819534	RBSG1	126709	0.373730
chrX	98716599	99194841	XRCC6P5	478242	0.359492
chrX	99546641	99665271	PCDH19	118630	0.400868
chrX	99839789	99854882	TNMD	15093	0.407937
chrX	99883794	99891794	TSPAN6	8000	0.409500
chrX	99899162	99926296	SRPX2	27134	0.434473
chrX	99929488	99986522	SYTL4	57034	0.410913
chrX	100075347	100095923	CSTF2	20576	0.388657
chrX	100077608	100077741	SNORA9	133	0.488722
chrX	100098312	100129334	NOX1	31022	0.411450
chrX	100168430	100183898	XKRX	15468	0.409878
chrX	100224696	100245820	ARL13A	21124	0.444897
chrX	100264333	100307105	TRMT2B	42772	0.449032
chrX	100333835	100351355	TMEM35	17520	0.441553
chrX	100354797	100417978	CENPI	63181	0.404964
chrX	100474932	100519485	DRP2	44553	0.451619
chrX	100523240	100548059	TAF7L	24819	0.410331
chrX	100600643	100603957	TIMM8A	3314	0.455643
chrX	100604434	100641212	BTK	36778	0.429496
chrX	100645877	100669128	RPL36A-HNRNPH2	23251	0.423810
chrX	100652778	100663001	GLA	10223	0.436565
chrX	100663120	100669128	HNRNPH2	6008	0.398469
chrX	100743030	100750798	ARMCX4	7768	0.519439
chrX	100805513	100809675	ARMCX1	4162	0.490870
chrX	100870107	100872991	ARMCX6	2884	0.515603
chrX	100878119	100882831	ARMCX3	4712	0.447368
chrX	100910267	100914863	ARMCX2	4596	0.517842
chrX	101087084	101112549	NXF5	25465	0.422266
chrX	101137259	101187039	ZMAT1	49780	0.377662
chrX	101380659	101382684	TCEAL2	2025	0.555556
chrX	101394932	101397388	TCEAL6	2456	0.528094
chrX	101408678	101410986	BEX5	2308	0.500000
chrX	101502093	101581634	NXF2	79541	0.422172
chrX	101470279	101481785	TCP11X2	11506	0.410742
chrX	101615315	101694929	NXF2	79614	0.422313
chrX	101715239	101726732	TCP11X2	11493	0.411120
chrX	101768609	101771699	TMSB15A	3090	0.433333
chrX	101804892	101826621	NXF4	21729	0.403286
chrX	101854425	101859085	ARMCX5	4660	0.447639
chrX	101854275	101972661	ARMCX5-GPRASP2	118386	0.399853
chrX	101906293	101914010	GPRASP1	7717	0.486588
chrX	102000906	102007369	BHLHB9	6463	0.444066
chrX	102024094	102140338	LINC00630	116244	0.391040
chrX	102192199	102193228	RAB40AL	1029	0.566570
chrX	102317580	102319168	BEX1	1588	0.568640
chrX	102330749	102348022	NXF3	17273	0.442193
chrX	102470019	102472128	BEX4	2109	0.525367
chrX	102507922	102510121	TCEAL8	2199	0.463847
chrX	102528617	102531797	TCEAL5	3180	0.506289
chrX	102564273	102565883	BEX2	1610	0.566460
chrX	102585113	102587251	TCEAL7	2138	0.444340
chrX	102611379	102613397	WBP5	2018	0.439544
chrX	102632108	102632999	NGFRAP1	891	0.455668
chrX	102754680	102774417	RAB40A	19737	0.393525
chrX	102840418	102842655	TCEAL4	2237	0.518999
chrX	102862833	102864855	TCEAL3	2022	0.574184
chrX	102883891	102885876	TCEAL1	1985	0.498741
chrX	102930425	102943086	MORF4L2	12661	0.393887
chrX	102942211	102947484	MORF4L2-AS1	5273	0.418737
chrX	102962271	102983552	GLRA4	21281	0.473803
chrX	102965836	102968960	TMEM31	3124	0.469590
chrX	103031753	103047547	PLP1	15794	0.438648
chrX	103077254	103087212	RAB9B	9958	0.398976
chrX	103139054	103139097	MIR1256	43	0.441860
chrX	103172239	103174131	AK026512	1892	0.545983
chrX	103173478	103187485	AK090973	14007	0.443421
chrX	103216593	103220563	TMSB15B	3970	0.457179
chrX	103230501	103232785	H2BFXP	2284	0.456217
chrX	103265718	103268256	H2BFWT	2538	0.480693
chrX	103294515	103297021	H2BFM	2506	0.462091
chrX	103315218	103317502	H2BFXP	2284	0.457093
chrX	103343897	103401708	SLC25A53	57811	0.428448
chrX	103357106	103360533	ZCCHC18	3427	0.519113
chrX	103366999	103369317	LOC286437	2318	0.423210
chrX	103411155	103440582	FAM199X	29427	0.370272
chrX	103494718	103499599	ESX1	4881	0.480025
chrX	103810995	105011822	IL1RAPL2	1200827	0.374725
chrX	104463610	104465358	TEX13A	1748	0.588673
chrX	105066535	105202602	NRK	136067	0.357846
chrX	105277189	105282718	SERPINA7	5529	0.416169
chrX	105412297	105452949	MUM1L1	40652	0.386967
chrX	105855159	105922673	CXorf57	67514	0.351616
chrX	105969893	106040246	RNF128	70353	0.361363
chrX	106045918	106119377	TBC1D8B	73459	0.365837
chrX	106057100	106236592	MORC4	179492	0.395951
chrX	106143292	106146561	RIPPLY1	3269	0.512695
chrX	106161589	106174091	CLDN2	12502	0.472084
chrX	106183963	106243474	MORC4	59511	0.390634
chrX	106309532	106362057	RBM41	52525	0.361066
chrX	106366656	106449670	NUP62CL	83014	0.370600
chrX	106449861	106487473	PIH1D3	37612	0.369403
chrX	106843634	106848479	KIAA1817	4845	0.584314
chrX	106871653	106894256	PRPS1	22603	0.418307
chrX	106956451	107019017	TSC22D3	62566	0.485775
chrX	107069083	107174867	MID2	105784	0.399446
chrX	107224093	107225600	TEX13B	1507	0.578633
chrX	107288199	107322414	VSIG1	34215	0.391027
chrX	107327434	107334874	PSMD10	7440	0.380108
chrX	107334898	107397901	ATG4A	63003	0.399664
chrX	107398836	107681658	COL4A6	282822	0.401716
chrX	107683073	107940775	COL4A5	257702	0.357541
chrX	107975726	107979607	IRS4	3881	0.560938
chrX	108616134	108725285	GUCY2F	109151	0.399181
chrX	108779009	108787927	NXT2	8918	0.373851
chrX	108866928	108868393	KCNE1L	1465	0.606826
chrX	108884563	108976621	ACSL4	92058	0.384844
chrX	109246341	109421016	TMEM164	174675	0.417209
chrX	109325345	109325446	MIR3978	101	0.485149
chrX	109437413	109561380	AMMECR1	123967	0.369945
chrX	109468216	109468288	SNORD96B	72	0.527778
chrX	109662284	109699562	RGAG1	37278	0.455818
chrX	109763539	109766249	TDGF1P3	2710	0.438745
chrX	109917083	110039076	CHRDL1	121993	0.394580
chrX	110366304	110464173	PAK3	97869	0.375512
chrX	110367492	110372431	AF070581	4939	0.353310
chrX	110488326	110513774	CAPN6	25448	0.413667
chrX	110537006	110654374	DCX	117368	0.394264
chrX	110664770	110664835	RNU6-28P	65	0.461538
chrX	110754889	110765627	LINC00890	10738	0.368132
chrX	110924345	111003875	ALG13	79530	0.369948
chrX	111017541	111326004	TRPC5	308463	0.402382
chrX	111125124	111147213	TRPC5OS	22089	0.390873
chrX	111326252	111700473	ZCCHC16	374221	0.384174
chrX	111873878	111923375	LHFPL1	49497	0.407358
chrX	112018104	112066372	AMOT	48268	0.422516
chrX	112023945	112024016	MIR4329	71	0.464789
chrX	112162359	112162458	U6	99	0.313131
chrX	113818550	114144624	HTR2C	326074	0.350310
chrX	113865258	113865386	SNORA35	128	0.546875
chrX	113873917	113874002	MIR764	85	0.505882
chrX	113886018	113886098	MIR1912	80	0.400000
chrX	113887129	113887198	MIR1264	69	0.318841
chrX	113949649	113949761	MIR1298	112	0.410714
chrX	113997743	113997823	MIR1911	80	0.587500
chrX	114058016	114058127	MIR448	111	0.531532
chrX	114238537	114252207	IL13RA2	13670	0.347476
chrX	114345182	114468635	LRCH2	123453	0.371299
chrX	114360878	114361007	SNORA35	129	0.434109
chrX	114423962	114427431	RBMXL3	3469	0.627270
chrX	114524291	114542121	LUZP4	17830	0.405777
chrX	114752496	114797058	AK127380	44562	0.401710
chrX	114827818	114885179	PLS3	57361	0.382089
chrX	115033603	115085422	LOC642776	51819	0.420097
chrX	115301957	115306225	AGTR2	4268	0.336926
chrX	115567746	115592625	SLC6A14	24879	0.333213
chrX	115592852	115594194	CXorf61	1342	0.421013
chrX	117031775	117119376	KLHL13	87601	0.350567
chrX	117480035	117583923	WDR44	103888	0.390738
chrX	117520356	117520434	MIR1277	78	0.256410
chrX	117629871	117820123	DOCK11	190252	0.396821
chrX	117861558	117928496	IL13RA1	66938	0.403478
chrX	117872017	117872145	SNORA35	128	0.507812
chrX	117957786	117960931	ZCCHC12	3145	0.517647
chrX	117973518	117991683	AK057519	18165	0.425544
chrX	118108712	118151949	LONRF3	43237	0.447603
chrX	118212597	118284542	KIAA1210	71945	0.427396
chrX	118370210	118378429	PGRMC1	8219	0.425721
chrX	118533257	118588437	SLC25A43	55180	0.452646
chrX	118599995	118603083	SLC25A5-AS1	3088	0.496438
chrX	118602362	118605359	SLC25A5	2997	0.525526
chrX	118672111	118699397	CXorf56	27286	0.443084
chrX	118708498	118718379	UBE2A	9881	0.396417
chrX	118722299	118739846	NKRF	17547	0.420642
chrX	118750908	118827333	SEPT6	76425	0.472882
chrX	118780700	118780811	MIR766	111	0.558559
chrX	118892575	118894165	SOWAHD	1590	0.654088
chrX	118920466	118925622	RPL39	5156	0.461210
chrX	118921315	118921447	SNORA69	132	0.363636
chrX	118967988	118986991	UPF3B	19003	0.407357
chrX	119004494	119005791	RNF113A	1297	0.547417
chrX	119005733	119010629	NDUFA1	4896	0.425041
chrX	119029935	119054679	AKAP14	24744	0.468477
chrX	119059012	119077735	NKAP	18723	0.417722
chrX	119170200	119280760	AK123976	110560	0.424864
chrX	119206228	119211707	RHOXF2B	5479	0.451542
chrX	119243010	119249847	RHOXF1	6837	0.419775
chrX	119292466	119297945	RHOXF2B	5479	0.451542
chrX	119370308	119379122	NKAPP1	8814	0.402882
chrX	119384606	119392251	ZBTB33	7645	0.393721
chrX	119392504	119445391	TMEM255A	52887	0.431826
chrX	119495939	119517104	ATP1B4	21165	0.418994
chrX	119560002	119603204	LAMP2	43202	0.386093
chrX	119658445	119709684	CUL4B	51239	0.392533
chrX	119738551	119755016	MCTS1	16465	0.372609
chrX	119759528	119764005	C1GALT1C1	4477	0.404959
chrX	120006451	120009779	CT47B1	3328	0.492188
chrX	120011344	120066151	CT47A1	54807	0.040743
chrX	120067694	120071012	CT47A4	3318	0.495178
chrX	120072555	120075873	CT47A10	3318	0.495178
chrX	120077415	120080733	CT47A2	3318	0.495178
chrX	120082276	120085594	CT47A3	3318	0.495178
chrX	120087136	120090454	CT47A7	3318	0.494876
chrX	120092019	120095337	CT47A6	3318	0.493972
chrX	120101740	120105058	CT47A5	3318	0.494575
chrX	120106600	120109918	CT47A9	3318	0.494575
chrX	120111460	120114778	CT47A11	3318	0.494575
chrX	120116320	120119638	CT47A6	3318	0.494274
chrX	120181461	120183796	GLUD2	2335	0.489507
chrX	121974278	121974498	U3	220	0.445455
chrX	122318095	122624766	GRIA3	306671	0.392678
chrX	122695945	122696055	mir-220	110	0.545455
chrX	122734411	122866904	THOC2	132493	0.380888
chrX	122993661	123047829	XIAP	54168	0.419344
chrX	123094474	123236505	STAG2	142031	0.375172
chrX	123480131	123507010	SH2D1A	26879	0.357082
chrX	123509755	124097666	TENM1	587911	0.371708
chrX	124453968	124456950	LOC100129520	2982	0.570087
chrX	125297481	125300080	DCAF12L2	2599	0.548673
chrX	125683365	125686842	DCAF12L1	3477	0.481450
chrX	125953746	125955768	CXorf64	2022	0.449060
chrX	127184940	127186382	ACTRT1	1442	0.486824
chrX	128580477	128657460	SMARCA1	76983	0.368666
chrX	128652552	128652624	SNORD112	72	0.416667
chrX	128674251	128726530	OCRL	52279	0.397597
chrX	128779235	128788933	APLN	9698	0.561765
chrX	128872945	128903525	XPNPEP2	30580	0.497515
chrX	128913891	128929176	SASH3	15285	0.527511
chrX	128937263	128977910	ZDHHC9	40647	0.434030
chrX	129040096	129063738	UTP14A	23642	0.450850
chrX	129139163	129192058	BCORL1	52895	0.501465
chrX	129198894	129244688	ELF4	45794	0.517775
chrX	129263337	129299861	AIFM1	36524	0.429827
chrX	129305772	129318844	RAB33A	13072	0.474679
chrX	129336672	129402922	ZNF280C	66250	0.380392
chrX	129474046	129507335	SLC25A14	33289	0.376731
chrX	129518318	129519511	GPR119	1193	0.548198
chrX	129535942	129547317	RBMX2	11375	0.437714
chrX	129611042	129658231	BC043223	47189	0.398292
chrX	129628914	129631421	FAM45B	2507	0.411647
chrX	129757356	130037208	ENOX2	279852	0.388666
chrX	130192215	130223857	ARHGAP36	31642	0.461760
chrX	130407482	130423403	IGSF1	15921	0.478048
chrX	130678047	130678974	OR13H1	927	0.459547
chrX	130836677	130964671	LOC286467	127994	0.412902
chrX	131157244	131209971	MST4	52727	0.366567
chrX	131211020	131262050	FRMD7	51030	0.405840
chrX	131337051	131352189	RAP2C	15138	0.367684
chrX	131352649	131566839	AK095439	214190	0.383972
chrX	131503342	131574342	MBNL3	71000	0.362690
chrX	131714144	131714251	U6	107	0.448598
chrX	131760037	132095423	HS6ST2	335386	0.412149
chrX	131801669	131803915	HS6ST2-AS1	2246	0.402048
chrX	132159506	132162300	USP26	2794	0.387616
chrX	132350696	132352376	TFDP3	1680	0.475000
chrX	132435063	132549205	GPC4	114142	0.412293
chrX	132669775	133119673	GPC3	449898	0.396339
chrX	133303407	133303482	MIR363	75	0.413333
chrX	133303567	133303642	MIR92A2	75	0.453333
chrX	133303700	133303796	MIR19B2	96	0.343750
chrX	133303712	133303735	DM119510	23	0.391304
chrX	133303838	133303907	MIR20B	69	0.449275
chrX	133304070	133304141	MIR18B	71	0.464789
chrX	133304227	133304308	MIR106A	81	0.419753
chrX	133371076	133379808	CCDC160	8732	0.407352
chrX	133507341	133562822	PHF6	55481	0.374380
chrX	133594174	133634698	HPRT1	40524	0.390559
chrX	133674214	133674292	MIR450B	78	0.282051
chrX	133674370	133674461	MIR450A1	91	0.274725
chrX	133674537	133674637	MIR450A2	100	0.290000
chrX	133675370	133675467	MIR542	97	0.474227
chrX	133678456	133680653	MIR503HG	2197	0.604916
chrX	133680357	133680428	MIR503	71	0.591549
chrX	133680643	133680741	MIR424	98	0.510204
chrX	133684053	133694428	LINC00629	10375	0.427470
chrX	133699872	133792513	PLAC1	92641	0.423409
chrX	133903595	133930385	FAM122B	26790	0.393953
chrX	133941222	133988641	FAM122C	47419	0.406968
chrX	134021661	134049297	MOSPD1	27636	0.408344
chrX	134124967	134126503	SMIM10	1536	0.453125
chrX	134154533	134156566	FAM127C	2033	0.512543
chrX	134166332	134167575	FAM127A	1243	0.605792
chrX	134184962	134186221	FAM127B	1259	0.600477
chrX	134229014	134232733	LINC00087	3719	0.618177
chrX	134252881	134254405	LINC00633	1524	0.428478
chrX	134254548	134257529	BC061642	2981	0.432741
chrX	134290460	134305751	CXorf48	15291	0.392649
chrX	134382887	134477957	DKFZp451F083	95070	0.416682
chrX	134419722	134429965	ZNF75D	10243	0.408376
chrX	134478695	134497338	ZNF449	18643	0.379499
chrX	134540020	134540794	AB062081	774	0.475452
chrX	134555867	134560225	LINC00086	4358	0.619780
chrX	134654554	134716460	DDX26B	61906	0.385859
chrX	134847184	134856988	CT45A1	9804	0.395247
chrX	134883487	134891519	CT45A3	8032	0.428038
chrX	134928696	134936735	CT45A4	8039	0.427790
chrX	134945650	134953994	CT45A5	8344	0.429410
chrX	134963214	134971244	CT45A6	8030	0.427646
chrX	134975784	134995220	SAGE1	19436	0.410321
chrX	135044230	135056134	MMGT1	11904	0.397597
chrX	135067585	135129428	SLC9A6	61843	0.401484
chrX	135229558	135293518	FHL1	63960	0.417714
chrX	135298973	135333738	MAP7D3	34765	0.395858
chrX	135383121	135499047	GPR112	115926	0.391250
chrX	135570124	135574598	BRS3	4474	0.385785
chrX	135579670	135594503	HTATSF1	14833	0.367626
chrX	135614310	135638966	VGLL1	24656	0.436648
chrX	135633036	135633119	MIR934	83	0.433735
chrX	135721701	135724588	LINC00892	2887	0.483893
chrX	135730335	135742549	CD40LG	12214	0.416162
chrX	135747711	135863503	ARHGEF6	115792	0.397661
chrX	135856157	135856264	U6	107	0.373832
chrX	135955605	135962939	RBMX	7334	0.438369
chrX	135961357	135961430	SNORD61	73	0.342466
chrX	135991553	136075814	AK055694	84261	0.418830
chrX	136112306	136113833	GPR101	1527	0.562541
chrX	136648345	136654259	ZIC3	5914	0.494082
chrX	136770049	136770153	U6	104	0.355769
chrX	137696891	137699799	LINC00889	2908	0.399587
chrX	137713733	138287185	FGF13	573452	0.390598
chrX	137749871	137749954	MIR504	83	0.554217
chrX	137794268	137798763	FGF13-AS1	4495	0.436707
chrX	137922164	137922184	JB158051	20	0.400000
chrX	138528977	138531132	SRD5A1P1	2155	0.466357
chrX	138612894	138645617	F9	32723	0.389390
chrX	138663929	138790381	MCF2	126452	0.377210
chrX	138808504	138914447	ATP11C	105943	0.376485
chrX	139006306	139006390	MIR505	84	0.523810
chrX	139037883	139047677	CXorf66	9794	0.398816
chrX	139173825	139175070	LOC389895	1245	0.555823
chrX	139533312	139533373	U7	61	0.393443
chrX	139585151	139587225	SOX3	2074	0.634523
chrX	139791923	139796996	LINC00632	5073	0.408437
chrX	139863223	139866517	AK054921	3294	0.401032
chrX	139865424	139866723	CDR1	1299	0.437259
chrX	140008336	140008384	MIR320D2	48	0.479167
chrX	140084755	140085871	SPANXF1	1116	0.499104
chrX	140096760	140097876	SPANXF1	1116	0.499104
chrX	140269930	140271310	LDOC1	1380	0.573188
chrX	140335595	140336646	SPANXC	1051	0.495718
chrX	140590842	140738069	SPANXA2-OT1	147227	0.394595
chrX	140671795	140672860	SPANXA2	1065	0.494836
chrX	140677834	140678899	SPANXA2	1065	0.494836
chrX	140713995	140714861	SPANX-L	866	0.415704
chrX	140785567	140786655	SPANXE	1088	0.500000
chrX	140926101	140985618	MAGEC3	59517	0.390594
chrX	140991641	140997187	MAGEC1	5546	0.519654
chrX	141290127	141293076	MAGEC2	2949	0.517464
chrX	142113703	142122066	SPANXN4	8363	0.466579
chrX	142178132	142178463	7SK	331	0.471299
chrX	142596563	142605307	SPANXN3	8744	0.466148
chrX	142710594	142723926	SLITRK4	13332	0.412316
chrX	142795054	142804516	SPANXN2	9462	0.467449
chrX	142967172	142968357	UBE2NL	1185	0.404219
chrX	144329106	144337728	SPANXN1	8622	0.464509
chrX	144902865	144907360	SLITRK2	4495	0.468298
chrX	144908927	144911370	TMEM257	2443	0.344658
chrX	145075792	145075869	MIR890	77	0.402597
chrX	145076301	145076378	MIR888	77	0.467532
chrX	145078186	145078261	MIR892A	75	0.493333
chrX	145078715	145078792	MIR892B	77	0.454545
chrX	145082570	145082649	MIR891B	79	0.367089
chrX	145109311	145109390	MIR891A	79	0.430380
chrX	145891301	145891929	CXorf51B	628	0.495223
chrX	145895621	145896249	CXorf51A	628	0.495223
chrX	146312237	146312361	MIR506	124	0.419355
chrX	146312501	146312595	MIR507	94	0.404255
chrX	146318430	146318545	MIR508	115	0.452174
chrX	146331668	146331748	MIR514B	80	0.425000
chrX	146340277	146341244	MIR509-1	967	0.388831
chrX	146342049	146342143	MIR509-1	94	0.436170
chrX	146353852	146353926	MIR510	74	0.445946
chrX	146360764	146360862	MIR514A1	98	0.397959
chrX	146363460	146363548	MIR514A2	88	0.409091
chrX	146366158	146366246	MIR514A2	88	0.409091
chrX	146990948	147003676	FMR1-AS1	12728	0.401320
chrX	146993468	147032647	FMR1	39179	0.363613
chrX	147062848	147108187	FMR1NB	45339	0.394627
chrX	147582138	148082193	AFF2	500055	0.388409
chrX	148560294	148586884	IDS	26590	0.462204
chrX	148593083	148607803	IDS2	14720	0.450136
chrX	148614963	148622504	LINC00893	7541	0.574460
chrX	148622518	148629312	CXorf40A	6794	0.540183
chrX	148663308	148669116	MAGEA9B	5808	0.582817
chrX	148674171	148676974	HSFX2	2803	0.569390
chrX	148678215	148713487	TMEM185A	35272	0.425607
chrX	148793684	148798928	MAGEA11	5244	0.541953
chrX	148850566	148853774	TMEM185A	3208	0.538653
chrX	148853852	148854484	TMEM185A	632	0.507911
chrX	148855725	148858528	HSFX2	2803	0.569390
chrX	148863592	148869399	MAGEA9B	5807	0.582745
chrX	149007562	149025779	MAGEA8-AS1	18217	0.424000
chrX	149009940	149014609	MAGEA8	4669	0.550439
chrX	149100414	149106716	CXorf40B	6302	0.550460
chrX	149106765	149392815	LINC00894	286050	0.419210
chrX	149396238	149396318	MIR2114	80	0.550000
chrX	149531550	149682448	MAMLD1	150898	0.438144
chrX	149737046	149841616	MTM1	104570	0.397102
chrX	149861868	149933575	MTMR1	71707	0.423613
chrX	149934808	150067289	CD99L2	132481	0.430220
chrX	150151762	150159248	HMGB3	7486	0.502939
chrX	150336693	150336798	MIR4330	105	0.523810
chrX	150345055	150349937	GPR50	4882	0.562679
chrX	150565656	150577836	VMA21	12180	0.403695
chrX	150732006	150845211	PASD1	113205	0.392695
chrX	150863729	150870063	PRRG3	6334	0.524313
chrX	150884507	150891664	FATE1	7157	0.483303
chrX	150903217	150914036	CNGA2	10819	0.509936
chrX	151081360	151093642	MAGEA4	12282	0.589806
chrX	151121595	151143151	GABRE	21556	0.468593
chrX	151128099	151128184	MIR452	85	0.411765
chrX	151282520	151286411	MAGEA5	3891	0.538936
chrX	151301782	151307050	MAGEA10	5268	0.513098
chrX	151335633	151619831	GABRA3	284198	0.373405
chrX	151419043	151419148	U6	105	0.342857
chrX	151560690	151560771	MIR105-1	81	0.530864
chrX	151561892	151562001	MIR767	109	0.458716
chrX	151562883	151562964	MIR105-2	81	0.506173
chrX	151806636	151821825	GABRQ	15189	0.484825
chrX	151867244	151870814	MAGEA6	3570	0.557703
chrX	151876742	151877747	CSAG2	1005	0.497512
chrX	151883118	151887095	MAGEA2	3977	0.558461
chrX	151899292	151903184	MAGEA12	3892	0.551131
chrX	151903227	151909518	CSAG1	6291	0.404228
chrX	151903227	151909518	CSAG1	6291	0.404228
chrX	151918387	151922364	MAGEA2	3977	0.558713
chrX	151927733	151928738	CSAG2	1005	0.497512
chrX	151934651	151938240	MAGEA3	3589	0.559209
chrX	151995870	151999301	CETN2	3431	0.438356
chrX	151999510	152037907	NSDHL	38397	0.460192
chrX	152082985	152142025	ZNF185	59040	0.505064
chrX	152157367	152160761	PNMA5	3394	0.564231
chrX	152224765	152228827	PNMA3	4062	0.606844
chrX	152240726	152243402	PNMA6C	2676	0.670777
chrX	152243995	152246070	PNMA6D	2075	0.697831
chrX	152338907	152340107	PNMA6A	1200	0.647500
chrX	152481521	152486116	MAGEA1	4595	0.559304
chrX	152599612	152618384	ZNF275	18772	0.485244
chrX	152683780	152687086	ZFP92	3306	0.585904
chrX	152710177	152711945	TREX2	1768	0.664593
chrX	152713122	152736603	HAUS7	23481	0.548486
chrX	152760346	152775004	BGN	14658	0.627030
chrX	152801579	152848387	ATP2B3	46808	0.584131
chrX	152853382	152864632	FAM58A	11250	0.555467
chrX	152907896	152916781	DUSP9	8885	0.637366
chrX	152935187	152939816	PNCK	4629	0.660186
chrX	152953751	152962048	SLC6A8	8297	0.641678
chrX	152965946	152989838	BCAP31	23892	0.540097
chrX	152990322	153010216	ABCD1	19894	0.583593
chrX	153029650	153045940	PLXNB3	16290	0.657213
chrX	153046455	153051187	SRPK3	4732	0.647929
chrX	153051220	153059978	IDH3G	8758	0.587691
chrX	153059629	153063967	SSR4	4338	0.616183
chrX	153067622	153096003	PDZD4	28381	0.563370
chrX	153126968	153151628	L1CAM	24660	0.599716
chrX	153170427	153172620	AVPR2	2193	0.641587
chrX	153172829	153191714	ARHGAP4	18885	0.576542
chrX	153195279	153200607	NAA10	5328	0.585773
chrX	153200721	153210232	RENBP	9511	0.559142
chrX	153209600	153209674	DL490658	74	0.675676
chrX	153213007	153236819	HCFC1	23812	0.594112
chrX	153237990	153248646	TMEM187	10656	0.522241
chrX	153246547	153246628	MIR3202-1	81	0.345679
chrX	153246548	153246627	MIR3202-2	79	0.341772
chrX	153275956	153285342	IRAK1	9386	0.616237
chrX	153285370	153285440	MIR718	70	0.857143
chrX	153287263	153363188	MECP2	75925	0.469463
chrX	153409724	153424507	OPN1LW	14783	0.525671
chrX	153424832	153441837	TEX28	17005	0.502676
chrX	153448084	153462352	OPN1MW	14268	0.531890
chrX	153461962	153482668	TEX28	20706	0.496426
chrX	153485202	153499470	OPN1MW	14268	0.531960
chrX	153498929	153523564	TEX28	24635	0.496205
chrX	153524026	153558713	TKTL1	34687	0.483207
chrX	153576899	153603006	FLNA	26107	0.622860
chrX	153607596	153609883	EMD	2287	0.619589
chrX	153625074	153627178	AK307233	2104	0.604087
chrX	153626570	153630680	RPL10	4110	0.521411
chrX	153628621	153628756	SNORA70	135	0.562963
chrX	153629578	153640427	DNASE1L1	10849	0.545304
chrX	153639876	153650063	TAZ	10187	0.560420
chrX	153652727	153656796	BC009467	4069	0.495453
chrX	153656977	153664862	ATP6AP1	7885	0.567660
chrX	153665258	153671814	GDI1	6556	0.597620
chrX	153672472	153679002	FAM50A	6530	0.604900
chrX	153686622	153701985	PLXNA3	15363	0.636464
chrX	153705240	153707596	LAGE3	2356	0.567487
chrX	153712055	153714932	UBL4A	2877	0.606535
chrX	153715649	153719002	SLC10A3	3353	0.606621
chrX	153733326	153744566	FAM3A	11240	0.550534
chrX	153759605	153775233	G6PD	15628	0.557333
chrX	153770458	153793261	IKBKG	22803	0.567645
chrX	153799478	153800188	FAM223B	710	0.464789
chrX	153813417	153815075	CTAG1B	1658	0.658022
chrX	153845864	153847522	CTAG1B	1658	0.658022
chrX	153860738	153861448	FAM223B	710	0.466197
chrX	153868251	153871017	IKBKG	2766	0.593637
chrX	153880245	153881853	CTAG2	1608	0.646144
chrX	153903526	153979348	GAB3	75822	0.406320
chrX	153991030	154005964	DKC1	14934	0.455939
chrX	153996802	153996932	SNORA36A	130	0.407692
chrX	154003272	154003401	SNORA56	129	0.488372
chrX	154006958	154033802	MPP1	26844	0.434660
chrX	154051622	154062937	SMIM9	11315	0.405921
chrX	154064063	154250998	F8	186935	0.395967
chrX	154113316	154113833	H2AFB3	517	0.634429
chrX	154114634	154116336	F8A1	1702	0.647474
chrX	154115634	154115733	MIR1184-3	99	0.565657
chrX	154255063	154285191	FUNDC2	30128	0.393255
chrX	154289899	154299547	CMC4	9648	0.406509
chrX	154292308	154299547	MTCP1	7239	0.419809
chrX	154299694	154351349	BRCC3	51655	0.377563
chrX	154444700	154468098	VBP1	23398	0.399863
chrX	154487525	154493852	RAB39B	6327	0.410147
chrX	154505499	154563986	CLIC2	58487	0.384393
chrX	154576449	154603823	TMLHE-AS1	27374	0.390407
chrX	154610427	154610944	H2AFB3	517	0.632495
chrX	154611748	154613450	F8A1	1702	0.648649
chrX	154612748	154612847	MIR1184-3	99	0.565657
chrX	154686574	154688276	F8A1	1702	0.648649
chrX	154687177	154687276	MIR1184-3	99	0.565657
chrX	154689079	154689596	H2AFB3	517	0.632495
chrX	154696200	154723771	TMLHE-AS1	27571	0.388343
chrX	154697946	154716707	U00684	18761	0.377219
chrX	154718672	154842622	TMLHE	123950	0.378830
chrX	154997450	155012117	SPRY3	14667	0.402877
chrX	155110942	155173433	VAMP7	62491	0.387800
chrX	155227245	155240482	IL9R	13237	0.558208
chrX	155249966	155253125	WASH1	3159	0.602406
chrX	155255322	155257848	DDX11L family member	2526	0.573634
chrY	148060	170022	PLCXD1	21962	0.516255
chrY	171425	180887	GTPBP6	9462	0.559924
chrY	231384	232054	LINC00685	670	0.505970
chrY	244667	297690	PPP2R3B	53023	0.582841
chrY	535078	557558	SHOX	22480	0.533185
chrY	750013	750044	DQ576039	31	0.548387
chrY	1264886	1281529	CRLF2	16643	0.471249
chrY	1351570	1378828	CSF2RA	27258	0.518160
chrY	1362810	1362885	MIR3690	75	0.533333
chrY	1405508	1451582	IL3RA	46074	0.545427
chrY	1455044	1461039	SLC25A6	5995	0.573645
chrY	1469423	1484314	ASMTL-AS1	14891	0.529649
chrY	1472031	1521870	ASMTL	49839	0.519192
chrY	1531465	1606037	P2RY8	74572	0.482232
chrY	1660485	1671411	AKAP17A	10926	0.609098
chrY	1683940	1711974	ASMT	28034	0.520760
chrY	2087554	2369015	DHRSX	281461	0.469887
chrY	2354454	2368580	ZBED1	14126	0.486337
chrY	2477305	2525270	CD99P1	47965	0.433003
chrY	2559227	2609350	CD99	50123	0.473794
chrY	2620336	2655611	XGPY2	35275	0.456074
chrY	2620336	2643037	XGPY2	22701	0.481080
chrY	2654895	2655792	SRY	897	0.462653
chrY	2709526	2734997	RPS4Y1	25471	0.428055
chrY	2803517	2850547	ZFY	47030	0.371061
chrY	2871036	2970313	LINC00278	99277	0.374447
chrY	3447125	3448082	TGIF2LY	957	0.510972
chrY	4924130	5610264	PCDH11Y	686134	0.356462
chrY	5205861	5205883	DD413682	22	0.409091
chrY	5378252	5378339	CS706497	87	0.367816
chrY	6110486	6111651	TTTY23	1165	0.510730
chrY	6114263	6117053	TSPY2	2790	0.532258
chrY	6258441	6279605	TTTY1B	21164	0.465838
chrY	6274284	6296485	TTTY2	22201	0.462817
chrY	6311474	6315118	TTTY21	3644	0.455818
chrY	6317508	6325947	TTTY7	8439	0.473871
chrY	6339071	6341671	TTTY8	2600	0.465769
chrY	6733958	6742068	AMELY	8110	0.372750
chrY	6778726	6959724	TBL1Y	180998	0.433204
chrY	7142012	7249588	PRKY	107576	0.442989
chrY	7567397	7569288	TTTY16	1891	0.434162
chrY	7610635	7677302	BC041884	66667	0.401653
chrY	7672964	7678723	TTTY12	5759	0.411877
chrY	8551410	8551919	TTTY18	509	0.493124
chrY	8572512	8573324	TTTY19	812	0.413793
chrY	8651358	8685423	TTTY11	34065	0.388727
chrY	9154669	9160483	RBMY1A3P	5814	0.350705
chrY	9167488	9172441	TTTY20	4953	0.368867
chrY	9175118	9177699	TSPY4	2581	0.539713
chrY	9187188	9192791	FAM197Y2	5603	0.405140
chrY	9195451	9198202	TSPY8	2751	0.528172
chrY	9207465	9213071	FAM197Y5	5606	0.404745
chrY	9215730	9238826	TSPY3	23096	0.471034
chrY	9215949	9218486	TSPY4	2537	0.515964
chrY	9225730	9233425	CYorf16	7695	0.400130
chrY	9236075	9368285	TSPY3	132210	0.290742
chrY	9296351	9301954	FAM197Y2	5603	0.404426
chrY	9304563	9307358	TSPY1	2795	0.534168
chrY	9316661	9322271	FAM197Y5	5610	0.405348
chrY	9324875	9327689	TSPY3	2814	0.533404
chrY	9357274	9362885	FAM197Y2	5611	0.405275
chrY	9448329	9452762	RBMY3AP	4433	0.350778
chrY	9528708	9531308	TTTY8	2600	0.465769
chrY	9544432	9552871	TTTY7	8439	0.473753
chrY	9555261	9558905	TTTY21	3644	0.455269
chrY	9573894	9596085	TTTY2	22191	0.462935
chrY	9590764	9611928	TTTY1B	21164	0.465933
chrY	9638761	9650854	TTTY22	12093	0.442322
chrY	9748406	9749571	TTTY23	1165	0.510730
chrY	10033119	10033139	JA668106	20	0.950000
chrY	10037845	10037870	JB175072	25	0.440000
chrY	13332094	13332124	DQ590589	30	0.566667
chrY	13334588	13334618	DQ590126	30	0.433333
chrY	13629636	13629724	IGL@	88	0.556818
chrY	14517914	14533389	GYG2P1	15475	0.463393
chrY	14774297	14804153	TTTY15	29856	0.392718
chrY	14813159	14972768	USP9Y	159609	0.368093
chrY	15016698	15032390	DDX3Y	15692	0.371463
chrY	15360258	15592550	UTY	232292	0.374705
chrY	15815446	15817902	TMSB4Y	2456	0.456840
chrY	16097651	16098392	VCY	741	0.619433
chrY	16168097	16168838	VCY	741	0.619433
chrY	16635625	16955848	NLGN4Y	320223	0.386287
chrY	16905521	16915913	NLGN4Y-AS1	10392	0.334777
chrY	19612837	19628622	FAM41AY2	15785	0.381945
chrY	19687040	19691353	FAM224B	4313	0.447021
chrY	19880859	19882440	XKRY	1581	0.342821
chrY	19990139	19992100	CDY2A	1961	0.443141
chrY	20137666	20139627	CDY2A	1961	0.442631
chrY	20297334	20298915	XKRY	1581	0.342821
chrY	20488418	20492736	FAM224B	4318	0.446503
chrY	20551155	20566932	FAM41AY2	15777	0.381822
chrY	20708556	20710478	HSFY2	1922	0.356920
chrY	20743091	20752407	TTTY9B	9316	0.384714
chrY	20891767	20901083	TTTY9B	9316	0.384714
chrY	20933699	20935621	HSFY2	1922	0.356920
chrY	21034386	21040114	NCRNA00185	5728	0.414979
chrY	21094584	21239302	TTTY14	144718	0.409085
chrY	21152525	21154705	CD24	2180	0.415596
chrY	21628341	21665039	BCORP1	36698	0.399204
chrY	21729243	21769056	TXLNG2P	39813	0.364102
chrY	21867300	21906825	KDM5D	39525	0.387603
chrY	22627553	22681114	TTTY10	53561	0.373499
chrY	22737610	22755040	EIF1AY	17430	0.356397
chrY	22917953	22942918	RPS4Y2	24965	0.426717
chrY	23557033	23563448	RBMY2EP	6415	0.350273
chrY	23673223	23687672	RBMY1B	14449	0.369922
chrY	23696764	23711212	RBMY1B	14448	0.369809
chrY	23745485	23756552	TTTY13	11067	0.459564
chrY	24026222	24040673	RBMY1B	14451	0.370009
chrY	24217902	24242154	PRY2	24252	0.414811
chrY	24291112	24292981	TTTY6	1869	0.474585
chrY	24442944	24445023	TTTY5	2079	0.507456
chrY	24455005	24564028	RBMY1F	109023	0.379810
chrY	24455005	24462352	RBMY2FP	7347	0.371989
chrY	24585736	24587606	TTTY6	1870	0.474866
chrY	24636543	24660784	PRY	24241	0.414628
chrY	24997730	24998862	TTTY17A	1132	0.426678
chrY	25082601	25119431	TTTY4	36830	0.422509
chrY	25130409	25151610	BPY2	21201	0.421678
chrY	25275501	25345254	DAZ1	69753	0.359927
chrY	25365580	25437503	DAZ2	71923	0.354365
chrY	25828121	25840710	PRY	12589	0.413615
chrY	26082873	26087769	TTTY3	4896	0.319444
chrY	26191376	26194161	CDY1	2785	0.413645
chrY	26317665	26317698	DQ577902	33	0.424242
chrY	26326465	26326496	DQ574758	31	0.451613
chrY	26326478	26326514	DQ582680	36	0.472222
chrY	26329580	26333378	CSPG4P1Y	3798	0.578462
chrY	26337855	26337882	DQ585964	27	0.592593
chrY	26337964	26337990	DQ571386	26	0.576923
chrY	26355003	26355032	DQ581594	29	0.448276
chrY	26356014	26356042	DQ597149	28	0.571429
chrY	26356113	26360978	GOLGA2P2Y	4865	0.548407
chrY	26356757	26356791	DQ579249	34	0.558824
chrY	26358936	26358978	DQ593032	42	0.547619
chrY	26422646	26422679	DQ575010	33	0.575758
chrY	26631478	26632610	TTTY17A	1132	0.425795
chrY	26716348	26753172	TTTY4	36824	0.422388
chrY	26764150	26785352	BPY2	21202	0.421706
chrY	26909215	26959639	DAZ3	50424	0.360562
chrY	26979966	27053187	DAZ4	73221	0.356687
chrY	27177049	27198251	BPY2	21202	0.421753
chrY	27209229	27246039	TTTY4	36810	0.422494
chrY	27329789	27330920	TTTY17A	1131	0.427056
chrY	27539762	27539795	DQ587965	33	0.575758
chrY	27601457	27606322	GOLGA2P2Y	4865	0.548613
chrY	27603457	27603499	DQ598729	42	0.547619
chrY	27604351	27604379	DQ596138	28	0.571429
chrY	27605644	27605678	DQ578199	34	0.558824
chrY	27606393	27606421	DQ597149	28	0.571429
chrY	27607403	27607432	DQ574758	29	0.448276
chrY	27624442	27624468	DQ571386	26	0.576923
chrY	27624550	27624577	DQ585964	27	0.592593
chrY	27629054	27632852	CSPG4P1Y	3798	0.578462
chrY	27635918	27635954	DQ576060	36	0.472222
chrY	27635936	27635967	DQ581594	31	0.451613
chrY	27644740	27644773	DQ600137	33	0.424242
chrY	27768263	27771048	CDY1	2785	0.413645
chrY	27874636	27879535	TTTY3	4899	0.319249
chrY	28121659	28134248	PRY	12589	0.413536
chrY	28507135	28507239	U6	104	0.365385
chrY	59100456	59115123	SPRY3	14667	0.402877
chrY	59213948	59276439	VAMP7	62491	0.387800
chrY	59330251	59343488	IL9R	13237	0.558208
chrY	59352972	59356131	WASH1	3159	0.602406
chrY	59358328	59360854	DDX11L family member	2526	0.573634
